id,submitdate,lastpage,startlanguage,seed,startdate,datestamp,CF001,CF002,education,education[other],IQ001,eqG01,vis01[appealing],vis01[artistic],vis01[attractive],vis01[balanced],vis01[beautiful],vis01[clean],vis01[cluttered],vis01[colorHarmonious],vis01[creative],vis01[delightful],vis01[elegant],vis01[engaging],vis01[enjoyable],vis01[exciting],vis01[fascinating],vis01[harmonious],vis01[interesting],vis01[inviting],vis01[likable],vis01[lovely],vis01[motivating],vis01[nice],vis01[organized],vis01[pleasing],vis01[pretty],vis01[professional],vis01[provoking],vis01[satisfying],vis01[sophisticated],vis01[tasteful],vis01[wellDesigned],vis01[strongDisagree],eqG02,vis02[appealing],vis02[artistic],vis02[attractive],vis02[balanced],vis02[beautiful],vis02[clean],vis02[cluttered],vis02[colorHarmonious],vis02[creative],vis02[delightful],vis02[elegant],vis02[engaging],vis02[enjoyable],vis02[exciting],vis02[fascinating],vis02[harmonious],vis02[interesting],vis02[inviting],vis02[likable],vis02[lovely],vis02[motivating],vis02[nice],vis02[organized],vis02[pleasing],vis02[pretty],vis02[professional],vis02[provoking],vis02[satisfying],vis02[sophisticated],vis02[tasteful],vis02[wellDesigned],vis02[disagree],eqG03,vis03[appealing],vis03[artistic],vis03[attractive],vis03[balanced],vis03[beautiful],vis03[clean],vis03[cluttered],vis03[colorHarmonious],vis03[creative],vis03[delightful],vis03[elegant],vis03[engaging],vis03[enjoyable],vis03[exciting],vis03[fascinating],vis03[harmonious],vis03[interesting],vis03[inviting],vis03[likable],vis03[lovely],vis03[motivating],vis03[nice],vis03[organized],vis03[pleasing],vis03[pretty],vis03[professional],vis03[provoking],vis03[satisfying],vis03[sophisticated],vis03[tasteful],vis03[wellDesigned],vis03[slightDisagree],eqG04,vis04[appealing],vis04[artistic],vis04[attractive],vis04[balanced],vis04[beautiful],vis04[clean],vis04[cluttered],vis04[colorHarmonious],vis04[creative],vis04[delightful],vis04[elegant],vis04[engaging],vis04[enjoyable],vis04[exciting],vis04[fascinating],vis04[harmonious],vis04[interesting],vis04[inviting],vis04[likable],vis04[lovely],vis04[motivating],vis04[nice],vis04[organized],vis04[pleasing],vis04[pretty],vis04[professional],vis04[provoking],vis04[satisfying],vis04[sophisticated],vis04[tasteful],vis04[wellDesigned],vis04[neutral],eqG05,vis05[appealing],vis05[artistic],vis05[attractive],vis05[balanced],vis05[beautiful],vis05[clean],vis05[cluttered],vis05[colorHarmonious],vis05[creative],vis05[delightful],vis05[elegant],vis05[engaging],vis05[enjoyable],vis05[exciting],vis05[fascinating],vis05[harmonious],vis05[interesting],vis05[inviting],vis05[likable],vis05[lovely],vis05[motivating],vis05[nice],vis05[organized],vis05[pleasing],vis05[pretty],vis05[professional],vis05[provoking],vis05[satisfying],vis05[sophisticated],vis05[tasteful],vis05[wellDesigned],vis05[slightAgree],eqG06,vis06[appealing],vis06[artistic],vis06[attractive],vis06[balanced],vis06[beautiful],vis06[clean],vis06[cluttered],vis06[colorHarmonious],vis06[creative],vis06[delightful],vis06[elegant],vis06[engaging],vis06[enjoyable],vis06[exciting],vis06[fascinating],vis06[harmonious],vis06[interesting],vis06[inviting],vis06[likable],vis06[lovely],vis06[motivating],vis06[nice],vis06[organized],vis06[pleasing],vis06[pretty],vis06[professional],vis06[provoking],vis06[satisfying],vis06[sophisticated],vis06[tasteful],vis06[wellDesigned],vis06[agree],eqG07,vis07[appealing],vis07[artistic],vis07[attractive],vis07[balanced],vis07[beautiful],vis07[clean],vis07[cluttered],vis07[colorHarmonious],vis07[creative],vis07[delightful],vis07[elegant],vis07[engaging],vis07[enjoyable],vis07[exciting],vis07[fascinating],vis07[harmonious],vis07[interesting],vis07[inviting],vis07[likable],vis07[lovely],vis07[motivating],vis07[nice],vis07[organized],vis07[pleasing],vis07[pretty],vis07[professional],vis07[provoking],vis07[satisfying],vis07[sophisticated],vis07[tasteful],vis07[wellDesigned],vis07[strongAgree],eqG08,vis08[appealing],vis08[artistic],vis08[attractive],vis08[balanced],vis08[beautiful],vis08[clean],vis08[cluttered],vis08[colorHarmonious],vis08[creative],vis08[delightful],vis08[elegant],vis08[engaging],vis08[enjoyable],vis08[exciting],vis08[fascinating],vis08[harmonious],vis08[interesting],vis08[inviting],vis08[likable],vis08[lovely],vis08[motivating],vis08[nice],vis08[organized],vis08[pleasing],vis08[pretty],vis08[professional],vis08[provoking],vis08[satisfying],vis08[sophisticated],vis08[tasteful],vis08[wellDesigned],vis08[strongDisagree],eqG09,vis09[appealing],vis09[artistic],vis09[attractive],vis09[balanced],vis09[beautiful],vis09[clean],vis09[cluttered],vis09[colorHarmonious],vis09[creative],vis09[delightful],vis09[elegant],vis09[engaging],vis09[enjoyable],vis09[exciting],vis09[fascinating],vis09[harmonious],vis09[interesting],vis09[inviting],vis09[likable],vis09[lovely],vis09[motivating],vis09[nice],vis09[organized],vis09[pleasing],vis09[pretty],vis09[professional],vis09[provoking],vis09[satisfying],vis09[sophisticated],vis09[tasteful],vis09[wellDesigned],vis09[disagree],eqG10,vis10[appealing],vis10[artistic],vis10[attractive],vis10[balanced],vis10[beautiful],vis10[clean],vis10[cluttered],vis10[colorHarmonious],vis10[creative],vis10[delightful],vis10[elegant],vis10[engaging],vis10[enjoyable],vis10[exciting],vis10[fascinating],vis10[harmonious],vis10[interesting],vis10[inviting],vis10[likable],vis10[lovely],vis10[motivating],vis10[nice],vis10[organized],vis10[pleasing],vis10[pretty],vis10[professional],vis10[provoking],vis10[satisfying],vis10[sophisticated],vis10[tasteful],vis10[wellDesigned],vis10[slightDisagree],eqG11,vis11[appealing],vis11[artistic],vis11[attractive],vis11[balanced],vis11[beautiful],vis11[clean],vis11[cluttered],vis11[colorHarmonious],vis11[creative],vis11[delightful],vis11[elegant],vis11[engaging],vis11[enjoyable],vis11[exciting],vis11[fascinating],vis11[harmonious],vis11[interesting],vis11[inviting],vis11[likable],vis11[lovely],vis11[motivating],vis11[nice],vis11[organized],vis11[pleasing],vis11[pretty],vis11[professional],vis11[provoking],vis11[satisfying],vis11[sophisticated],vis11[tasteful],vis11[wellDesigned],vis11[neutral],eqG12,vis12[appealing],vis12[artistic],vis12[attractive],vis12[balanced],vis12[beautiful],vis12[clean],vis12[cluttered],vis12[colorHarmonious],vis12[creative],vis12[delightful],vis12[elegant],vis12[engaging],vis12[enjoyable],vis12[exciting],vis12[fascinating],vis12[harmonious],vis12[interesting],vis12[inviting],vis12[likable],vis12[lovely],vis12[motivating],vis12[nice],vis12[organized],vis12[pleasing],vis12[pretty],vis12[professional],vis12[provoking],vis12[satisfying],vis12[sophisticated],vis12[tasteful],vis12[wellDesigned],vis12[slightAgree],eqG13,vis13[appealing],vis13[artistic],vis13[attractive],vis13[balanced],vis13[beautiful],vis13[clean],vis13[cluttered],vis13[colorHarmonious],vis13[creative],vis13[delightful],vis13[elegant],vis13[engaging],vis13[enjoyable],vis13[exciting],vis13[fascinating],vis13[harmonious],vis13[interesting],vis13[inviting],vis13[likable],vis13[lovely],vis13[motivating],vis13[nice],vis13[organized],vis13[pleasing],vis13[pretty],vis13[professional],vis13[provoking],vis13[satisfying],vis13[sophisticated],vis13[tasteful],vis13[wellDesigned],vis13[agree],eqG14,vis14[appealing],vis14[artistic],vis14[attractive],vis14[balanced],vis14[beautiful],vis14[clean],vis14[cluttered],vis14[colorHarmonious],vis14[creative],vis14[delightful],vis14[elegant],vis14[engaging],vis14[enjoyable],vis14[exciting],vis14[fascinating],vis14[harmonious],vis14[interesting],vis14[inviting],vis14[likable],vis14[lovely],vis14[motivating],vis14[nice],vis14[organized],vis14[pleasing],vis14[pretty],vis14[professional],vis14[provoking],vis14[satisfying],vis14[sophisticated],vis14[tasteful],vis14[wellDesigned],vis14[strongAgree],eqG15,vis15[appealing],vis15[artistic],vis15[attractive],vis15[balanced],vis15[beautiful],vis15[clean],vis15[cluttered],vis15[colorHarmonious],vis15[creative],vis15[delightful],vis15[elegant],vis15[engaging],vis15[enjoyable],vis15[exciting],vis15[fascinating],vis15[harmonious],vis15[interesting],vis15[inviting],vis15[likable],vis15[lovely],vis15[motivating],vis15[nice],vis15[organized],vis15[pleasing],vis15[pretty],vis15[professional],vis15[provoking],vis15[satisfying],vis15[sophisticated],vis15[tasteful],vis15[wellDesigned],vis15[strongDisagree],END,interviewtime,groupTime7609,PIDTime,CF001Time,CF002Time,groupTime7610,educationTime,groupTime7611,IQ001Time,groupTime7613,eqG01Time,vis01Time,groupTime7614,eqG02Time,vis02Time,groupTime7615,eqG03Time,vis03Time,groupTime7616,eqG04Time,vis04Time,groupTime7617,eqG05Time,vis05Time,groupTime7618,eqG06Time,vis06Time,groupTime7619,eqG07Time,vis07Time,groupTime7620,eqG08Time,vis08Time,groupTime7621,eqG09Time,vis09Time,groupTime7622,eqG10Time,vis10Time,groupTime7623,eqG11Time,vis11Time,groupTime7624,eqG12Time,vis12Time,groupTime7625,eqG13Time,vis13Time,groupTime7626,eqG14Time,vis14Time,groupTime7627,eqG15Time,vis15Time,groupTime7612,ENDTime,status,gender,age,duplicated
7,2022-03-21 02:21:10,19,en,1709767099,2022-03-21 02:14:55,2022-03-21 02:21:10,Y,Y,A1,,,13,,,,,,,,,,,,,,,,,,,,,,,,,,,,,,,,,8,,,,,,,,,,,,,,,,,,,,,,,,,,,,,,,,,4,,,,,,,,,,,,,,,,,,,,,,,,,,,,,,,,,2,5.0,3.0,2.0,4.0,3.0,3.0,4.0,4.0,5.0,2.0,1.0,4.0,3.0,2.0,4.0,1.0,5.0,1.0,3.0,2.0,2.0,4.0,2.0,3.0,3.0,4.0,1.0,3.0,2.0,2.0,5.0,4.0,3,,,,,,,,,,,,,,,,,,,,,,,,,,,,,,,,,1,5.0,5.0,4.0,3.0,4.0,1.0,3.0,6.0,6.0,4.0,1.0,3.0,4.0,2.0,5.0,2.0,5.0,1.0,4.0,3.0,2.0,4.0,3.0,5.0,4.0,2.0,1.0,2.0,2.0,3.0,5.0,6.0,7,,,,,,,,,,,,,,,,,,,,,,,,,,,,,,,,,12,,,,,,,,,,,,,,,,,,,,,,,,,,,,,,,,,6,,,,,,,,,,,,,,,,,,,,,,,,,,,,,,,,,9,,,,,,,,,,,,,,,,,,,,,,,,,,,,,,,,,10,,,,,,,,,,,,,,,,,,,,,,,,,,,,,,,,,0,3.0,5.0,2.0,2.0,4.0,2.0,4.0,4.0,4.0,2.0,2.0,2.0,4.0,2.0,4.0,3.0,4.0,1.0,3.0,2.0,2.0,4.0,2.0,4.0,3.0,2.0,1.0,3.0,3.0,4.0,2.0,5.0,11,,,,,,,,,,,,,,,,,,,,,,,,,,,,,,,,,5,,,,,,,,,,,,,,,,,,,,,,,,,,,,,,,,,14,,,,,,,,,,,,,,,,,,,,,,,,,,,,,,,,,,378.28,33.33,,,,9.45,,40.54,,,,,,,,,,,103.19,,,,,,87.0,,,,,,,,,,,,,,,,,,100.06,,,,,,,,,,,,4.71,,APPROVED,Female,23.0,FALSE
8,2022-03-21 02:21:38,19,en,850821544,2022-03-21 02:15:20,2022-03-21 02:21:38,Y,Y,A1,,,4,,,,,,,,,,,,,,,,,,,,,,,,,,,,,,,,,13,,,,,,,,,,,,,,,,,,,,,,,,,,,,,,,,,1,4.0,5.0,4.0,3.0,5.0,4.0,4.0,4.0,3.0,4.0,5.0,4.0,4.0,4.0,5.0,4.0,4.0,4.0,5.0,4.0,4.0,4.0,4.0,4.0,5.0,4.0,4.0,5.0,4.0,4.0,5.0,3.0,8,,,,,,,,,,,,,,,,,,,,,,,,,,,,,,,,,3,,,,,,,,,,,,,,,,,,,,,,,,,,,,,,,,,6,,,,,,,,,,,,,,,,,,,,,,,,,,,,,,,,,14,,,,,,,,,,,,,,,,,,,,,,,,,,,,,,,,,5,,,,,,,,,,,,,,,,,,,,,,,,,,,,,,,,,10,,,,,,,,,,,,,,,,,,,,,,,,,,,,,,,,,12,,,,,,,,,,,,,,,,,,,,,,,,,,,,,,,,,0,3.0,5.0,4.0,4.0,3.0,4.0,4.0,5.0,5.0,4.0,4.0,3.0,4.0,4.0,5.0,3.0,5.0,3.0,4.0,3.0,4.0,5.0,3.0,4.0,3.0,4.0,4.0,3.0,4.0,4.0,2.0,4.0,9,,,,,,,,,,,,,,,,,,,,,,,,,,,,,,,,,11,,,,,,,,,,,,,,,,,,,,,,,,,,,,,,,,,7,,,,,,,,,,,,,,,,,,,,,,,,,,,,,,,,,2,4.0,5.0,5.0,5.0,5.0,4.0,5.0,5.0,5.0,5.0,4.0,5.0,6.0,4.0,4.0,6.0,5.0,5.0,4.0,5.0,5.0,5.0,5.0,5.0,5.0,4.0,4.0,6.0,4.0,5.0,5.0,1.0,,381.37,53.62,,,,7.64,,65.54,,,,,,,,105.21,,,,,,,,,,,,,,,,,,,,,,,,95.09,,,,,,,,,,,,50.86,,,3.41,,APPROVED,Male,22.0,FALSE
9,2022-03-21 02:25:00,19,en,1087823500,2022-03-21 02:15:36,2022-03-21 02:25:00,Y,Y,A1,,,3,,,,,,,,,,,,,,,,,,,,,,,,,,,,,,,,,6,,,,,,,,,,,,,,,,,,,,,,,,,,,,,,,,,10,,,,,,,,,,,,,,,,,,,,,,,,,,,,,,,,,14,,,,,,,,,,,,,,,,,,,,,,,,,,,,,,,,,4,,,,,,,,,,,,,,,,,,,,,,,,,,,,,,,,,0,4.0,7.0,4.0,3.0,3.0,3.0,6.0,6.0,6.0,3.0,4.0,3.0,3.0,4.0,3.0,5.0,3.0,4.0,4.0,4.0,3.0,4.0,2.0,4.0,5.0,4.0,4.0,5.0,3.0,5.0,2.0,6.0,1,3.0,4.0,4.0,5.0,3.0,3.0,6.0,5.0,3.0,2.0,5.0,4.0,4.0,2.0,4.0,3.0,4.0,4.0,4.0,3.0,2.0,5.0,2.0,3.0,4.0,4.0,4.0,3.0,4.0,3.0,3.0,7.0,7,,,,,,,,,,,,,,,,,,,,,,,,,,,,,,,,,13,,,,,,,,,,,,,,,,,,,,,,,,,,,,,,,,,11,,,,,,,,,,,,,,,,,,,,,,,,,,,,,,,,,12,,,,,,,,,,,,,,,,,,,,,,,,,,,,,,,,,9,,,,,,,,,,,,,,,,,,,,,,,,,,,,,,,,,2,3.0,6.0,5.0,2.0,5.0,4.0,6.0,5.0,6.0,3.0,5.0,4.0,4.0,4.0,6.0,4.0,6.0,4.0,5.0,4.0,4.0,5.0,3.0,3.0,6.0,4.0,4.0,5.0,3.0,5.0,4.0,6.0,5,,,,,,,,,,,,,,,,,,,,,,,,,,,,,,,,,8,,,,,,,,,,,,,,,,,,,,,,,,,,,,,,,,,:),566.99,105.52,,,,10.23,,45.26,,,,,,,,,,,,,,,,,124.21,,,161.26,,,,,,,,,,,,,,,,,,110.79,,,,,,,,,9.72,,APPROVED,Male,33.0,FALSE
10,2022-03-21 02:19:11,19,en,1711834330,2022-03-21 02:15:36,2022-03-21 02:19:11,Y,Y,A1,,,3,,,,,,,,,,,,,,,,,,,,,,,,,,,,,,,,,4,,,,,,,,,,,,,,,,,,,,,,,,,,,,,,,,,8,,,,,,,,,,,,,,,,,,,,,,,,,,,,,,,,,11,,,,,,,,,,,,,,,,,,,,,,,,,,,,,,,,,14,,,,,,,,,,,,,,,,,,,,,,,,,,,,,,,,,2,5.0,7.0,6.0,6.0,7.0,5.0,5.0,7.0,5.0,6.0,6.0,6.0,4.0,6.0,6.0,6.0,6.0,6.0,5.0,5.0,6.0,5.0,6.0,5.0,5.0,5.0,5.0,6.0,6.0,6.0,6.0,6.0,9,,,,,,,,,,,,,,,,,,,,,,,,,,,,,,,,,0,1.0,3.0,3.0,3.0,3.0,1.0,7.0,7.0,5.0,3.0,6.0,2.0,3.0,1.0,3.0,4.0,1.0,4.0,3.0,2.0,1.0,3.0,3.0,3.0,4.0,5.0,3.0,2.0,3.0,4.0,5.0,1.0,7,,,,,,,,,,,,,,,,,,,,,,,,,,,,,,,,,5,,,,,,,,,,,,,,,,,,,,,,,,,,,,,,,,,12,,,,,,,,,,,,,,,,,,,,,,,,,,,,,,,,,6,,,,,,,,,,,,,,,,,,,,,,,,,,,,,,,,,10,,,,,,,,,,,,,,,,,,,,,,,,,,,,,,,,,1,5.0,5.0,1.0,5.0,1.0,5.0,1.0,7.0,6.0,5.0,3.0,6.0,4.0,5.0,6.0,5.0,3.0,4.0,4.0,5.0,4.0,3.0,4.0,6.0,4.0,5.0,4.0,6.0,3.0,4.0,7.0,7.0,13,,,,,,,,,,,,,,,,,,,,,,,,,,,,,,,,,,217.7,10.56,,,,5.52,,11.33,,,,,,,,,,,,,,,,,41.35,,,,,,86.2,,,,,,,,,,,,,,,,,,60.16,,,,,,2.58,,APPROVED,Male,22.0,FALSE
11,2022-03-21 02:18:48,19,en,1427473993,2022-03-21 02:15:41,2022-03-21 02:18:48,Y,Y,A1,,,2,5.0,4.0,6.0,6.0,5.0,3.0,4.0,6.0,6.0,6.0,6.0,4.0,6.0,5.0,4.0,5.0,5.0,6.0,5.0,5.0,5.0,7.0,3.0,4.0,5.0,5.0,5.0,4.0,6.0,5.0,5.0,1.0,1,4.0,2.0,5.0,4.0,4.0,7.0,5.0,6.0,2.0,4.0,4.0,5.0,4.0,6.0,5.0,5.0,4.0,5.0,4.0,6.0,3.0,6.0,7.0,4.0,5.0,6.0,3.0,5.0,5.0,4.0,5.0,2.0,14,,,,,,,,,,,,,,,,,,,,,,,,,,,,,,,,,10,,,,,,,,,,,,,,,,,,,,,,,,,,,,,,,,,5,,,,,,,,,,,,,,,,,,,,,,,,,,,,,,,,,13,,,,,,,,,,,,,,,,,,,,,,,,,,,,,,,,,12,,,,,,,,,,,,,,,,,,,,,,,,,,,,,,,,,7,,,,,,,,,,,,,,,,,,,,,,,,,,,,,,,,,4,,,,,,,,,,,,,,,,,,,,,,,,,,,,,,,,,11,,,,,,,,,,,,,,,,,,,,,,,,,,,,,,,,,9,,,,,,,,,,,,,,,,,,,,,,,,,,,,,,,,,0,4.0,6.0,3.0,3.0,4.0,5.0,4.0,5.0,6.0,6.0,5.0,3.0,5.0,5.0,5.0,5.0,6.0,5.0,5.0,2.0,3.0,6.0,1.0,4.0,5.0,4.0,4.0,2.0,5.0,4.0,3.0,5.0,8,,,,,,,,,,,,,,,,,,,,,,,,,,,,,,,,,3,,,,,,,,,,,,,,,,,,,,,,,,,,,,,,,,,6,,,,,,,,,,,,,,,,,,,,,,,,,,,,,,,,,,190.39,14.42,,,,4.2,,13.99,,42.43,,,52.13,,,,,,,,,,,,,,,,,,,,,,,,,,,,,,59.34,,,,,,,,,,,,3.88,,APPROVED,Male,23.0,FALSE
12,2022-03-21 02:26:26,19,en,1363689224,2022-03-21 02:15:49,2022-03-21 02:26:26,Y,Y,A1,,,0,5.0,6.0,5.0,2.0,2.0,1.0,5.0,3.0,6.0,3.0,5.0,3.0,4.0,6.0,6.0,6.0,5.0,3.0,3.0,3.0,3.0,6.0,1.0,3.0,5.0,2.0,6.0,5.0,6.0,6.0,5.0,1.0,5,,,,,,,,,,,,,,,,,,,,,,,,,,,,,,,,,2,6.0,3.0,6.0,4.0,5.0,3.0,5.0,6.0,3.0,3.0,6.0,6.0,6.0,5.0,4.0,5.0,7.0,7.0,6.0,5.0,6.0,6.0,6.0,6.0,7.0,3.0,2.0,7.0,6.0,5.0,6.0,3.0,8,,,,,,,,,,,,,,,,,,,,,,,,,,,,,,,,,10,,,,,,,,,,,,,,,,,,,,,,,,,,,,,,,,,9,,,,,,,,,,,,,,,,,,,,,,,,,,,,,,,,,4,,,,,,,,,,,,,,,,,,,,,,,,,,,,,,,,,13,,,,,,,,,,,,,,,,,,,,,,,,,,,,,,,,,12,,,,,,,,,,,,,,,,,,,,,,,,,,,,,,,,,11,,,,,,,,,,,,,,,,,,,,,,,,,,,,,,,,,1,6.0,6.0,5.0,2.0,3.0,2.0,6.0,1.0,6.0,3.0,3.0,6.0,6.0,3.0,5.0,3.0,6.0,6.0,5.0,3.0,2.0,5.0,5.0,2.0,3.0,5.0,6.0,2.0,3.0,5.0,5.0,4.0,6,,,,,,,,,,,,,,,,,,,,,,,,,,,,,,,,,3,,,,,,,,,,,,,,,,,,,,,,,,,,,,,,,,,7,,,,,,,,,,,,,,,,,,,,,,,,,,,,,,,,,14,,,,,,,,,,,,,,,,,,,,,,,,,,,,,,,,,,642.86,13.64,,,,6.1,,35.76,,150.03,,,,,,338.04,,,,,,,,,,,,,,,,,,,,,,,,96.55,,,,,,,,,,,,,,,2.74,,APPROVED,Male,23.0,FALSE
14,2022-03-21 02:22:35,19,en,923828498,2022-03-21 02:16:04,2022-03-21 02:22:35,Y,Y,-oth-,undergraduate,,10,,,,,,,,,,,,,,,,,,,,,,,,,,,,,,,,,14,,,,,,,,,,,,,,,,,,,,,,,,,,,,,,,,,11,,,,,,,,,,,,,,,,,,,,,,,,,,,,,,,,,5,,,,,,,,,,,,,,,,,,,,,,,,,,,,,,,,,3,,,,,,,,,,,,,,,,,,,,,,,,,,,,,,,,,0,3.0,5.0,3.0,3.0,3.0,3.0,6.0,3.0,5.0,2.0,3.0,3.0,3.0,3.0,3.0,2.0,5.0,2.0,3.0,2.0,2.0,3.0,2.0,3.0,5.0,4.0,5.0,3.0,2.0,3.0,3.0,6.0,12,,,,,,,,,,,,,,,,,,,,,,,,,,,,,,,,,9,,,,,,,,,,,,,,,,,,,,,,,,,,,,,,,,,4,,,,,,,,,,,,,,,,,,,,,,,,,,,,,,,,,6,,,,,,,,,,,,,,,,,,,,,,,,,,,,,,,,,1,5.0,6.0,6.0,4.0,3.0,5.0,4.0,6.0,5.0,5.0,6.0,5.0,5.0,5.0,5.0,5.0,5.0,5.0,5.0,4.0,3.0,5.0,5.0,5.0,5.0,5.0,4.0,5.0,4.0,5.0,5.0,4.0,8,,,,,,,,,,,,,,,,,,,,,,,,,,,,,,,,,7,,,,,,,,,,,,,,,,,,,,,,,,,,,,,,,,,13,,,,,,,,,,,,,,,,,,,,,,,,,,,,,,,,,2,3.0,3.0,3.0,3.0,3.0,5.0,3.0,3.0,3.0,3.0,3.0,3.0,3.0,3.0,3.0,3.0,3.0,3.0,3.0,3.0,3.0,3.0,5.0,3.0,3.0,5.0,3.0,3.0,3.0,3.0,5.0,1.0,,394.83,47.73,,,,35.51,,28.56,,,,,,,,,,,,,,,,,98.56,,,,,,,,,,,,,,,104.63,,,,,,,,,,,,75.99,,,3.85,,APPROVED,Female,21.0,FALSE
15,2022-03-21 02:20:27,19,en,1857724599,2022-03-21 02:16:06,2022-03-21 02:20:27,Y,Y,-oth-,Highschool ,,14,,,,,,,,,,,,,,,,,,,,,,,,,,,,,,,,,9,,,,,,,,,,,,,,,,,,,,,,,,,,,,,,,,,10,,,,,,,,,,,,,,,,,,,,,,,,,,,,,,,,,2,5.0,4.0,5.0,1.0,3.0,4.0,4.0,6.0,5.0,2.0,3.0,5.0,5.0,5.0,5.0,6.0,6.0,4.0,6.0,1.0,1.0,3.0,4.0,4.0,2.0,4.0,5.0,5.0,4.0,5.0,4.0,4.0,8,,,,,,,,,,,,,,,,,,,,,,,,,,,,,,,,,1,5.0,5.0,3.0,3.0,1.0,5.0,5.0,1.0,3.0,2.0,1.0,2.0,4.0,3.0,3.0,3.0,5.0,3.0,2.0,3.0,1.0,4.0,1.0,4.0,1.0,4.0,5.0,3.0,1.0,4.0,3.0,6.0,3,,,,,,,,,,,,,,,,,,,,,,,,,,,,,,,,,12,,,,,,,,,,,,,,,,,,,,,,,,,,,,,,,,,7,,,,,,,,,,,,,,,,,,,,,,,,,,,,,,,,,13,,,,,,,,,,,,,,,,,,,,,,,,,,,,,,,,,6,,,,,,,,,,,,,,,,,,,,,,,,,,,,,,,,,11,,,,,,,,,,,,,,,,,,,,,,,,,,,,,,,,,5,,,,,,,,,,,,,,,,,,,,,,,,,,,,,,,,,4,,,,,,,,,,,,,,,,,,,,,,,,,,,,,,,,,0,2.0,3.0,3.0,2.0,2.0,1.0,5.0,5.0,2.0,3.0,3.0,3.0,2.0,3.0,3.0,2.0,2.0,2.0,2.0,1.0,2.0,2.0,1.0,2.0,3.0,4.0,2.0,3.0,3.0,2.0,1.0,3.0,,264.59,12.87,,,,26.53,,20.14,,,,,,,,,,,62.46,,,,,,80.6,,,,,,,,,,,,,,,,,,,,,,,,,,,58.7,,,3.29,,APPROVED,Female,21.0,FALSE
16,2022-03-21 02:25:24,19,en,140034895,2022-03-21 02:16:12,2022-03-21 02:25:24,Y,Y,A1,,,8,,,,,,,,,,,,,,,,,,,,,,,,,,,,,,,,,9,,,,,,,,,,,,,,,,,,,,,,,,,,,,,,,,,13,,,,,,,,,,,,,,,,,,,,,,,,,,,,,,,,,5,,,,,,,,,,,,,,,,,,,,,,,,,,,,,,,,,0,4.0,4.0,3.0,3.0,3.0,3.0,5.0,3.0,4.0,3.0,3.0,4.0,3.0,4.0,3.0,3.0,5.0,3.0,3.0,3.0,3.0,3.0,4.0,3.0,3.0,5.0,3.0,4.0,4.0,4.0,4.0,5.0,6,,,,,,,,,,,,,,,,,,,,,,,,,,,,,,,,,14,,,,,,,,,,,,,,,,,,,,,,,,,,,,,,,,,12,,,,,,,,,,,,,,,,,,,,,,,,,,,,,,,,,11,,,,,,,,,,,,,,,,,,,,,,,,,,,,,,,,,2,6.0,6.0,5.0,5.0,5.0,5.0,4.0,6.0,6.0,5.0,6.0,4.0,5.0,4.0,5.0,5.0,6.0,4.0,6.0,4.0,4.0,5.0,5.0,5.0,5.0,6.0,5.0,6.0,4.0,5.0,6.0,3.0,3,,,,,,,,,,,,,,,,,,,,,,,,,,,,,,,,,1,5.0,5.0,5.0,4.0,4.0,5.0,3.0,5.0,5.0,4.0,5.0,4.0,4.0,5.0,5.0,5.0,5.0,4.0,5.0,4.0,3.0,5.0,4.0,5.0,4.0,4.0,5.0,5.0,5.0,4.0,4.0,5.0,7,,,,,,,,,,,,,,,,,,,,,,,,,,,,,,,,,4,,,,,,,,,,,,,,,,,,,,,,,,,,,,,,,,,10,,,,,,,,,,,,,,,,,,,,,,,,,,,,,,,,,,555.08,98.6,,,,17.51,,81.05,,,,,,,,,,,,,,163.69,,,,,,,,,,,,,,,98.98,,,,,,89.41,,,,,,,,,,,,5.84,,APPROVED,Female,22.0,FALSE
17,2022-03-21 02:20:50,19,en,696362673,2022-03-21 02:16:13,2022-03-21 02:20:50,Y,Y,-oth-,High School,,4,,,,,,,,,,,,,,,,,,,,,,,,,,,,,,,,,7,,,,,,,,,,,,,,,,,,,,,,,,,,,,,,,,,11,,,,,,,,,,,,,,,,,,,,,,,,,,,,,,,,,0,3.0,5.0,5.0,2.0,5.0,1.0,6.0,2.0,5.0,2.0,5.0,4.0,4.0,5.0,5.0,2.0,5.0,2.0,4.0,2.0,2.0,4.0,3.0,3.0,6.0,2.0,3.0,3.0,3.0,5.0,3.0,4.0,10,,,,,,,,,,,,,,,,,,,,,,,,,,,,,,,,,5,,,,,,,,,,,,,,,,,,,,,,,,,,,,,,,,,9,,,,,,,,,,,,,,,,,,,,,,,,,,,,,,,,,14,,,,,,,,,,,,,,,,,,,,,,,,,,,,,,,,,8,,,,,,,,,,,,,,,,,,,,,,,,,,,,,,,,,3,,,,,,,,,,,,,,,,,,,,,,,,,,,,,,,,,6,,,,,,,,,,,,,,,,,,,,,,,,,,,,,,,,,13,,,,,,,,,,,,,,,,,,,,,,,,,,,,,,,,,12,,,,,,,,,,,,,,,,,,,,,,,,,,,,,,,,,2,5.0,4.0,5.0,5.0,4.0,5.0,2.0,6.0,5.0,4.0,4.0,5.0,4.0,4.0,5.0,4.0,5.0,4.0,5.0,4.0,4.0,6.0,6.0,4.0,4.0,6.0,4.0,4.0,4.0,4.0,6.0,7.0,1,1.0,4.0,1.0,2.0,1.0,1.0,7.0,1.0,4.0,2.0,1.0,1.0,2.0,2.0,1.0,2.0,1.0,1.0,2.0,2.0,1.0,1.0,1.0,1.0,1.0,1.0,6.0,1.0,1.0,1.0,1.0,1.0,,280.68,17.4,,,,12.41,,37.56,,,,,,,,,,,97.41,,,,,,,,,,,,,,,,,,,,,,,,,,,,,,52.6,,,58.41,,,4.89,,APPROVED,Male,23.0,FALSE
18,2022-03-21 02:24:33,19,en,1072363307,2022-03-21 02:16:17,2022-03-21 02:24:33,Y,Y,-oth-,High school,,2,6.0,7.0,7.0,4.0,7.0,3.0,7.0,6.0,7.0,6.0,6.0,5.0,6.0,5.0,7.0,6.0,7.0,6.0,6.0,6.0,5.0,7.0,5.0,6.0,6.0,4.0,5.0,7.0,7.0,7.0,7.0,1.0,0,3.0,4.0,6.0,5.0,4.0,5.0,6.0,6.0,5.0,3.0,4.0,6.0,6.0,4.0,3.0,4.0,4.0,4.0,6.0,4.0,4.0,4.0,5.0,5.0,6.0,4.0,4.0,3.0,3.0,5.0,5.0,2.0,9,,,,,,,,,,,,,,,,,,,,,,,,,,,,,,,,,6,,,,,,,,,,,,,,,,,,,,,,,,,,,,,,,,,4,,,,,,,,,,,,,,,,,,,,,,,,,,,,,,,,,5,,,,,,,,,,,,,,,,,,,,,,,,,,,,,,,,,10,,,,,,,,,,,,,,,,,,,,,,,,,,,,,,,,,3,,,,,,,,,,,,,,,,,,,,,,,,,,,,,,,,,12,,,,,,,,,,,,,,,,,,,,,,,,,,,,,,,,,11,,,,,,,,,,,,,,,,,,,,,,,,,,,,,,,,,7,,,,,,,,,,,,,,,,,,,,,,,,,,,,,,,,,14,,,,,,,,,,,,,,,,,,,,,,,,,,,,,,,,,1,3.0,6.0,3.0,3.0,6.0,3.0,5.0,1.0,5.0,3.0,2.0,2.0,2.0,5.0,2.0,3.0,5.0,2.0,4.0,4.0,4.0,2.0,3.0,6.0,6.0,4.0,2.0,5.0,5.0,2.0,2.0,6.0,8,,,,,,,,,,,,,,,,,,,,,,,,,,,,,,,,,13,,,,,,,,,,,,,,,,,,,,,,,,,,,,,,,,,,499.64,21.12,,,,35.98,,47.62,,123.2,,,123.06,,,,,,,,,,,,,,,,,,,,,,,,,,,,,,,,,144.87,,,,,,,,,3.79,,APPROVED,Male,29.0,FALSE
19,2022-03-21 02:24:34,19,en,1761268259,2022-03-21 02:16:18,2022-03-21 02:24:34,Y,Y,A1,,,9,,,,,,,,,,,,,,,,,,,,,,,,,,,,,,,,,8,,,,,,,,,,,,,,,,,,,,,,,,,,,,,,,,,4,,,,,,,,,,,,,,,,,,,,,,,,,,,,,,,,,5,,,,,,,,,,,,,,,,,,,,,,,,,,,,,,,,,3,,,,,,,,,,,,,,,,,,,,,,,,,,,,,,,,,10,,,,,,,,,,,,,,,,,,,,,,,,,,,,,,,,,1,1.0,1.0,1.0,1.0,1.0,4.0,7.0,5.0,4.0,1.0,1.0,1.0,1.0,1.0,2.0,4.0,1.0,1.0,1.0,1.0,1.0,1.0,4.0,1.0,1.0,4.0,5.0,1.0,1.0,4.0,5.0,7.0,7,,,,,,,,,,,,,,,,,,,,,,,,,,,,,,,,,2,4.0,1.0,1.0,4.0,2.0,1.0,3.0,5.0,1.0,1.0,1.0,5.0,1.0,4.0,1.0,4.0,3.0,2.0,2.0,1.0,1.0,1.0,5.0,3.0,1.0,7.0,1.0,4.0,5.0,1.0,5.0,2.0,11,,,,,,,,,,,,,,,,,,,,,,,,,,,,,,,,,0,3.0,5.0,1.0,2.0,4.0,1.0,6.0,6.0,5.0,4.0,1.0,5.0,3.0,5.0,5.0,2.0,5.0,2.0,1.0,1.0,3.0,4.0,1.0,1.0,1.0,1.0,6.0,1.0,4.0,3.0,1.0,4.0,14,,,,,,,,,,,,,,,,,,,,,,,,,,,,,,,,,6,,,,,,,,,,,,,,,,,,,,,,,,,,,,,,,,,12,,,,,,,,,,,,,,,,,,,,,,,,,,,,,,,,,13,,,,,,,,,,,,,,,,,,,,,,,,,,,,,,,,,,500.57,24.14,,,,5.48,,202.98,,,,,,,,,,,,,,,,,,,,86.18,,,,,,84.53,,,,,,94.34,,,,,,,,,,,,,,,2.92,,APPROVED,Male,23.0,FALSE
20,2022-03-21 02:24:20,19,en,689042014,2022-03-21 02:16:22,2022-03-21 02:24:20,Y,Y,A1,,,7,,,,,,,,,,,,,,,,,,,,,,,,,,,,,,,,,8,,,,,,,,,,,,,,,,,,,,,,,,,,,,,,,,,6,,,,,,,,,,,,,,,,,,,,,,,,,,,,,,,,,3,,,,,,,,,,,,,,,,,,,,,,,,,,,,,,,,,11,,,,,,,,,,,,,,,,,,,,,,,,,,,,,,,,,5,,,,,,,,,,,,,,,,,,,,,,,,,,,,,,,,,13,,,,,,,,,,,,,,,,,,,,,,,,,,,,,,,,,9,,,,,,,,,,,,,,,,,,,,,,,,,,,,,,,,,10,,,,,,,,,,,,,,,,,,,,,,,,,,,,,,,,,2,1.0,1.0,4.0,2.0,3.0,1.0,7.0,2.0,2.0,2.0,2.0,4.0,2.0,2.0,2.0,1.0,5.0,2.0,2.0,2.0,2.0,3.0,1.0,2.0,2.0,4.0,1.0,2.0,6.0,2.0,2.0,3.0,14,,,,,,,,,,,,,,,,,,,,,,,,,,,,,,,,,12,,,,,,,,,,,,,,,,,,,,,,,,,,,,,,,,,4,,,,,,,,,,,,,,,,,,,,,,,,,,,,,,,,,1,2.0,4.0,2.0,2.0,1.0,5.0,4.0,2.0,4.0,1.0,3.0,4.0,2.0,2.0,2.0,2.0,4.0,3.0,2.0,3.0,3.0,3.0,5.0,1.0,1.0,5.0,2.0,2.0,4.0,3.0,5.0,7.0,1,3.0,3.0,4.0,4.0,3.0,2.0,6.0,3.0,5.0,4.0,6.0,5.0,2.0,4.0,4.0,2.0,6.0,4.0,2.0,2.0,2.0,4.0,2.0,5.0,5.0,6.0,3.0,2.0,5.0,3.0,5.0,1.0,Great study! :),483.58,91.91,,,,7.28,,79.99,,,,,,,,,,,,,,,,,,,,,,,,,,,,,67.7,,,,,,,,,,,,108.32,,,118.49,,,9.89,,APPROVED,Male,20.0,FALSE
21,2022-03-21 02:25:24,19,en,1721102130,2022-03-21 02:16:28,2022-03-21 02:25:24,Y,Y,A1,,,2,4.0,4.0,4.0,4.0,5.0,2.0,4.0,4.0,5.0,3.0,4.0,3.0,3.0,2.0,2.0,3.0,5.0,4.0,4.0,3.0,3.0,4.0,2.0,4.0,4.0,4.0,4.0,3.0,5.0,2.0,5.0,1.0,1,3.0,4.0,4.0,4.0,3.0,4.0,4.0,5.0,2.0,3.0,4.0,2.0,3.0,3.0,2.0,5.0,4.0,4.0,5.0,4.0,2.0,4.0,5.0,5.0,3.0,4.0,3.0,3.0,1.0,3.0,3.0,2.0,7,,,,,,,,,,,,,,,,,,,,,,,,,,,,,,,,,12,,,,,,,,,,,,,,,,,,,,,,,,,,,,,,,,,5,,,,,,,,,,,,,,,,,,,,,,,,,,,,,,,,,10,,,,,,,,,,,,,,,,,,,,,,,,,,,,,,,,,0,4.0,4.0,3.0,5.0,4.0,3.0,4.0,4.0,4.0,3.0,5.0,3.0,4.0,4.0,3.0,3.0,4.0,3.0,4.0,3.0,2.0,5.0,3.0,4.0,3.0,4.0,4.0,3.0,3.0,3.0,4.0,7.0,3,,,,,,,,,,,,,,,,,,,,,,,,,,,,,,,,,6,,,,,,,,,,,,,,,,,,,,,,,,,,,,,,,,,9,,,,,,,,,,,,,,,,,,,,,,,,,,,,,,,,,11,,,,,,,,,,,,,,,,,,,,,,,,,,,,,,,,,13,,,,,,,,,,,,,,,,,,,,,,,,,,,,,,,,,8,,,,,,,,,,,,,,,,,,,,,,,,,,,,,,,,,4,,,,,,,,,,,,,,,,,,,,,,,,,,,,,,,,,14,,,,,,,,,,,,,,,,,,,,,,,,,,,,,,,,,,539.05,16.74,,,,10.3,,102.07,,114.87,,,110.59,,,,,,,,,,,,,,,179.15,,,,,,,,,,,,,,,,,,,,,,,,,,,5.33,,APPROVED,Male,35.0,FALSE
24,2022-03-21 02:23:22,19,en,1013631814,2022-03-21 02:16:41,2022-03-21 02:23:22,Y,Y,-oth-,Diploma,,10,,,,,,,,,,,,,,,,,,,,,,,,,,,,,,,,,14,,,,,,,,,,,,,,,,,,,,,,,,,,,,,,,,,6,,,,,,,,,,,,,,,,,,,,,,,,,,,,,,,,,8,,,,,,,,,,,,,,,,,,,,,,,,,,,,,,,,,4,,,,,,,,,,,,,,,,,,,,,,,,,,,,,,,,,2,6.0,6.0,6.0,6.0,6.0,6.0,3.0,6.0,6.0,6.0,6.0,6.0,5.0,6.0,6.0,6.0,6.0,6.0,6.0,6.0,6.0,2.0,6.0,6.0,6.0,6.0,6.0,6.0,6.0,4.0,6.0,6.0,5,,,,,,,,,,,,,,,,,,,,,,,,,,,,,,,,,7,,,,,,,,,,,,,,,,,,,,,,,,,,,,,,,,,11,,,,,,,,,,,,,,,,,,,,,,,,,,,,,,,,,1,6.0,6.0,6.0,6.0,6.0,6.0,2.0,4.0,6.0,6.0,6.0,6.0,6.0,6.0,6.0,6.0,6.0,6.0,6.0,5.0,6.0,6.0,6.0,6.0,6.0,6.0,3.0,6.0,6.0,6.0,6.0,1.0,3,,,,,,,,,,,,,,,,,,,,,,,,,,,,,,,,,13,,,,,,,,,,,,,,,,,,,,,,,,,,,,,,,,,12,,,,,,,,,,,,,,,,,,,,,,,,,,,,,,,,,0,2.0,5.0,2.0,4.0,2.0,6.0,3.0,6.0,6.0,2.0,2.0,3.0,2.0,2.0,2.0,2.0,2.0,2.0,2.0,2.0,2.0,2.0,6.0,2.0,2.0,6.0,6.0,2.0,2.0,2.0,6.0,7.0,9,,,,,,,,,,,,,,,,,,,,,,,,,,,,,,,,,,404.73,29.21,,,,18.52,,79.64,,,,,,,,,,,,,,,,,69.55,,,,,,,,,,,,92.48,,,,,,,,,,,,110.9,,,,,,4.43,,APPROVED,Male,34.0,FALSE
25,2022-03-21 02:23:43,19,en,1830374702,2022-03-21 02:16:43,2022-03-21 02:23:43,Y,Y,A1,,,9,,,,,,,,,,,,,,,,,,,,,,,,,,,,,,,,,14,,,,,,,,,,,,,,,,,,,,,,,,,,,,,,,,,8,,,,,,,,,,,,,,,,,,,,,,,,,,,,,,,,,4,,,,,,,,,,,,,,,,,,,,,,,,,,,,,,,,,11,,,,,,,,,,,,,,,,,,,,,,,,,,,,,,,,,7,,,,,,,,,,,,,,,,,,,,,,,,,,,,,,,,,12,,,,,,,,,,,,,,,,,,,,,,,,,,,,,,,,,1,1.0,3.0,2.0,4.0,1.0,1.0,6.0,4.0,5.0,1.0,2.0,2.0,1.0,2.0,2.0,2.0,5.0,3.0,2.0,2.0,3.0,3.0,1.0,2.0,2.0,3.0,1.0,1.0,5.0,4.0,5.0,1.0,10,,,,,,,,,,,,,,,,,,,,,,,,,,,,,,,,,3,,,,,,,,,,,,,,,,,,,,,,,,,,,,,,,,,0,3.0,5.0,5.0,3.0,1.0,5.0,7.0,6.0,5.0,2.0,4.0,5.0,3.0,4.0,6.0,5.0,2.0,4.0,5.0,2.0,2.0,6.0,3.0,4.0,3.0,5.0,3.0,3.0,5.0,6.0,2.0,4.0,5,,,,,,,,,,,,,,,,,,,,,,,,,,,,,,,,,2,6.0,3.0,5.0,4.0,6.0,5.0,5.0,6.0,6.0,3.0,4.0,5.0,4.0,5.0,4.0,4.0,3.0,6.0,5.0,5.0,4.0,6.0,4.0,5.0,5.0,6.0,5.0,5.0,6.0,5.0,6.0,6.0,13,,,,,,,,,,,,,,,,,,,,,,,,,,,,,,,,,6,,,,,,,,,,,,,,,,,,,,,,,,,,,,,,,,,,423.0,22.3,,,,6.47,,18.02,,,,,,,,,,,,,,,,,,,,,,,76.41,,,,,,,,,190.68,,,,,,107.09,,,,,,,,,2.03,,APPROVED,Male,22.0,FALSE
26,2022-03-21 02:26:08,19,en,1340058799,2022-03-21 02:16:54,2022-03-21 02:26:08,Y,Y,-oth-,some college,,9,,,,,,,,,,,,,,,,,,,,,,,,,,,,,,,,,2,7.0,5.0,7.0,7.0,7.0,7.0,4.0,7.0,5.0,7.0,7.0,7.0,7.0,7.0,7.0,7.0,7.0,5.0,7.0,7.0,7.0,7.0,7.0,7.0,7.0,7.0,6.0,7.0,6.0,7.0,6.0,2.0,4,,,,,,,,,,,,,,,,,,,,,,,,,,,,,,,,,6,,,,,,,,,,,,,,,,,,,,,,,,,,,,,,,,,8,,,,,,,,,,,,,,,,,,,,,,,,,,,,,,,,,7,,,,,,,,,,,,,,,,,,,,,,,,,,,,,,,,,11,,,,,,,,,,,,,,,,,,,,,,,,,,,,,,,,,0,2.0,5.0,4.0,2.0,3.0,1.0,6.0,5.0,5.0,3.0,1.0,5.0,3.0,4.0,1.0,2.0,5.0,4.0,5.0,4.0,1.0,3.0,1.0,5.0,2.0,1.0,4.0,1.0,5.0,3.0,5.0,1.0,12,,,,,,,,,,,,,,,,,,,,,,,,,,,,,,,,,14,,,,,,,,,,,,,,,,,,,,,,,,,,,,,,,,,13,,,,,,,,,,,,,,,,,,,,,,,,,,,,,,,,,3,,,,,,,,,,,,,,,,,,,,,,,,,,,,,,,,,5,,,,,,,,,,,,,,,,,,,,,,,,,,,,,,,,,1,3.0,5.0,2.0,5.0,3.0,6.0,4.0,2.0,6.0,5.0,5.0,5.0,3.0,3.0,7.0,6.0,6.0,3.0,4.0,4.0,6.0,5.0,7.0,5.0,5.0,7.0,5.0,5.0,7.0,5.0,6.0,7.0,10,,,,,,,,,,,,,,,,,,,,,,,,,,,,,,,,,no comments,556.86,125.73,,,,12.84,,91.27,,,,,82.02,,,,,,,,,,,,,,,,,,130.76,,,,,,,,,,,,,,,,,,106.21,,,,,,8.03,,APPROVED,Male,26.0,FALSE
27,2022-03-21 02:23:50,19,en,633315395,2022-03-21 02:17:01,2022-03-21 02:23:50,Y,Y,A1,,,6,,,,,,,,,,,,,,,,,,,,,,,,,,,,,,,,,3,,,,,,,,,,,,,,,,,,,,,,,,,,,,,,,,,8,,,,,,,,,,,,,,,,,,,,,,,,,,,,,,,,,4,,,,,,,,,,,,,,,,,,,,,,,,,,,,,,,,,7,,,,,,,,,,,,,,,,,,,,,,,,,,,,,,,,,2,4.0,4.0,4.0,5.0,3.0,5.0,5.0,5.0,3.0,4.0,4.0,4.0,3.0,4.0,4.0,4.0,4.0,4.0,4.0,4.0,4.0,4.0,5.0,4.0,3.0,4.0,4.0,3.0,4.0,4.0,4.0,6.0,2,1.0,1.0,1.0,1.0,1.0,2.0,7.0,1.0,1.0,2.0,1.0,1.0,1.0,1.0,1.0,1.0,1.0,1.0,1.0,1.0,1.0,2.0,1.0,1.0,2.0,1.0,1.0,2.0,1.0,1.0,2.0,7.0,9,,,,,,,,,,,,,,,,,,,,,,,,,,,,,,,,,11,,,,,,,,,,,,,,,,,,,,,,,,,,,,,,,,,10,,,,,,,,,,,,,,,,,,,,,,,,,,,,,,,,,5,,,,,,,,,,,,,,,,,,,,,,,,,,,,,,,,,14,,,,,,,,,,,,,,,,,,,,,,,,,,,,,,,,,13,,,,,,,,,,,,,,,,,,,,,,,,,,,,,,,,,12,,,,,,,,,,,,,,,,,,,,,,,,,,,,,,,,,2,4.0,5.0,4.0,5.0,4.0,4.0,6.0,4.0,5.0,4.0,4.0,4.0,4.0,3.0,5.0,4.0,6.0,4.0,4.0,4.0,4.0,4.0,2.0,4.0,4.0,6.0,4.0,4.0,5.0,4.0,5.0,1.0,,414.02,58.3,,,,7.48,,52.98,,,,,,,,,,,,,,,,,77.19,,,77.69,,,,,,,,,,,,,,,,,,,,,,,,135.66,,,4.72,,APPROVED,Male,23.0,FALSE
28,2022-03-21 02:22:32,19,en,129861125,2022-03-21 02:17:03,2022-03-21 02:22:32,Y,Y,A1,,,13,,,,,,,,,,,,,,,,,,,,,,,,,,,,,,,,,1,6.0,3.0,4.0,6.0,5.0,5.0,5.0,5.0,2.0,5.0,5.0,5.0,5.0,5.0,5.0,5.0,5.0,5.0,5.0,5.0,5.0,4.0,6.0,6.0,5.0,6.0,4.0,3.0,5.0,5.0,5.0,2.0,4,,,,,,,,,,,,,,,,,,,,,,,,,,,,,,,,,10,,,,,,,,,,,,,,,,,,,,,,,,,,,,,,,,,6,,,,,,,,,,,,,,,,,,,,,,,,,,,,,,,,,3,,,,,,,,,,,,,,,,,,,,,,,,,,,,,,,,,5,,,,,,,,,,,,,,,,,,,,,,,,,,,,,,,,,0,2.0,2.0,4.0,2.0,3.0,4.0,5.0,2.0,2.0,2.0,2.0,2.0,2.0,2.0,2.0,2.0,5.0,3.0,2.0,3.0,2.0,2.0,2.0,2.0,2.0,2.0,2.0,2.0,2.0,2.0,3.0,1.0,12,,,,,,,,,,,,,,,,,,,,,,,,,,,,,,,,,9,,,,,,,,,,,,,,,,,,,,,,,,,,,,,,,,,8,,,,,,,,,,,,,,,,,,,,,,,,,,,,,,,,,7,,,,,,,,,,,,,,,,,,,,,,,,,,,,,,,,,11,,,,,,,,,,,,,,,,,,,,,,,,,,,,,,,,,14,,,,,,,,,,,,,,,,,,,,,,,,,,,,,,,,,2,3.0,4.0,3.0,2.0,2.0,3.0,5.0,4.0,5.0,3.0,1.0,2.0,4.0,5.0,3.0,2.0,5.0,5.0,3.0,2.0,4.0,2.0,4.0,2.0,4.0,3.0,3.0,4.0,2.0,4.0,5.0,1.0,"Everythingin this study went smoothly, am just curious on whats the name of the last graph. ",304.47,15.7,,,,7.9,,38.15,,,,,47.43,,,,,,,,,,,,,,,,,,67.9,,,,,,,,,,,,,,,,,,,,,63.31,,,64.08,,RETURNED,CONSENT REVOKED,21.0,FALSE
29,2022-03-21 02:22:26,19,en,1841629230,2022-03-21 02:17:05,2022-03-21 02:22:26,Y,Y,A1,,,13,,,,,,,,,,,,,,,,,,,,,,,,,,,,,,,,,9,,,,,,,,,,,,,,,,,,,,,,,,,,,,,,,,,12,,,,,,,,,,,,,,,,,,,,,,,,,,,,,,,,,3,,,,,,,,,,,,,,,,,,,,,,,,,,,,,,,,,10,,,,,,,,,,,,,,,,,,,,,,,,,,,,,,,,,0,4.0,6.0,3.0,3.0,3.0,2.0,7.0,4.0,6.0,3.0,3.0,3.0,4.0,5.0,5.0,3.0,6.0,3.0,6.0,5.0,3.0,5.0,1.0,4.0,6.0,2.0,3.0,3.0,2.0,6.0,3.0,6.0,7,,,,,,,,,,,,,,,,,,,,,,,,,,,,,,,,,2,3.0,2.0,3.0,4.0,3.0,3.0,6.0,3.0,5.0,3.0,2.0,5.0,5.0,5.0,3.0,3.0,5.0,5.0,5.0,3.0,5.0,5.0,4.0,3.0,4.0,2.0,5.0,3.0,3.0,5.0,4.0,1.0,1,2.0,2.0,3.0,4.0,4.0,2.0,6.0,1.0,2.0,2.0,2.0,2.0,3.0,3.0,2.0,2.0,2.0,2.0,2.0,2.0,3.0,3.0,4.0,2.0,2.0,5.0,5.0,2.0,5.0,3.0,4.0,2.0,11,,,,,,,,,,,,,,,,,,,,,,,,,,,,,,,,,8,,,,,,,,,,,,,,,,,,,,,,,,,,,,,,,,,6,,,,,,,,,,,,,,,,,,,,,,,,,,,,,,,,,14,,,,,,,,,,,,,,,,,,,,,,,,,,,,,,,,,5,,,,,,,,,,,,,,,,,,,,,,,,,,,,,,,,,4,,,,,,,,,,,,,,,,,,,,,,,,,,,,,,,,,,323.59,13.3,,,,7.03,,47.0,,,,,,,,,,,,,,,,,107.46,,,,,,74.49,,,71.72,,,,,,,,,,,,,,,,,,,,,2.59,,APPROVED,Male,23.0,FALSE
30,2022-03-21 02:23:52,19,en,1343708829,2022-03-21 02:17:05,2022-03-21 02:23:52,Y,Y,A2,,,9,,,,,,,,,,,,,,,,,,,,,,,,,,,,,,,,,1,3.0,2.0,2.0,6.0,2.0,5.0,4.0,3.0,3.0,2.0,2.0,4.0,3.0,2.0,3.0,3.0,4.0,4.0,3.0,3.0,3.0,4.0,6.0,4.0,3.0,7.0,3.0,4.0,3.0,3.0,5.0,2.0,12,,,,,,,,,,,,,,,,,,,,,,,,,,,,,,,,,11,,,,,,,,,,,,,,,,,,,,,,,,,,,,,,,,,14,,,,,,,,,,,,,,,,,,,,,,,,,,,,,,,,,5,,,,,,,,,,,,,,,,,,,,,,,,,,,,,,,,,4,,,,,,,,,,,,,,,,,,,,,,,,,,,,,,,,,3,,,,,,,,,,,,,,,,,,,,,,,,,,,,,,,,,6,,,,,,,,,,,,,,,,,,,,,,,,,,,,,,,,,7,,,,,,,,,,,,,,,,,,,,,,,,,,,,,,,,,10,,,,,,,,,,,,,,,,,,,,,,,,,,,,,,,,,0,4.0,6.0,3.0,4.0,4.0,4.0,3.0,5.0,6.0,4.0,3.0,4.0,4.0,2.0,4.0,5.0,5.0,4.0,4.0,4.0,2.0,4.0,4.0,4.0,3.0,4.0,2.0,4.0,5.0,2.0,7.0,5.0,8,,,,,,,,,,,,,,,,,,,,,,,,,,,,,,,,,2,2.0,2.0,2.0,3.0,1.0,3.0,4.0,2.0,2.0,2.0,2.0,3.0,1.0,2.0,4.0,1.0,3.0,4.0,3.0,1.0,1.0,3.0,5.0,2.0,2.0,5.0,6.0,2.0,2.0,2.0,2.0,7.0,13,,,,,,,,,,,,,,,,,,,,,,,,,,,,,,,,,Interesting choice of images. Never thought about the impact of data visualization through this different types of images,409.81,43.09,,,,4.6,,25.14,,,,,69.32,,,,,,,,,,,,,,,,,,,,,,,,,,,,,,91.77,,,,,,99.3,,,,,,76.59,,APPROVED,Male,22.0,FALSE
31,2022-03-21 02:23:11,19,en,752110435,2022-03-21 02:17:07,2022-03-21 02:23:11,Y,Y,A1,,,14,,,,,,,,,,,,,,,,,,,,,,,,,,,,,,,,,11,,,,,,,,,,,,,,,,,,,,,,,,,,,,,,,,,0,6.0,4.0,5.0,3.0,4.0,5.0,2.0,5.0,4.0,4.0,4.0,4.0,4.0,4.0,4.0,4.0,3.0,4.0,5.0,4.0,4.0,5.0,4.0,5.0,5.0,4.0,3.0,5.0,4.0,4.0,4.0,3.0,2,4.0,4.0,4.0,3.0,4.0,4.0,5.0,3.0,4.0,4.0,4.0,4.0,4.0,4.0,5.0,4.0,5.0,4.0,4.0,4.0,3.0,4.0,4.0,4.0,4.0,4.0,4.0,4.0,4.0,4.0,4.0,4.0,8,,,,,,,,,,,,,,,,,,,,,,,,,,,,,,,,,4,,,,,,,,,,,,,,,,,,,,,,,,,,,,,,,,,1,3.0,3.0,2.0,3.0,2.0,4.0,5.0,4.0,4.0,3.0,3.0,3.0,3.0,2.0,3.0,3.0,3.0,4.0,3.0,2.0,4.0,3.0,4.0,3.0,3.0,4.0,3.0,3.0,3.0,3.0,4.0,7.0,12,,,,,,,,,,,,,,,,,,,,,,,,,,,,,,,,,13,,,,,,,,,,,,,,,,,,,,,,,,,,,,,,,,,7,,,,,,,,,,,,,,,,,,,,,,,,,,,,,,,,,10,,,,,,,,,,,,,,,,,,,,,,,,,,,,,,,,,3,,,,,,,,,,,,,,,,,,,,,,,,,,,,,,,,,9,,,,,,,,,,,,,,,,,,,,,,,,,,,,,,,,,5,,,,,,,,,,,,,,,,,,,,,,,,,,,,,,,,,6,,,,,,,,,,,,,,,,,,,,,,,,,,,,,,,,,,367.53,41.17,,,,7.79,,34.18,,,,,,,,113.66,,,84.27,,,,,,,,,82.52,,,,,,,,,,,,,,,,,,,,,,,,,,,3.94,,APPROVED,Female,,FALSE
32,2022-03-21 02:22:23,19,en,1793660565,2022-03-21 02:17:10,2022-03-21 02:22:23,Y,Y,A1,,,8,,,,,,,,,,,,,,,,,,,,,,,,,,,,,,,,,5,,,,,,,,,,,,,,,,,,,,,,,,,,,,,,,,,11,,,,,,,,,,,,,,,,,,,,,,,,,,,,,,,,,4,,,,,,,,,,,,,,,,,,,,,,,,,,,,,,,,,1,4.0,3.0,6.0,6.0,3.0,2.0,4.0,3.0,3.0,3.0,2.0,3.0,4.0,5.0,5.0,5.0,2.0,2.0,3.0,4.0,6.0,3.0,3.0,3.0,3.0,2.0,3.0,3.0,6.0,2.0,3.0,5.0,3,,,,,,,,,,,,,,,,,,,,,,,,,,,,,,,,,13,,,,,,,,,,,,,,,,,,,,,,,,,,,,,,,,,6,,,,,,,,,,,,,,,,,,,,,,,,,,,,,,,,,10,,,,,,,,,,,,,,,,,,,,,,,,,,,,,,,,,1,4.0,3.0,5.0,2.0,4.0,1.0,1.0,1.0,6.0,1.0,3.0,5.0,3.0,4.0,5.0,3.0,3.0,2.0,4.0,3.0,4.0,3.0,1.0,2.0,2.0,3.0,4.0,1.0,1.0,4.0,5.0,3.0,14,,,,,,,,,,,,,,,,,,,,,,,,,,,,,,,,,2,3.0,4.0,4.0,5.0,3.0,3.0,4.0,3.0,4.0,2.0,4.0,4.0,3.0,3.0,5.0,2.0,4.0,3.0,3.0,4.0,2.0,4.0,3.0,4.0,5.0,3.0,4.0,4.0,4.0,2.0,4.0,5.0,7,,,,,,,,,,,,,,,,,,,,,,,,,,,,,,,,,9,,,,,,,,,,,,,,,,,,,,,,,,,,,,,,,,,12,,,,,,,,,,,,,,,,,,,,,,,,,,,,,,,,,very fun,320.01,10.84,,,,5.26,,4.85,,,,,,,,,,,,,,53.63,,,,,,,,,,,,,,,44.77,,,,,,29.3,,,,,,,,,,,,171.36,,APPROVED,Male,20.0,FALSE
33,2022-03-21 02:22:15,19,en,919957384,2022-03-21 02:17:14,2022-03-21 02:22:15,Y,Y,A1,,,14,,,,,,,,,,,,,,,,,,,,,,,,,,,,,,,,,12,,,,,,,,,,,,,,,,,,,,,,,,,,,,,,,,,2,7.0,4.0,6.0,6.0,7.0,6.0,2.0,7.0,6.0,6.0,7.0,6.0,7.0,5.0,4.0,7.0,6.0,6.0,6.0,5.0,5.0,7.0,7.0,7.0,7.0,7.0,5.0,6.0,6.0,6.0,7.0,3.0,5,,,,,,,,,,,,,,,,,,,,,,,,,,,,,,,,,9,,,,,,,,,,,,,,,,,,,,,,,,,,,,,,,,,3,,,,,,,,,,,,,,,,,,,,,,,,,,,,,,,,,6,,,,,,,,,,,,,,,,,,,,,,,,,,,,,,,,,13,,,,,,,,,,,,,,,,,,,,,,,,,,,,,,,,,4,,,,,,,,,,,,,,,,,,,,,,,,,,,,,,,,,0,2.0,5.0,3.0,3.0,3.0,2.0,6.0,2.0,5.0,2.0,2.0,2.0,3.0,2.0,2.0,2.0,5.0,2.0,3.0,2.0,2.0,4.0,3.0,2.0,2.0,5.0,6.0,3.0,5.0,3.0,4.0,3.0,11,,,,,,,,,,,,,,,,,,,,,,,,,,,,,,,,,7,,,,,,,,,,,,,,,,,,,,,,,,,,,,,,,,,10,,,,,,,,,,,,,,,,,,,,,,,,,,,,,,,,,8,,,,,,,,,,,,,,,,,,,,,,,,,,,,,,,,,1,4.0,5.0,5.0,3.0,4.0,3.0,4.0,3.0,5.0,2.0,3.0,2.0,3.0,3.0,4.0,3.0,5.0,3.0,3.0,2.0,4.0,3.0,2.0,4.0,3.0,4.0,5.0,3.0,6.0,3.0,4.0,1.0,,301.28,25.32,,,,6.26,,33.98,,,,,,,,71.11,,,,,,,,,,,,,,,,,,,,,80.98,,,,,,,,,,,,,,,80.47,,,3.16,,APPROVED,Male,22.0,FALSE
34,2022-03-21 02:25:02,19,en,346846067,2022-03-21 02:17:14,2022-03-21 02:25:02,Y,Y,-oth-,MD,,4,,,,,,,,,,,,,,,,,,,,,,,,,,,,,,,,,12,,,,,,,,,,,,,,,,,,,,,,,,,,,,,,,,,13,,,,,,,,,,,,,,,,,,,,,,,,,,,,,,,,,3,,,,,,,,,,,,,,,,,,,,,,,,,,,,,,,,,7,,,,,,,,,,,,,,,,,,,,,,,,,,,,,,,,,10,,,,,,,,,,,,,,,,,,,,,,,,,,,,,,,,,6,,,,,,,,,,,,,,,,,,,,,,,,,,,,,,,,,14,,,,,,,,,,,,,,,,,,,,,,,,,,,,,,,,,1,5.0,3.0,5.0,2.0,2.0,4.0,6.0,3.0,2.0,4.0,6.0,6.0,3.0,2.0,5.0,5.0,5.0,5.0,4.0,5.0,3.0,6.0,6.0,3.0,2.0,6.0,2.0,5.0,6.0,4.0,2.0,2.0,9,,,,,,,,,,,,,,,,,,,,,,,,,,,,,,,,,8,,,,,,,,,,,,,,,,,,,,,,,,,,,,,,,,,2,6.0,6.0,7.0,5.0,6.0,5.0,2.0,6.0,6.0,6.0,6.0,6.0,6.0,6.0,7.0,6.0,6.0,6.0,6.0,6.0,6.0,6.0,6.0,6.0,6.0,6.0,6.0,6.0,5.0,6.0,7.0,5.0,5,,,,,,,,,,,,,,,,,,,,,,,,,,,,,,,,,11,,,,,,,,,,,,,,,,,,,,,,,,,,,,,,,,,0,3.0,5.0,3.0,3.0,3.0,2.0,7.0,3.0,5.0,3.0,3.0,2.0,3.0,3.0,3.0,3.0,5.0,3.0,2.0,3.0,2.0,3.0,3.0,3.0,2.0,5.0,2.0,2.0,2.0,3.0,3.0,1.0,,470.57,21.55,,,,12.7,,50.27,,,,,,,,,,,,,,,,,,,,,,,,,,142.11,,,,,,,,,65.52,,,,,,,,,173.17,,,5.25,,APPROVED,Female,27.0,FALSE
35,2022-03-21 02:25:30,19,en,1570141171,2022-03-21 02:17:16,2022-03-21 02:25:30,Y,Y,A1,,,2,5.0,5.0,5.0,4.0,4.0,5.0,5.0,5.0,4.0,3.0,5.0,4.0,3.0,3.0,5.0,5.0,5.0,4.0,5.0,4.0,4.0,5.0,3.0,4.0,4.0,4.0,5.0,5.0,5.0,4.0,4.0,1.0,6,,,,,,,,,,,,,,,,,,,,,,,,,,,,,,,,,4,,,,,,,,,,,,,,,,,,,,,,,,,,,,,,,,,13,,,,,,,,,,,,,,,,,,,,,,,,,,,,,,,,,8,,,,,,,,,,,,,,,,,,,,,,,,,,,,,,,,,1,3.0,4.0,3.0,3.0,3.0,2.0,6.0,3.0,2.0,3.0,3.0,3.0,2.0,3.0,3.0,3.0,3.0,3.0,3.0,3.0,3.0,3.0,1.0,2.0,3.0,3.0,4.0,3.0,3.0,3.0,3.0,6.0,7,,,,,,,,,,,,,,,,,,,,,,,,,,,,,,,,,14,,,,,,,,,,,,,,,,,,,,,,,,,,,,,,,,,3,,,,,,,,,,,,,,,,,,,,,,,,,,,,,,,,,10,,,,,,,,,,,,,,,,,,,,,,,,,,,,,,,,,5,,,,,,,,,,,,,,,,,,,,,,,,,,,,,,,,,0,4.0,5.0,5.0,5.0,3.0,4.0,5.0,6.0,5.0,4.0,3.0,4.0,5.0,4.0,4.0,3.0,6.0,3.0,5.0,5.0,3.0,5.0,3.0,4.0,4.0,3.0,4.0,3.0,4.0,3.0,3.0,5.0,12,,,,,,,,,,,,,,,,,,,,,,,,,,,,,,,,,9,,,,,,,,,,,,,,,,,,,,,,,,,,,,,,,,,11,,,,,,,,,,,,,,,,,,,,,,,,,,,,,,,,,,497.8,184.37,,,,47.94,,56.44,,57.93,,,,,,,,,,,,,,,81.54,,,,,,,,,,,,,,,,,,66.23,,,,,,,,,,,,3.35,,APPROVED,Male,25.0,FALSE
36,2022-03-21 02:23:35,19,en,985287278,2022-03-21 02:17:20,2022-03-21 02:23:35,Y,Y,-oth-,High School,,9,,,,,,,,,,,,,,,,,,,,,,,,,,,,,,,,,5,,,,,,,,,,,,,,,,,,,,,,,,,,,,,,,,,10,,,,,,,,,,,,,,,,,,,,,,,,,,,,,,,,,1,5.0,6.0,5.0,3.0,7.0,5.0,6.0,7.0,6.0,4.0,3.0,3.0,4.0,5.0,5.0,3.0,6.0,1.0,4.0,4.0,3.0,5.0,2.0,6.0,6.0,5.0,5.0,4.0,5.0,3.0,3.0,4.0,13,,,,,,,,,,,,,,,,,,,,,,,,,,,,,,,,,8,,,,,,,,,,,,,,,,,,,,,,,,,,,,,,,,,3,,,,,,,,,,,,,,,,,,,,,,,,,,,,,,,,,0,6.0,5.0,4.0,4.0,2.0,5.0,5.0,5.0,5.0,4.0,2.0,4.0,6.0,6.0,4.0,2.0,6.0,6.0,5.0,3.0,5.0,6.0,4.0,5.0,3.0,2.0,5.0,6.0,2.0,4.0,4.0,1.0,11,,,,,,,,,,,,,,,,,,,,,,,,,,,,,,,,,7,,,,,,,,,,,,,,,,,,,,,,,,,,,,,,,,,4,,,,,,,,,,,,,,,,,,,,,,,,,,,,,,,,,12,,,,,,,,,,,,,,,,,,,,,,,,,,,,,,,,,14,,,,,,,,,,,,,,,,,,,,,,,,,,,,,,,,,2,3.0,3.0,2.0,4.0,2.0,3.0,5.0,4.0,4.0,2.0,1.0,3.0,3.0,4.0,5.0,3.0,5.0,3.0,4.0,1.0,3.0,4.0,3.0,4.0,2.0,3.0,3.0,2.0,2.0,4.0,3.0,7.0,6,,,,,,,,,,,,,,,,,,,,,,,,,,,,,,,,,,377.88,61.22,,,,15.37,,27.76,,,,,,,,,,,81.54,,,,,,,,,,,,79.22,,,,,,,,,,,,,,,,,,109.15,,,,,,3.62,,APPROVED,Female,19.0,FALSE
37,2022-03-21 02:23:59,19,en,1654241666,2022-03-21 02:17:24,2022-03-21 02:23:59,Y,Y,A1,,,13,,,,,,,,,,,,,,,,,,,,,,,,,,,,,,,,,10,,,,,,,,,,,,,,,,,,,,,,,,,,,,,,,,,4,,,,,,,,,,,,,,,,,,,,,,,,,,,,,,,,,14,,,,,,,,,,,,,,,,,,,,,,,,,,,,,,,,,12,,,,,,,,,,,,,,,,,,,,,,,,,,,,,,,,,1,6.0,6.0,6.0,5.0,6.0,5.0,7.0,7.0,6.0,4.0,5.0,5.0,6.0,6.0,5.0,6.0,6.0,6.0,6.0,3.0,4.0,6.0,4.0,6.0,6.0,6.0,6.0,6.0,6.0,4.0,6.0,6.0,11,,,,,,,,,,,,,,,,,,,,,,,,,,,,,,,,,9,,,,,,,,,,,,,,,,,,,,,,,,,,,,,,,,,5,,,,,,,,,,,,,,,,,,,,,,,,,,,,,,,,,0,3.0,5.0,1.0,5.0,3.0,3.0,6.0,4.0,4.0,5.0,3.0,6.0,3.0,3.0,3.0,2.0,6.0,3.0,5.0,1.0,2.0,3.0,3.0,3.0,1.0,6.0,2.0,3.0,6.0,1.0,4.0,3.0,6,,,,,,,,,,,,,,,,,,,,,,,,,,,,,,,,,8,,,,,,,,,,,,,,,,,,,,,,,,,,,,,,,,,7,,,,,,,,,,,,,,,,,,,,,,,,,,,,,,,,,2,5.0,2.0,3.0,6.0,1.0,5.0,4.0,3.0,5.0,2.0,3.0,3.0,4.0,5.0,3.0,3.0,5.0,5.0,2.0,1.0,4.0,3.0,6.0,3.0,1.0,6.0,3.0,2.0,5.0,4.0,4.0,7.0,3,,,,,,,,,,,,,,,,,,,,,,,,,,,,,,,,,,397.81,48.97,,,,7.59,,47.0,,,,,,,,,,,,,,,,,82.26,,,,,,,,,,,,92.28,,,,,,,,,,,,115.8,,,,,,3.91,,APPROVED,Male,22.0,FALSE
38,2022-03-21 02:29:42,19,en,260097891,2022-03-21 02:24:35,2022-03-21 02:29:42,Y,Y,-oth-,high school,,6,,,,,,,,,,,,,,,,,,,,,,,,,,,,,,,,,8,,,,,,,,,,,,,,,,,,,,,,,,,,,,,,,,,7,,,,,,,,,,,,,,,,,,,,,,,,,,,,,,,,,10,,,,,,,,,,,,,,,,,,,,,,,,,,,,,,,,,0,1.0,3.0,4.0,3.0,4.0,2.0,6.0,6.0,5.0,2.0,3.0,4.0,4.0,2.0,4.0,1.0,6.0,2.0,4.0,2.0,2.0,4.0,2.0,3.0,3.0,2.0,1.0,3.0,3.0,4.0,5.0,5.0,5,,,,,,,,,,,,,,,,,,,,,,,,,,,,,,,,,2,5.0,4.0,2.0,6.0,3.0,5.0,2.0,7.0,3.0,4.0,4.0,4.0,5.0,3.0,4.0,4.0,5.0,5.0,5.0,4.0,4.0,4.0,5.0,3.0,4.0,4.0,1.0,4.0,3.0,2.0,2.0,7.0,14,,,,,,,,,,,,,,,,,,,,,,,,,,,,,,,,,9,,,,,,,,,,,,,,,,,,,,,,,,,,,,,,,,,4,,,,,,,,,,,,,,,,,,,,,,,,,,,,,,,,,11,,,,,,,,,,,,,,,,,,,,,,,,,,,,,,,,,3,,,,,,,,,,,,,,,,,,,,,,,,,,,,,,,,,13,,,,,,,,,,,,,,,,,,,,,,,,,,,,,,,,,12,,,,,,,,,,,,,,,,,,,,,,,,,,,,,,,,,1,1.0,1.0,1.0,1.0,1.0,1.0,4.0,2.0,1.0,2.0,2.0,1.0,1.0,2.0,1.0,1.0,1.0,2.0,1.0,1.0,1.0,2.0,2.0,2.0,1.0,4.0,3.0,1.0,1.0,1.0,1.0,1.0,.,310.68,40.54,,,,11.48,,33.78,,,,,,,,,,,,,,91.57,,,,,,70.04,,,,,,,,,,,,,,,,,,,,,,,,59.34,,,3.93,,APPROVED,Male,23.0,FALSE
39,2022-03-21 03:00:30,19,en,1423072882,2022-03-21 02:38:41,2022-03-21 03:00:30,Y,Y,-oth-,TAFE,,14,,,,,,,,,,,,,,,,,,,,,,,,,,,,,,,,,0,5.0,5.0,4.0,6.0,4.0,7.0,4.0,5.0,3.0,5.0,5.0,3.0,5.0,5.0,4.0,5.0,6.0,5.0,6.0,4.0,4.0,5.0,5.0,5.0,5.0,4.0,1.0,5.0,4.0,5.0,4.0,2.0,5,,,,,,,,,,,,,,,,,,,,,,,,,,,,,,,,,2,6.0,7.0,6.0,5.0,5.0,6.0,4.0,6.0,7.0,5.0,5.0,4.0,6.0,6.0,5.0,5.0,6.0,6.0,5.0,5.0,4.0,6.0,6.0,6.0,5.0,6.0,1.0,4.0,4.0,5.0,6.0,4.0,8,,,,,,,,,,,,,,,,,,,,,,,,,,,,,,,,,12,,,,,,,,,,,,,,,,,,,,,,,,,,,,,,,,,11,,,,,,,,,,,,,,,,,,,,,,,,,,,,,,,,,9,,,,,,,,,,,,,,,,,,,,,,,,,,,,,,,,,13,,,,,,,,,,,,,,,,,,,,,,,,,,,,,,,,,3,,,,,,,,,,,,,,,,,,,,,,,,,,,,,,,,,10,,,,,,,,,,,,,,,,,,,,,,,,,,,,,,,,,7,,,,,,,,,,,,,,,,,,,,,,,,,,,,,,,,,4,,,,,,,,,,,,,,,,,,,,,,,,,,,,,,,,,1,2.0,6.0,3.0,4.0,3.0,5.0,5.0,5.0,6.0,3.0,4.0,3.0,3.0,5.0,5.0,4.0,5.0,4.0,3.0,3.0,4.0,3.0,5.0,3.0,3.0,6.0,2.0,5.0,4.0,4.0,5.0,7.0,6,,,,,,,,,,,,,,,,,,,,,,,,,,,,,,,,,,312.58,15.53,,,,7.3,,36.18,,,,,86.41,,,,,,74.96,,,,,,,,,,,,,,,,,,,,,,,,,,,,,,88.18,,,,,,4.02,,APPROVED,Male,25.0,FALSE
40,2022-03-21 03:01:40,19,en,664382267,2022-03-21 02:38:44,2022-03-21 03:01:39,Y,Y,A2,,,2,5.0,6.0,6.0,3.0,6.0,4.0,5.0,5.0,6.0,6.0,5.0,5.0,5.0,5.0,6.0,4.0,6.0,6.0,5.0,4.0,5.0,6.0,2.0,4.0,6.0,6.0,7.0,5.0,5.0,5.0,5.0,1.0,7,,,,,,,,,,,,,,,,,,,,,,,,,,,,,,,,,3,,,,,,,,,,,,,,,,,,,,,,,,,,,,,,,,,12,,,,,,,,,,,,,,,,,,,,,,,,,,,,,,,,,10,,,,,,,,,,,,,,,,,,,,,,,,,,,,,,,,,1,4.0,5.0,4.0,3.0,6.0,2.0,4.0,4.0,6.0,5.0,4.0,5.0,4.0,3.0,3.0,2.0,6.0,5.0,4.0,3.0,3.0,5.0,4.0,3.0,3.0,2.0,1.0,2.0,3.0,4.0,4.0,6.0,6,,,,,,,,,,,,,,,,,,,,,,,,,,,,,,,,,8,,,,,,,,,,,,,,,,,,,,,,,,,,,,,,,,,14,,,,,,,,,,,,,,,,,,,,,,,,,,,,,,,,,4,,,,,,,,,,,,,,,,,,,,,,,,,,,,,,,,,0,2.0,6.0,2.0,2.0,4.0,2.0,5.0,2.0,5.0,2.0,1.0,3.0,4.0,2.0,3.0,3.0,5.0,2.0,4.0,2.0,2.0,5.0,1.0,2.0,2.0,1.0,1.0,2.0,2.0,2.0,3.0,4.0,11,,,,,,,,,,,,,,,,,,,,,,,,,,,,,,,,,9,,,,,,,,,,,,,,,,,,,,,,,,,,,,,,,,,5,,,,,,,,,,,,,,,,,,,,,,,,,,,,,,,,,13,,,,,,,,,,,,,,,,,,,,,,,,,,,,,,,,,,277.42,8.85,,,,4.56,,35.71,,61.16,,,,,,,,,,,,,,,73.96,,,,,,,,,,,,,,,80.18,,,,,,,,,,,,,,,13.0,,APPROVED,Male,25.0,FALSE
41,2022-03-21 02:55:41,19,en,244941590,2022-03-21 02:38:46,2022-03-21 02:55:41,Y,Y,A2,,,7,,,,,,,,,,,,,,,,,,,,,,,,,,,,,,,,,6,,,,,,,,,,,,,,,,,,,,,,,,,,,,,,,,,13,,,,,,,,,,,,,,,,,,,,,,,,,,,,,,,,,2,6.0,6.0,6.0,6.0,6.0,6.0,5.0,6.0,6.0,5.0,5.0,5.0,5.0,6.0,5.0,4.0,6.0,6.0,6.0,4.0,6.0,5.0,6.0,5.0,6.0,5.0,4.0,6.0,6.0,6.0,6.0,4.0,10,,,,,,,,,,,,,,,,,,,,,,,,,,,,,,,,,9,,,,,,,,,,,,,,,,,,,,,,,,,,,,,,,,,11,,,,,,,,,,,,,,,,,,,,,,,,,,,,,,,,,5,,,,,,,,,,,,,,,,,,,,,,,,,,,,,,,,,14,,,,,,,,,,,,,,,,,,,,,,,,,,,,,,,,,0,2.0,2.0,2.0,2.0,1.0,1.0,6.0,2.0,2.0,2.0,1.0,2.0,2.0,2.0,5.0,1.0,2.0,1.0,2.0,2.0,2.0,2.0,2.0,2.0,2.0,2.0,2.0,2.0,1.0,2.0,2.0,3.0,8,,,,,,,,,,,,,,,,,,,,,,,,,,,,,,,,,1,5.0,4.0,4.0,5.0,5.0,4.0,1.0,4.0,5.0,4.0,4.0,5.0,4.0,4.0,5.0,4.0,5.0,4.0,5.0,4.0,5.0,5.0,4.0,4.0,4.0,5.0,4.0,5.0,5.0,2.0,4.0,5.0,4,,,,,,,,,,,,,,,,,,,,,,,,,,,,,,,,,12,,,,,,,,,,,,,,,,,,,,,,,,,,,,,,,,,3,,,,,,,,,,,,,,,,,,,,,,,,,,,,,,,,,,479.4,27.09,,,,13.61,,77.23,,,,,,,,,,,56.08,,,,,,,,,,,,,,,,,,223.66,,,,,,77.87,,,,,,,,,,,,3.86,,APPROVED,Male,31.0,FALSE
44,2022-03-21 03:00:13,19,en,1077290675,2022-03-21 02:38:49,2022-03-21 03:00:13,Y,Y,A2,,,0,7.0,6.0,6.0,5.0,5.0,3.0,2.0,6.0,5.0,5.0,5.0,7.0,7.0,5.0,6.0,4.0,6.0,6.0,6.0,4.0,6.0,7.0,3.0,7.0,7.0,3.0,4.0,7.0,4.0,6.0,4.0,1.0,14,,,,,,,,,,,,,,,,,,,,,,,,,,,,,,,,,3,,,,,,,,,,,,,,,,,,,,,,,,,,,,,,,,,8,,,,,,,,,,,,,,,,,,,,,,,,,,,,,,,,,4,,,,,,,,,,,,,,,,,,,,,,,,,,,,,,,,,9,,,,,,,,,,,,,,,,,,,,,,,,,,,,,,,,,10,,,,,,,,,,,,,,,,,,,,,,,,,,,,,,,,,12,,,,,,,,,,,,,,,,,,,,,,,,,,,,,,,,,13,,,,,,,,,,,,,,,,,,,,,,,,,,,,,,,,,11,,,,,,,,,,,,,,,,,,,,,,,,,,,,,,,,,7,,,,,,,,,,,,,,,,,,,,,,,,,,,,,,,,,5,,,,,,,,,,,,,,,,,,,,,,,,,,,,,,,,,2,5.0,2.0,4.0,3.0,5.0,6.0,5.0,4.0,1.0,4.0,4.0,5.0,6.0,3.0,3.0,5.0,5.0,3.0,4.0,5.0,3.0,2.0,6.0,5.0,3.0,6.0,1.0,2.0,2.0,4.0,6.0,6.0,1,2.0,2.0,3.0,6.0,1.0,5.0,2.0,6.0,2.0,3.0,4.0,4.0,3.0,2.0,4.0,5.0,6.0,3.0,2.0,3.0,3.0,3.0,7.0,3.0,2.0,5.0,2.0,2.0,2.0,4.0,6.0,7.0,6,,,,,,,,,,,,,,,,,,,,,,,,,,,,,,,,,,374.3,14.0,,,,4.88,,46.48,,114.18,,,,,,,,,,,,,,,,,,,,,,,,,,,,,,,,,,,,95.94,,,92.16,,,,,,6.66,,APPROVED,Female,24.0,FALSE
45,2022-03-21 03:00:06,19,en,563705613,2022-03-21 02:38:49,2022-03-21 03:00:05,Y,Y,A1,,,8,,,,,,,,,,,,,,,,,,,,,,,,,,,,,,,,,6,,,,,,,,,,,,,,,,,,,,,,,,,,,,,,,,,3,,,,,,,,,,,,,,,,,,,,,,,,,,,,,,,,,10,,,,,,,,,,,,,,,,,,,,,,,,,,,,,,,,,14,,,,,,,,,,,,,,,,,,,,,,,,,,,,,,,,,4,,,,,,,,,,,,,,,,,,,,,,,,,,,,,,,,,5,,,,,,,,,,,,,,,,,,,,,,,,,,,,,,,,,2,6.0,2.0,5.0,6.0,6.0,6.0,5.0,7.0,2.0,2.0,2.0,6.0,5.0,2.0,4.0,6.0,6.0,6.0,5.0,2.0,2.0,2.0,5.0,5.0,2.0,6.0,6.0,2.0,2.0,5.0,7.0,1.0,11,,,,,,,,,,,,,,,,,,,,,,,,,,,,,,,,,0,2.0,6.0,6.0,3.0,6.0,2.0,3.0,6.0,5.0,3.0,3.0,2.0,3.0,4.0,2.0,3.0,3.0,2.0,3.0,7.0,5.0,3.0,5.0,2.0,3.0,3.0,3.0,3.0,3.0,1.0,3.0,3.0,7,,,,,,,,,,,,,,,,,,,,,,,,,,,,,,,,,9,,,,,,,,,,,,,,,,,,,,,,,,,,,,,,,,,13,,,,,,,,,,,,,,,,,,,,,,,,,,,,,,,,,1,1.0,2.0,1.0,5.0,2.0,1.0,4.0,1.0,5.0,2.0,1.0,3.0,2.0,2.0,2.0,2.0,3.0,3.0,2.0,3.0,2.0,3.0,2.0,2.0,1.0,2.0,6.0,2.0,1.0,3.0,1.0,7.0,12,,,,,,,,,,,,,,,,,,,,,,,,,,,,,,,,,"No, thanks",340.43,29.73,,,,9.07,,50.86,,,,,,,,,,,,,,,,,,,,,,,61.31,,,,,,115.67,,,,,,,,,,,,65.8,,,,,,7.99,,APPROVED,Male,21.0,FALSE
47,2022-03-21 02:57:44,19,en,1645257828,2022-03-21 02:38:51,2022-03-21 02:57:44,Y,Y,A1,,,6,,,,,,,,,,,,,,,,,,,,,,,,,,,,,,,,,4,,,,,,,,,,,,,,,,,,,,,,,,,,,,,,,,,9,,,,,,,,,,,,,,,,,,,,,,,,,,,,,,,,,3,,,,,,,,,,,,,,,,,,,,,,,,,,,,,,,,,2,6.0,5.0,6.0,6.0,6.0,5.0,4.0,6.0,3.0,5.0,6.0,5.0,6.0,6.0,5.0,6.0,6.0,6.0,6.0,6.0,5.0,6.0,6.0,6.0,5.0,6.0,3.0,6.0,6.0,5.0,6.0,5.0,12,,,,,,,,,,,,,,,,,,,,,,,,,,,,,,,,,8,,,,,,,,,,,,,,,,,,,,,,,,,,,,,,,,,11,,,,,,,,,,,,,,,,,,,,,,,,,,,,,,,,,1,6.0,6.0,6.0,3.0,5.0,6.0,3.0,5.0,6.0,4.0,6.0,5.0,5.0,5.0,6.0,5.0,6.0,5.0,5.0,5.0,4.0,6.0,6.0,5.0,5.0,5.0,6.0,6.0,6.0,4.0,5.0,2.0,14,,,,,,,,,,,,,,,,,,,,,,,,,,,,,,,,,0,3.0,5.0,2.0,3.0,3.0,3.0,5.0,6.0,5.0,3.0,2.0,4.0,3.0,3.0,2.0,3.0,3.0,3.0,4.0,3.0,4.0,3.0,5.0,3.0,2.0,2.0,5.0,3.0,3.0,3.0,3.0,4.0,7,,,,,,,,,,,,,,,,,,,,,,,,,,,,,,,,,10,,,,,,,,,,,,,,,,,,,,,,,,,,,,,,,,,13,,,,,,,,,,,,,,,,,,,,,,,,,,,,,,,,,5,,,,,,,,,,,,,,,,,,,,,,,,,,,,,,,,,,474.74,34.42,,,,96.56,,57.91,,,,,,,,,,,,,,62.48,,,,,,,,,,,,93.24,,,,,,123.98,,,,,,,,,,,,,,,6.15,,APPROVED,Male,34.0,FALSE
51,2022-03-21 03:03:52,19,en,9515900,2022-03-21 02:38:57,2022-03-21 03:03:52,Y,Y,A1,,,6,,,,,,,,,,,,,,,,,,,,,,,,,,,,,,,,,7,,,,,,,,,,,,,,,,,,,,,,,,,,,,,,,,,11,,,,,,,,,,,,,,,,,,,,,,,,,,,,,,,,,8,,,,,,,,,,,,,,,,,,,,,,,,,,,,,,,,,9,,,,,,,,,,,,,,,,,,,,,,,,,,,,,,,,,5,,,,,,,,,,,,,,,,,,,,,,,,,,,,,,,,,0,3.0,6.0,3.0,6.0,1.0,1.0,3.0,6.0,6.0,3.0,1.0,1.0,3.0,1.0,1.0,1.0,3.0,1.0,4.0,1.0,1.0,1.0,7.0,1.0,3.0,4.0,1.0,3.0,1.0,1.0,1.0,7.0,1,6.0,7.0,7.0,7.0,7.0,7.0,6.0,7.0,7.0,6.0,7.0,7.0,7.0,3.0,6.0,7.0,7.0,7.0,7.0,7.0,7.0,7.0,7.0,7.0,7.0,7.0,1.0,7.0,6.0,7.0,7.0,1.0,2,7.0,7.0,7.0,7.0,7.0,7.0,7.0,7.0,6.0,7.0,7.0,7.0,6.0,7.0,7.0,7.0,7.0,6.0,6.0,5.0,5.0,6.0,7.0,7.0,7.0,6.0,2.0,7.0,7.0,7.0,7.0,2.0,13,,,,,,,,,,,,,,,,,,,,,,,,,,,,,,,,,4,,,,,,,,,,,,,,,,,,,,,,,,,,,,,,,,,3,,,,,,,,,,,,,,,,,,,,,,,,,,,,,,,,,14,,,,,,,,,,,,,,,,,,,,,,,,,,,,,,,,,10,,,,,,,,,,,,,,,,,,,,,,,,,,,,,,,,,12,,,,,,,,,,,,,,,,,,,,,,,,,,,,,,,,,,624.22,317.87,,,,6.15,,115.12,,,,,,,,,,,,,,,,,,,,72.84,,,42.86,,,67.09,,,,,,,,,,,,,,,,,,,,,2.29,,APPROVED,Male,23.0,FALSE
54,2022-03-21 03:00:24,19,en,45662577,2022-03-21 02:38:59,2022-03-21 03:00:24,Y,Y,A1,,,11,,,,,,,,,,,,,,,,,,,,,,,,,,,,,,,,,0,6.0,4.0,5.0,6.0,6.0,5.0,5.0,6.0,2.0,5.0,5.0,6.0,6.0,6.0,4.0,4.0,6.0,3.0,7.0,5.0,4.0,7.0,6.0,6.0,6.0,6.0,1.0,6.0,5.0,5.0,6.0,2.0,12,,,,,,,,,,,,,,,,,,,,,,,,,,,,,,,,,2,5.0,5.0,5.0,3.0,5.0,2.0,7.0,6.0,6.0,5.0,5.0,6.0,5.0,5.0,4.0,5.0,6.0,3.0,5.0,5.0,4.0,3.0,7.0,6.0,5.0,7.0,1.0,5.0,7.0,5.0,7.0,4.0,13,,,,,,,,,,,,,,,,,,,,,,,,,,,,,,,,,10,,,,,,,,,,,,,,,,,,,,,,,,,,,,,,,,,4,,,,,,,,,,,,,,,,,,,,,,,,,,,,,,,,,14,,,,,,,,,,,,,,,,,,,,,,,,,,,,,,,,,3,,,,,,,,,,,,,,,,,,,,,,,,,,,,,,,,,9,,,,,,,,,,,,,,,,,,,,,,,,,,,,,,,,,5,,,,,,,,,,,,,,,,,,,,,,,,,,,,,,,,,1,3.0,5.0,5.0,4.0,5.0,4.0,5.0,2.0,5.0,4.0,5.0,1.0,5.0,5.0,4.0,4.0,6.0,3.0,4.0,4.0,2.0,5.0,2.0,5.0,6.0,4.0,1.0,6.0,7.0,6.0,2.0,7.0,8,,,,,,,,,,,,,,,,,,,,,,,,,,,,,,,,,7,,,,,,,,,,,,,,,,,,,,,,,,,,,,,,,,,6,,,,,,,,,,,,,,,,,,,,,,,,,,,,,,,,,,294.04,10.1,,,,7.07,,45.1,,,,,75.71,,,,,,80.13,,,,,,,,,,,,,,,,,,,,,,,,72.8,,,,,,,,,,,,3.13,,APPROVED,Male,24.0,FALSE
58,2022-03-21 03:00:53,19,en,1647578344,2022-03-21 02:39:04,2022-03-21 03:00:53,Y,Y,A1,,,10,,,,,,,,,,,,,,,,,,,,,,,,,,,,,,,,,8,,,,,,,,,,,,,,,,,,,,,,,,,,,,,,,,,14,,,,,,,,,,,,,,,,,,,,,,,,,,,,,,,,,12,,,,,,,,,,,,,,,,,,,,,,,,,,,,,,,,,0,3.0,6.0,3.0,2.0,3.0,1.0,6.0,4.0,6.0,3.0,3.0,4.0,3.0,3.0,4.0,1.0,5.0,2.0,5.0,3.0,3.0,3.0,1.0,2.0,3.0,3.0,4.0,5.0,4.0,4.0,2.0,5.0,5,,,,,,,,,,,,,,,,,,,,,,,,,,,,,,,,,4,,,,,,,,,,,,,,,,,,,,,,,,,,,,,,,,,13,,,,,,,,,,,,,,,,,,,,,,,,,,,,,,,,,9,,,,,,,,,,,,,,,,,,,,,,,,,,,,,,,,,1,2.0,1.0,1.0,2.0,1.0,1.0,6.0,1.0,2.0,1.0,1.0,1.0,1.0,1.0,2.0,2.0,1.0,1.0,3.0,1.0,1.0,1.0,2.0,1.0,1.0,1.0,5.0,1.0,5.0,1.0,3.0,3.0,3,,,,,,,,,,,,,,,,,,,,,,,,,,,,,,,,,7,,,,,,,,,,,,,,,,,,,,,,,,,,,,,,,,,2,6.0,6.0,6.0,5.0,4.0,6.0,5.0,4.0,6.0,5.0,4.0,6.0,5.0,5.0,5.0,6.0,7.0,5.0,6.0,4.0,4.0,5.0,5.0,5.0,5.0,6.0,4.0,5.0,6.0,5.0,6.0,6.0,6,,,,,,,,,,,,,,,,,,,,,,,,,,,,,,,,,11,,,,,,,,,,,,,,,,,,,,,,,,,,,,,,,,,,308.64,6.61,,,,8.04,,58.53,,,,,,,,,,,,,,97.02,,,,,,,,,,,,,,,65.98,,,,,,,,,67.45,,,,,,,,,5.01,,APPROVED,Male,22.0,FALSE
61,2022-03-21 02:56:14,19,en,1251218864,2022-03-21 02:39:08,2022-03-21 02:56:14,Y,Y,-oth-,still doing bachelors,,6,,,,,,,,,,,,,,,,,,,,,,,,,,,,,,,,,1,7.0,5.0,7.0,7.0,6.0,7.0,2.0,7.0,5.0,5.0,7.0,6.0,7.0,5.0,5.0,6.0,7.0,6.0,7.0,7.0,4.0,7.0,7.0,7.0,7.0,7.0,2.0,6.0,5.0,7.0,7.0,2.0,13,,,,,,,,,,,,,,,,,,,,,,,,,,,,,,,,,5,,,,,,,,,,,,,,,,,,,,,,,,,,,,,,,,,0,1.0,6.0,1.0,1.0,2.0,1.0,6.0,2.0,6.0,1.0,1.0,5.0,3.0,4.0,5.0,5.0,5.0,1.0,4.0,2.0,4.0,3.0,2.0,1.0,1.0,3.0,2.0,2.0,5.0,2.0,2.0,5.0,14,,,,,,,,,,,,,,,,,,,,,,,,,,,,,,,,,3,,,,,,,,,,,,,,,,,,,,,,,,,,,,,,,,,12,,,,,,,,,,,,,,,,,,,,,,,,,,,,,,,,,2,1.0,1.0,1.0,1.0,1.0,1.0,7.0,1.0,1.0,1.0,1.0,1.0,1.0,1.0,1.0,1.0,1.0,1.0,1.0,1.0,1.0,1.0,1.0,1.0,1.0,1.0,4.0,1.0,4.0,1.0,1.0,2.0,8,,,,,,,,,,,,,,,,,,,,,,,,,,,,,,,,,7,,,,,,,,,,,,,,,,,,,,,,,,,,,,,,,,,4,,,,,,,,,,,,,,,,,,,,,,,,,,,,,,,,,10,,,,,,,,,,,,,,,,,,,,,,,,,,,,,,,,,9,,,,,,,,,,,,,,,,,,,,,,,,,,,,,,,,,11,,,,,,,,,,,,,,,,,,,,,,,,,,,,,,,,,Lots of errors with SQL,501.91,46.37,,,,120.19,,33.92,,,,,69.27,,,,,,,,,131.61,,,,,,,,,,,,76.33,,,,,,,,,,,,,,,,,,,,,24.22,,APPROVED,Male,20.0,FALSE
62,2022-03-21 02:57:06,19,en,549029053,2022-03-21 02:39:09,2022-03-21 02:57:06,Y,Y,A1,,,11,,,,,,,,,,,,,,,,,,,,,,,,,,,,,,,,,2,3.0,6.0,5.0,4.0,5.0,6.0,4.0,4.0,6.0,5.0,5.0,5.0,6.0,4.0,6.0,5.0,7.0,4.0,5.0,5.0,5.0,5.0,5.0,5.0,5.0,6.0,2.0,4.0,6.0,1.0,5.0,2.0,10,,,,,,,,,,,,,,,,,,,,,,,,,,,,,,,,,13,,,,,,,,,,,,,,,,,,,,,,,,,,,,,,,,,7,,,,,,,,,,,,,,,,,,,,,,,,,,,,,,,,,6,,,,,,,,,,,,,,,,,,,,,,,,,,,,,,,,,12,,,,,,,,,,,,,,,,,,,,,,,,,,,,,,,,,9,,,,,,,,,,,,,,,,,,,,,,,,,,,,,,,,,14,,,,,,,,,,,,,,,,,,,,,,,,,,,,,,,,,4,,,,,,,,,,,,,,,,,,,,,,,,,,,,,,,,,1,1.0,5.0,5.0,5.0,4.0,3.0,1.0,3.0,6.0,4.0,4.0,2.0,3.0,1.0,4.0,3.0,5.0,1.0,4.0,1.0,1.0,6.0,5.0,3.0,2.0,3.0,2.0,5.0,4.0,3.0,4.0,4.0,3,,,,,,,,,,,,,,,,,,,,,,,,,,,,,,,,,5,,,,,,,,,,,,,,,,,,,,,,,,,,,,,,,,,0,3.0,6.0,1.0,3.0,1.0,5.0,3.0,5.0,5.0,4.0,3.0,3.0,4.0,3.0,3.0,4.0,6.0,1.0,4.0,1.0,5.0,4.0,4.0,3.0,1.0,6.0,1.0,1.0,6.0,1.0,5.0,7.0,8,,,,,,,,,,,,,,,,,,,,,,,,,,,,,,,,,next time make sure the server works well,444.79,16.07,,,,31.73,,90.23,,,,,66.36,,,,,,,,,,,,,,,,,,,,,,,,,,,92.05,,,,,,,,,116.89,,,,,,31.46,,APPROVED,Male,21.0,FALSE
64,2022-03-21 03:01:02,19,en,1862225285,2022-03-21 02:39:14,2022-03-21 03:01:02,Y,Y,A2,,,12,,,,,,,,,,,,,,,,,,,,,,,,,,,,,,,,,6,,,,,,,,,,,,,,,,,,,,,,,,,,,,,,,,,2,3.0,6.0,3.0,5.0,4.0,4.0,7.0,3.0,1.0,2.0,1.0,5.0,6.0,7.0,3.0,6.0,3.0,5.0,1.0,6.0,2.0,7.0,6.0,7.0,6.0,4.0,3.0,4.0,4.0,4.0,4.0,3.0,3,,,,,,,,,,,,,,,,,,,,,,,,,,,,,,,,,13,,,,,,,,,,,,,,,,,,,,,,,,,,,,,,,,,5,,,,,,,,,,,,,,,,,,,,,,,,,,,,,,,,,4,,,,,,,,,,,,,,,,,,,,,,,,,,,,,,,,,10,,,,,,,,,,,,,,,,,,,,,,,,,,,,,,,,,8,,,,,,,,,,,,,,,,,,,,,,,,,,,,,,,,,14,,,,,,,,,,,,,,,,,,,,,,,,,,,,,,,,,0,5.0,4.0,4.0,4.0,7.0,7.0,2.0,4.0,5.0,5.0,5.0,5.0,2.0,4.0,5.0,4.0,4.0,6.0,6.0,5.0,3.0,7.0,2.0,6.0,4.0,6.0,3.0,7.0,3.0,5.0,6.0,4.0,9,,,,,,,,,,,,,,,,,,,,,,,,,,,,,,,,,7,,,,,,,,,,,,,,,,,,,,,,,,,,,,,,,,,11,,,,,,,,,,,,,,,,,,,,,,,,,,,,,,,,,1,5.0,2.0,5.0,4.0,7.0,6.0,5.0,4.0,5.0,6.0,4.0,4.0,3.0,4.0,4.0,3.0,5.0,5.0,3.0,4.0,6.0,5.0,7.0,6.0,5.0,3.0,3.0,5.0,3.0,4.0,4.0,1.0,,149.76,11.02,,,,6.26,,3.87,,,,,,,,26.4,,,,,,,,,,,,,,,,,,,,,,,,66.2,,,,,,,,,,,,32.43,,,3.58,,APPROVED,Male,25.0,FALSE
70,2022-03-21 03:00:07,19,en,2070794714,2022-03-21 02:42:29,2022-03-21 03:00:07,Y,Y,A1,,,10,,,,,,,,,,,,,,,,,,,,,,,,,,,,,,,,,11,,,,,,,,,,,,,,,,,,,,,,,,,,,,,,,,,1,6.0,7.0,6.0,5.0,6.0,5.0,4.0,6.0,5.0,4.0,5.0,4.0,6.0,5.0,5.0,6.0,5.0,5.0,5.0,4.0,5.0,5.0,5.0,4.0,6.0,4.0,4.0,6.0,5.0,5.0,5.0,3.0,6,,,,,,,,,,,,,,,,,,,,,,,,,,,,,,,,,0,5.0,6.0,5.0,5.0,5.0,4.0,5.0,6.0,5.0,5.0,4.0,4.0,5.0,4.0,5.0,6.0,5.0,4.0,5.0,4.0,5.0,4.0,4.0,5.0,5.0,5.0,5.0,5.0,7.0,4.0,4.0,5.0,5,,,,,,,,,,,,,,,,,,,,,,,,,,,,,,,,,8,,,,,,,,,,,,,,,,,,,,,,,,,,,,,,,,,7,,,,,,,,,,,,,,,,,,,,,,,,,,,,,,,,,14,,,,,,,,,,,,,,,,,,,,,,,,,,,,,,,,,2,4.0,6.0,4.0,4.0,4.0,3.0,7.0,4.0,5.0,4.0,5.0,4.0,5.0,4.0,5.0,4.0,5.0,4.0,5.0,5.0,5.0,4.0,4.0,4.0,5.0,6.0,4.0,4.0,4.0,5.0,5.0,3.0,12,,,,,,,,,,,,,,,,,,,,,,,,,,,,,,,,,9,,,,,,,,,,,,,,,,,,,,,,,,,,,,,,,,,4,,,,,,,,,,,,,,,,,,,,,,,,,,,,,,,,,13,,,,,,,,,,,,,,,,,,,,,,,,,,,,,,,,,3,,,,,,,,,,,,,,,,,,,,,,,,,,,,,,,,,,393.17,27.19,,,,30.93,,37.71,,,,,,,,78.89,,,,,,125.14,,,,,,,,,,,,,,,84.56,,,,,,,,,,,,,,,,,,8.75,,APPROVED,Male,25.0,FALSE
78,2022-03-21 03:06:45,19,en,437024069,2022-03-21 02:43:27,2022-03-21 03:06:45,Y,Y,A1,,,14,,,,,,,,,,,,,,,,,,,,,,,,,,,,,,,,,11,,,,,,,,,,,,,,,,,,,,,,,,,,,,,,,,,3,,,,,,,,,,,,,,,,,,,,,,,,,,,,,,,,,9,,,,,,,,,,,,,,,,,,,,,,,,,,,,,,,,,2,6.0,6.0,6.0,3.0,4.0,2.0,7.0,7.0,6.0,5.0,6.0,6.0,5.0,5.0,6.0,6.0,6.0,6.0,6.0,6.0,6.0,5.0,5.0,7.0,6.0,2.0,5.0,5.0,6.0,3.0,6.0,7.0,7,,,,,,,,,,,,,,,,,,,,,,,,,,,,,,,,,4,,,,,,,,,,,,,,,,,,,,,,,,,,,,,,,,,8,,,,,,,,,,,,,,,,,,,,,,,,,,,,,,,,,1,5.0,2.0,2.0,4.0,2.0,2.0,3.0,5.0,6.0,2.0,2.0,3.0,5.0,1.0,5.0,3.0,6.0,1.0,5.0,2.0,4.0,3.0,5.0,5.0,2.0,2.0,6.0,5.0,4.0,3.0,5.0,2.0,10,,,,,,,,,,,,,,,,,,,,,,,,,,,,,,,,,13,,,,,,,,,,,,,,,,,,,,,,,,,,,,,,,,,0,3.0,3.0,4.0,2.0,3.0,2.0,7.0,1.0,5.0,3.0,3.0,4.0,4.0,4.0,6.0,1.0,6.0,2.0,5.0,3.0,2.0,3.0,2.0,3.0,3.0,2.0,6.0,2.0,3.0,3.0,1.0,5.0,5,,,,,,,,,,,,,,,,,,,,,,,,,,,,,,,,,6,,,,,,,,,,,,,,,,,,,,,,,,,,,,,,,,,12,,,,,,,,,,,,,,,,,,,,,,,,,,,,,,,,,,214.96,19.91,,,,6.83,,27.24,,,,,,,,,,,,,,48.19,,,,,,,,,,,,53.78,,,,,,,,,56.24,,,,,,,,,,,,2.77,,APPROVED,Male,21.0,FALSE
80,2022-03-21 03:02:48,19,en,1511282983,2022-03-21 02:43:45,2022-03-21 03:02:48,Y,Y,-oth-,highschool,,11,,,,,,,,,,,,,,,,,,,,,,,,,,,,,,,,,12,,,,,,,,,,,,,,,,,,,,,,,,,,,,,,,,,10,,,,,,,,,,,,,,,,,,,,,,,,,,,,,,,,,5,,,,,,,,,,,,,,,,,,,,,,,,,,,,,,,,,13,,,,,,,,,,,,,,,,,,,,,,,,,,,,,,,,,14,,,,,,,,,,,,,,,,,,,,,,,,,,,,,,,,,2,6.0,6.0,6.0,3.0,6.0,5.0,2.0,4.0,6.0,5.0,5.0,6.0,6.0,5.0,6.0,6.0,7.0,6.0,6.0,6.0,5.0,5.0,5.0,5.0,6.0,5.0,4.0,7.0,7.0,6.0,5.0,7.0,0,4.0,5.0,5.0,2.0,2.0,2.0,3.0,4.0,5.0,2.0,1.0,5.0,3.0,5.0,4.0,2.0,7.0,3.0,4.0,2.0,2.0,4.0,4.0,3.0,2.0,2.0,4.0,2.0,2.0,2.0,3.0,1.0,6,,,,,,,,,,,,,,,,,,,,,,,,,,,,,,,,,1,3.0,6.0,5.0,2.0,5.0,2.0,6.0,4.0,5.0,3.0,3.0,4.0,3.0,4.0,5.0,3.0,4.0,5.0,3.0,3.0,3.0,5.0,2.0,4.0,4.0,2.0,4.0,2.0,4.0,5.0,4.0,3.0,8,,,,,,,,,,,,,,,,,,,,,,,,,,,,,,,,,7,,,,,,,,,,,,,,,,,,,,,,,,,,,,,,,,,4,,,,,,,,,,,,,,,,,,,,,,,,,,,,,,,,,9,,,,,,,,,,,,,,,,,,,,,,,,,,,,,,,,,3,,,,,,,,,,,,,,,,,,,,,,,,,,,,,,,,,,671.2,171.93,,,,15.93,,64.95,,,,,,,,,,,,,,,,,,,,169.73,,,127.34,,,,,,117.0,,,,,,,,,,,,,,,,,,4.32,,APPROVED,Male,20.0,FALSE
83,2022-03-21 03:01:42,19,en,1827445594,2022-03-21 02:44:01,2022-03-21 03:01:42,Y,Y,A1,,,13,,,,,,,,,,,,,,,,,,,,,,,,,,,,,,,,,14,,,,,,,,,,,,,,,,,,,,,,,,,,,,,,,,,11,,,,,,,,,,,,,,,,,,,,,,,,,,,,,,,,,10,,,,,,,,,,,,,,,,,,,,,,,,,,,,,,,,,0,3.0,1.0,2.0,1.0,2.0,1.0,6.0,2.0,3.0,2.0,1.0,3.0,2.0,3.0,2.0,3.0,2.0,2.0,3.0,2.0,2.0,3.0,1.0,1.0,2.0,2.0,1.0,3.0,5.0,3.0,1.0,5.0,4,,,,,,,,,,,,,,,,,,,,,,,,,,,,,,,,,3,,,,,,,,,,,,,,,,,,,,,,,,,,,,,,,,,12,,,,,,,,,,,,,,,,,,,,,,,,,,,,,,,,,6,,,,,,,,,,,,,,,,,,,,,,,,,,,,,,,,,5,,,,,,,,,,,,,,,,,,,,,,,,,,,,,,,,,7,,,,,,,,,,,,,,,,,,,,,,,,,,,,,,,,,2,6.0,3.0,5.0,5.0,5.0,2.0,2.0,5.0,5.0,5.0,2.0,3.0,5.0,3.0,5.0,2.0,1.0,2.0,5.0,2.0,2.0,6.0,6.0,5.0,5.0,5.0,3.0,5.0,3.0,5.0,5.0,5.0,1,5.0,6.0,6.0,2.0,5.0,5.0,5.0,2.0,7.0,6.0,7.0,3.0,5.0,5.0,5.0,5.0,7.0,5.0,6.0,5.0,3.0,6.0,3.0,6.0,5.0,7.0,3.0,3.0,6.0,5.0,5.0,6.0,9,,,,,,,,,,,,,,,,,,,,,,,,,,,,,,,,,8,,,,,,,,,,,,,,,,,,,,,,,,,,,,,,,,,,1044.03,658.31,,,,14.73,,38.95,,,,,,,,,,,,,,127.72,,,,,,,,,,,,,,,,,,,,,108.72,,,91.85,,,,,,,,,3.75,,APPROVED,Male,20.0,FALSE
85,2022-03-21 03:03:16,19,en,489718320,2022-03-21 02:44:03,2022-03-21 03:03:16,Y,Y,A2,,,8,,,,,,,,,,,,,,,,,,,,,,,,,,,,,,,,,9,,,,,,,,,,,,,,,,,,,,,,,,,,,,,,,,,14,,,,,,,,,,,,,,,,,,,,,,,,,,,,,,,,,1,5.0,5.0,6.0,6.0,6.0,5.0,3.0,6.0,6.0,6.0,5.0,6.0,6.0,5.0,6.0,6.0,6.0,5.0,6.0,6.0,5.0,5.0,6.0,5.0,6.0,6.0,6.0,6.0,6.0,6.0,6.0,4.0,7,,,,,,,,,,,,,,,,,,,,,,,,,,,,,,,,,11,,,,,,,,,,,,,,,,,,,,,,,,,,,,,,,,,0,4.0,6.0,4.0,5.0,5.0,1.0,6.0,6.0,6.0,3.0,1.0,4.0,2.0,3.0,6.0,5.0,5.0,3.0,3.0,1.0,2.0,3.0,2.0,3.0,5.0,1.0,5.0,5.0,2.0,3.0,2.0,7.0,10,,,,,,,,,,,,,,,,,,,,,,,,,,,,,,,,,12,,,,,,,,,,,,,,,,,,,,,,,,,,,,,,,,,6,,,,,,,,,,,,,,,,,,,,,,,,,,,,,,,,,13,,,,,,,,,,,,,,,,,,,,,,,,,,,,,,,,,2,5.0,3.0,5.0,5.0,5.0,5.0,2.0,6.0,3.0,3.0,2.0,3.0,5.0,3.0,5.0,6.0,5.0,6.0,5.0,5.0,3.0,5.0,5.0,5.0,5.0,3.0,2.0,5.0,3.0,5.0,5.0,5.0,3,,,,,,,,,,,,,,,,,,,,,,,,,,,,,,,,,5,,,,,,,,,,,,,,,,,,,,,,,,,,,,,,,,,4,,,,,,,,,,,,,,,,,,,,,,,,,,,,,,,,,,1085.75,753.53,,,,8.38,,42.03,,,,,,,,,,,75.59,,,,,,,,,118.51,,,,,,,,,,,,,,,84.29,,,,,,,,,,,,3.42,,APPROVED,Male,24.0,FALSE
87,2022-03-21 03:04:51,19,en,1690803934,2022-03-21 02:44:05,2022-03-21 03:04:50,Y,Y,-oth-,high school diploma,,2,5.0,7.0,5.0,4.0,5.0,4.0,5.0,5.0,6.0,4.0,5.0,5.0,5.0,4.0,5.0,4.0,5.0,4.0,4.0,3.0,4.0,5.0,5.0,5.0,5.0,5.0,2.0,4.0,5.0,5.0,4.0,1.0,0,5.0,3.0,4.0,5.0,5.0,5.0,2.0,4.0,2.0,4.0,4.0,4.0,3.0,3.0,5.0,4.0,5.0,4.0,4.0,4.0,4.0,5.0,5.0,4.0,4.0,5.0,1.0,4.0,3.0,3.0,4.0,2.0,9,,,,,,,,,,,,,,,,,,,,,,,,,,,,,,,,,4,,,,,,,,,,,,,,,,,,,,,,,,,,,,,,,,,5,,,,,,,,,,,,,,,,,,,,,,,,,,,,,,,,,1,3.0,4.0,2.0,3.0,2.0,2.0,5.0,2.0,5.0,2.0,3.0,2.0,3.0,2.0,3.0,2.0,3.0,2.0,2.0,3.0,2.0,2.0,3.0,2.0,2.0,4.0,2.0,3.0,3.0,3.0,3.0,6.0,11,,,,,,,,,,,,,,,,,,,,,,,,,,,,,,,,,10,,,,,,,,,,,,,,,,,,,,,,,,,,,,,,,,,14,,,,,,,,,,,,,,,,,,,,,,,,,,,,,,,,,13,,,,,,,,,,,,,,,,,,,,,,,,,,,,,,,,,8,,,,,,,,,,,,,,,,,,,,,,,,,,,,,,,,,12,,,,,,,,,,,,,,,,,,,,,,,,,,,,,,,,,3,,,,,,,,,,,,,,,,,,,,,,,,,,,,,,,,,7,,,,,,,,,,,,,,,,,,,,,,,,,,,,,,,,,6,,,,,,,,,,,,,,,,,,,,,,,,,,,,,,,,,,771.92,409.13,,,,80.22,,31.81,,61.78,,,108.16,,,,,,,,,,,,75.82,,,,,,,,,,,,,,,,,,,,,,,,,,,,,,5.0,,APPROVED,Male,30.0,FALSE
88,2022-03-21 02:53:02,19,en,184887733,2022-03-21 02:44:20,2022-03-21 02:53:01,Y,Y,A2,,,12,,,,,,,,,,,,,,,,,,,,,,,,,,,,,,,,,9,,,,,,,,,,,,,,,,,,,,,,,,,,,,,,,,,6,,,,,,,,,,,,,,,,,,,,,,,,,,,,,,,,,3,,,,,,,,,,,,,,,,,,,,,,,,,,,,,,,,,2,4.0,5.0,4.0,4.0,3.0,4.0,5.0,5.0,3.0,3.0,5.0,5.0,3.0,2.0,3.0,2.0,2.0,5.0,5.0,3.0,4.0,4.0,3.0,4.0,4.0,6.0,3.0,4.0,5.0,4.0,4.0,5.0,10,,,,,,,,,,,,,,,,,,,,,,,,,,,,,,,,,13,,,,,,,,,,,,,,,,,,,,,,,,,,,,,,,,,0,3.0,5.0,5.0,3.0,3.0,2.0,5.0,5.0,5.0,3.0,1.0,3.0,3.0,3.0,5.0,3.0,3.0,3.0,3.0,3.0,4.0,2.0,1.0,2.0,3.0,1.0,4.0,4.0,2.0,2.0,2.0,1.0,5,,,,,,,,,,,,,,,,,,,,,,,,,,,,,,,,,8,,,,,,,,,,,,,,,,,,,,,,,,,,,,,,,,,7,,,,,,,,,,,,,,,,,,,,,,,,,,,,,,,,,4,,,,,,,,,,,,,,,,,,,,,,,,,,,,,,,,,1,5.0,5.0,5.0,2.0,3.0,2.0,5.0,5.0,5.0,2.0,2.0,4.0,3.0,4.0,5.0,1.0,5.0,1.0,2.0,3.0,4.0,4.0,1.0,3.0,4.0,3.0,4.0,3.0,2.0,3.0,1.0,6.0,14,,,,,,,,,,,,,,,,,,,,,,,,,,,,,,,,,11,,,,,,,,,,,,,,,,,,,,,,,,,,,,,,,,,,619.95,213.26,,,,80.55,,99.85,,,,,,,,,,,,,,76.5,,,,,,,,,70.47,,,,,,,,,,,,,,,70.26,,,,,,,,,9.06,,APPROVED,Male,29.0,FALSE
94,2022-03-21 02:55:01,19,en,332422048,2022-03-21 02:45:34,2022-03-21 02:55:01,Y,Y,A1,,,11,,,,,,,,,,,,,,,,,,,,,,,,,,,,,,,,,4,,,,,,,,,,,,,,,,,,,,,,,,,,,,,,,,,12,,,,,,,,,,,,,,,,,,,,,,,,,,,,,,,,,1,6.0,6.0,6.0,5.0,6.0,6.0,2.0,7.0,7.0,5.0,7.0,7.0,6.0,6.0,6.0,5.0,6.0,6.0,7.0,4.0,7.0,7.0,6.0,6.0,6.0,7.0,6.0,6.0,7.0,5.0,6.0,4.0,13,,,,,,,,,,,,,,,,,,,,,,,,,,,,,,,,,14,,,,,,,,,,,,,,,,,,,,,,,,,,,,,,,,,8,,,,,,,,,,,,,,,,,,,,,,,,,,,,,,,,,6,,,,,,,,,,,,,,,,,,,,,,,,,,,,,,,,,2,4.0,2.0,3.0,3.0,3.0,4.0,3.0,4.0,3.0,3.0,3.0,4.0,3.0,2.0,4.0,3.0,3.0,4.0,2.0,3.0,2.0,3.0,3.0,3.0,2.0,2.0,4.0,4.0,4.0,3.0,3.0,2.0,5,,,,,,,,,,,,,,,,,,,,,,,,,,,,,,,,,10,,,,,,,,,,,,,,,,,,,,,,,,,,,,,,,,,7,,,,,,,,,,,,,,,,,,,,,,,,,,,,,,,,,3,,,,,,,,,,,,,,,,,,,,,,,,,,,,,,,,,9,,,,,,,,,,,,,,,,,,,,,,,,,,,,,,,,,0,3.0,5.0,4.0,2.0,3.0,1.0,6.0,5.0,4.0,4.0,4.0,3.0,5.0,4.0,5.0,4.0,5.0,4.0,3.0,3.0,4.0,4.0,2.0,3.0,4.0,2.0,4.0,4.0,3.0,6.0,2.0,1.0,,561.54,115.27,,,,48.83,,80.78,,,,,,,,,,,76.04,,,,,,,,,,,,,,,64.53,,,,,,,,,,,,,,,,,,168.2,,,7.89,,APPROVED,Male,31.0,FALSE
95,2022-03-21 02:57:37,19,en,872441866,2022-03-21 02:45:34,2022-03-21 02:57:37,Y,Y,A2,,,2,2.0,6.0,3.0,2.0,3.0,3.0,6.0,3.0,6.0,3.0,3.0,5.0,5.0,5.0,5.0,1.0,5.0,2.0,5.0,3.0,2.0,4.0,5.0,3.0,3.0,4.0,2.0,4.0,5.0,5.0,5.0,1.0,7,,,,,,,,,,,,,,,,,,,,,,,,,,,,,,,,,0,6.0,6.0,6.0,6.0,6.0,6.0,2.0,7.0,3.0,6.0,7.0,4.0,6.0,6.0,5.0,6.0,6.0,6.0,6.0,4.0,5.0,6.0,6.0,6.0,6.0,5.0,4.0,5.0,3.0,4.0,6.0,3.0,10,,,,,,,,,,,,,,,,,,,,,,,,,,,,,,,,,14,,,,,,,,,,,,,,,,,,,,,,,,,,,,,,,,,6,,,,,,,,,,,,,,,,,,,,,,,,,,,,,,,,,1,1.0,1.0,1.0,1.0,1.0,2.0,6.0,1.0,1.0,1.0,1.0,1.0,1.0,1.0,1.0,1.0,1.0,2.0,1.0,1.0,1.0,1.0,1.0,1.0,1.0,1.0,5.0,1.0,1.0,1.0,1.0,7.0,3,,,,,,,,,,,,,,,,,,,,,,,,,,,,,,,,,13,,,,,,,,,,,,,,,,,,,,,,,,,,,,,,,,,12,,,,,,,,,,,,,,,,,,,,,,,,,,,,,,,,,9,,,,,,,,,,,,,,,,,,,,,,,,,,,,,,,,,5,,,,,,,,,,,,,,,,,,,,,,,,,,,,,,,,,11,,,,,,,,,,,,,,,,,,,,,,,,,,,,,,,,,8,,,,,,,,,,,,,,,,,,,,,,,,,,,,,,,,,4,,,,,,,,,,,,,,,,,,,,,,,,,,,,,,,,,,428.94,76.48,,,,80.51,,38.3,,78.69,,,,,,93.01,,,,,,,,,,,,54.11,,,,,,,,,,,,,,,,,,,,,,,,,,,7.84,,APPROVED,Male,27.0,FALSE
100,2022-03-21 03:00:55,19,en,1420463031,2022-03-21 02:46:18,2022-03-21 03:00:54,Y,Y,A1,,,10,,,,,,,,,,,,,,,,,,,,,,,,,,,,,,,,,12,,,,,,,,,,,,,,,,,,,,,,,,,,,,,,,,,1,6.0,7.0,7.0,2.0,6.0,7.0,2.0,6.0,5.0,2.0,7.0,7.0,7.0,5.0,7.0,5.0,6.0,7.0,7.0,6.0,5.0,6.0,6.0,5.0,6.0,6.0,5.0,7.0,6.0,7.0,5.0,3.0,13,,,,,,,,,,,,,,,,,,,,,,,,,,,,,,,,,2,3.0,2.0,1.0,4.0,2.0,2.0,7.0,1.0,2.0,2.0,1.0,2.0,1.0,2.0,3.0,1.0,2.0,1.0,4.0,2.0,1.0,2.0,3.0,2.0,1.0,2.0,3.0,3.0,1.0,2.0,3.0,5.0,5,,,,,,,,,,,,,,,,,,,,,,,,,,,,,,,,,4,,,,,,,,,,,,,,,,,,,,,,,,,,,,,,,,,11,,,,,,,,,,,,,,,,,,,,,,,,,,,,,,,,,9,,,,,,,,,,,,,,,,,,,,,,,,,,,,,,,,,0,2.0,4.0,1.0,2.0,2.0,1.0,7.0,1.0,5.0,1.0,1.0,1.0,1.0,1.0,5.0,3.0,5.0,1.0,1.0,1.0,4.0,1.0,3.0,3.0,1.0,6.0,6.0,1.0,5.0,2.0,4.0,3.0,14,,,,,,,,,,,,,,,,,,,,,,,,,,,,,,,,,7,,,,,,,,,,,,,,,,,,,,,,,,,,,,,,,,,6,,,,,,,,,,,,,,,,,,,,,,,,,,,,,,,,,3,,,,,,,,,,,,,,,,,,,,,,,,,,,,,,,,,8,,,,,,,,,,,,,,,,,,,,,,,,,,,,,,,,,,296.39,5.55,,,,6.68,,23.63,,,,,,,,63.17,,,,,,59.87,,,,,,,,,,,,,,,133.51,,,,,,,,,,,,,,,,,,3.98,,APPROVED,Male,21.0,FALSE
106,2022-03-21 03:06:10,19,en,5731944,2022-03-21 02:46:27,2022-03-21 03:06:10,Y,Y,-oth-,TAFE Cert IV,,11,,,,,,,,,,,,,,,,,,,,,,,,,,,,,,,,,1,4.0,5.0,4.0,5.0,3.0,5.0,3.0,5.0,3.0,3.0,4.0,4.0,3.0,3.0,3.0,5.0,5.0,3.0,4.0,3.0,3.0,5.0,5.0,4.0,4.0,5.0,4.0,4.0,2.0,4.0,5.0,2.0,13,,,,,,,,,,,,,,,,,,,,,,,,,,,,,,,,,12,,,,,,,,,,,,,,,,,,,,,,,,,,,,,,,,,8,,,,,,,,,,,,,,,,,,,,,,,,,,,,,,,,,10,,,,,,,,,,,,,,,,,,,,,,,,,,,,,,,,,14,,,,,,,,,,,,,,,,,,,,,,,,,,,,,,,,,3,,,,,,,,,,,,,,,,,,,,,,,,,,,,,,,,,6,,,,,,,,,,,,,,,,,,,,,,,,,,,,,,,,,7,,,,,,,,,,,,,,,,,,,,,,,,,,,,,,,,,0,3.0,5.0,3.0,3.0,4.0,3.0,5.0,4.0,5.0,2.0,3.0,5.0,5.0,4.0,4.0,3.0,5.0,5.0,4.0,4.0,3.0,3.0,3.0,4.0,4.0,4.0,5.0,4.0,5.0,3.0,3.0,4.0,2,6.0,6.0,6.0,4.0,5.0,5.0,3.0,5.0,6.0,5.0,4.0,5.0,5.0,5.0,5.0,5.0,6.0,6.0,5.0,5.0,5.0,5.0,5.0,5.0,5.0,4.0,5.0,4.0,5.0,4.0,4.0,5.0,9,,,,,,,,,,,,,,,,,,,,,,,,,,,,,,,,,5,,,,,,,,,,,,,,,,,,,,,,,,,,,,,,,,,4,,,,,,,,,,,,,,,,,,,,,,,,,,,,,,,,,,765.9,44.64,,,,24.76,,34.94,,,,,212.64,,,,,,,,,,,,,,,,,,,,,,,,,,,254.17,,,164.01,,,,,,,,,,,,30.74,,APPROVED,Female,54.0,FALSE
110,2022-03-21 03:09:12,19,en,2105924160,2022-03-21 02:46:59,2022-03-21 03:09:12,Y,Y,A1,,,9,,,,,,,,,,,,,,,,,,,,,,,,,,,,,,,,,14,,,,,,,,,,,,,,,,,,,,,,,,,,,,,,,,,12,,,,,,,,,,,,,,,,,,,,,,,,,,,,,,,,,6,,,,,,,,,,,,,,,,,,,,,,,,,,,,,,,,,2,5.0,4.0,5.0,1.0,4.0,6.0,5.0,5.0,7.0,5.0,6.0,5.0,5.0,5.0,4.0,1.0,5.0,6.0,4.0,4.0,4.0,6.0,5.0,4.0,6.0,5.0,5.0,5.0,5.0,5.0,5.0,5.0,13,,,,,,,,,,,,,,,,,,,,,,,,,,,,,,,,,5,,,,,,,,,,,,,,,,,,,,,,,,,,,,,,,,,0,5.0,3.0,5.0,3.0,5.0,5.0,3.0,1.0,6.0,5.0,3.0,5.0,4.0,2.0,6.0,3.0,7.0,5.0,5.0,3.0,3.0,5.0,3.0,4.0,3.0,4.0,5.0,3.0,5.0,5.0,5.0,1.0,7,,,,,,,,,,,,,,,,,,,,,,,,,,,,,,,,,4,,,,,,,,,,,,,,,,,,,,,,,,,,,,,,,,,3,,,,,,,,,,,,,,,,,,,,,,,,,,,,,,,,,8,,,,,,,,,,,,,,,,,,,,,,,,,,,,,,,,,1,5.0,3.0,6.0,4.0,4.0,6.0,5.0,2.0,6.0,6.0,6.0,5.0,5.0,5.0,5.0,4.0,7.0,6.0,5.0,6.0,4.0,5.0,6.0,5.0,5.0,5.0,5.0,5.0,6.0,5.0,6.0,6.0,10,,,,,,,,,,,,,,,,,,,,,,,,,,,,,,,,,11,,,,,,,,,,,,,,,,,,,,,,,,,,,,,,,,,I have a lot of problems to open the survey but i could finish it ,1231.75,537.63,,,,13.47,,116.91,,,,,,,,,,,,,,154.49,,,,,,,,,148.72,,,,,,,,,,,,,,,225.05,,,,,,,,,35.48,,APPROVED,Male,24.0,FALSE
113,2022-03-21 03:10:36,19,en,1191795150,2022-03-21 02:47:17,2022-03-21 03:10:36,Y,Y,A1,,,10,,,,,,,,,,,,,,,,,,,,,,,,,,,,,,,,,11,,,,,,,,,,,,,,,,,,,,,,,,,,,,,,,,,0,7.0,7.0,7.0,7.0,7.0,5.0,2.0,7.0,7.0,4.0,7.0,6.0,7.0,5.0,7.0,7.0,7.0,4.0,7.0,5.0,7.0,7.0,7.0,7.0,7.0,7.0,5.0,7.0,6.0,6.0,6.0,3.0,4,,,,,,,,,,,,,,,,,,,,,,,,,,,,,,,,,2,1.0,1.0,1.0,4.0,1.0,1.0,7.0,3.0,1.0,1.0,1.0,1.0,1.0,1.0,1.0,1.0,1.0,1.0,4.0,4.0,1.0,1.0,1.0,1.0,1.0,4.0,3.0,1.0,1.0,7.0,1.0,5.0,9,,,,,,,,,,,,,,,,,,,,,,,,,,,,,,,,,13,,,,,,,,,,,,,,,,,,,,,,,,,,,,,,,,,7,,,,,,,,,,,,,,,,,,,,,,,,,,,,,,,,,6,,,,,,,,,,,,,,,,,,,,,,,,,,,,,,,,,5,,,,,,,,,,,,,,,,,,,,,,,,,,,,,,,,,3,,,,,,,,,,,,,,,,,,,,,,,,,,,,,,,,,12,,,,,,,,,,,,,,,,,,,,,,,,,,,,,,,,,1,3.0,5.0,1.0,1.0,2.0,1.0,3.0,1.0,7.0,1.0,2.0,3.0,3.0,2.0,5.0,3.0,3.0,1.0,3.0,2.0,3.0,4.0,2.0,1.0,3.0,7.0,1.0,3.0,5.0,3.0,1.0,6.0,8,,,,,,,,,,,,,,,,,,,,,,,,,,,,,,,,,14,,,,,,,,,,,,,,,,,,,,,,,,,,,,,,,,,,161.95,11.6,,,,6.61,,19.22,,,,,,,,39.42,,,,,,45.97,,,,,,,,,,,,,,,,,,,,,,,,35.9,,,,,,,,,3.23,,APPROVED,Male,21.0,FALSE
120,2022-03-21 03:06:01,19,en,810036224,2022-03-21 02:47:30,2022-03-21 03:06:01,Y,Y,A1,,,4,,,,,,,,,,,,,,,,,,,,,,,,,,,,,,,,,8,,,,,,,,,,,,,,,,,,,,,,,,,,,,,,,,,13,,,,,,,,,,,,,,,,,,,,,,,,,,,,,,,,,14,,,,,,,,,,,,,,,,,,,,,,,,,,,,,,,,,5,,,,,,,,,,,,,,,,,,,,,,,,,,,,,,,,,2,2.0,3.0,3.0,2.0,4.0,4.0,1.0,2.0,2.0,2.0,2.0,1.0,4.0,1.0,2.0,3.0,3.0,4.0,2.0,3.0,2.0,3.0,2.0,2.0,3.0,1.0,1.0,4.0,1.0,4.0,2.0,6.0,1,1.0,2.0,1.0,2.0,1.0,2.0,2.0,2.0,1.0,1.0,1.0,1.0,1.0,1.0,2.0,1.0,1.0,2.0,1.0,1.0,1.0,2.0,3.0,2.0,1.0,4.0,1.0,1.0,1.0,1.0,1.0,1.0,7,,,,,,,,,,,,,,,,,,,,,,,,,,,,,,,,,12,,,,,,,,,,,,,,,,,,,,,,,,,,,,,,,,,9,,,,,,,,,,,,,,,,,,,,,,,,,,,,,,,,,6,,,,,,,,,,,,,,,,,,,,,,,,,,,,,,,,,3,,,,,,,,,,,,,,,,,,,,,,,,,,,,,,,,,11,,,,,,,,,,,,,,,,,,,,,,,,,,,,,,,,,10,,,,,,,,,,,,,,,,,,,,,,,,,,,,,,,,,0,5.0,6.0,5.0,4.0,4.0,5.0,1.0,6.0,6.0,4.0,6.0,5.0,5.0,2.0,5.0,5.0,1.0,4.0,4.0,4.0,4.0,4.0,2.0,5.0,4.0,4.0,2.0,4.0,6.0,6.0,6.0,1.0,Sorry for the delay.My internet connection is extremely slow at this moment.,967.32,105.23,,,,21.39,,98.99,,,,,,,,,,,,,,,,,135.44,,,115.15,,,,,,,,,,,,,,,,,,,,,,,,411.97,,,79.15,,APPROVED,Female,65.0,FALSE
121,2022-03-21 03:00:48,19,en,1592864634,2022-03-21 02:47:30,2022-03-21 03:00:48,Y,Y,A2,,,0,5.0,7.0,5.0,4.0,5.0,3.0,3.0,6.0,6.0,5.0,5.0,4.0,5.0,4.0,5.0,5.0,4.0,5.0,4.0,5.0,5.0,5.0,4.0,4.0,4.0,5.0,6.0,4.0,6.0,4.0,4.0,1.0,13,,,,,,,,,,,,,,,,,,,,,,,,,,,,,,,,,11,,,,,,,,,,,,,,,,,,,,,,,,,,,,,,,,,3,,,,,,,,,,,,,,,,,,,,,,,,,,,,,,,,,9,,,,,,,,,,,,,,,,,,,,,,,,,,,,,,,,,8,,,,,,,,,,,,,,,,,,,,,,,,,,,,,,,,,2,6.0,6.0,6.0,5.0,5.0,4.0,3.0,6.0,7.0,5.0,5.0,6.0,6.0,5.0,5.0,4.0,7.0,4.0,6.0,5.0,5.0,5.0,5.0,5.0,5.0,6.0,6.0,5.0,6.0,6.0,6.0,7.0,1,5.0,4.0,4.0,6.0,4.0,5.0,4.0,5.0,4.0,4.0,5.0,5.0,5.0,3.0,3.0,5.0,5.0,5.0,5.0,4.0,5.0,5.0,6.0,5.0,4.0,5.0,3.0,5.0,4.0,5.0,6.0,1.0,14,,,,,,,,,,,,,,,,,,,,,,,,,,,,,,,,,12,,,,,,,,,,,,,,,,,,,,,,,,,,,,,,,,,4,,,,,,,,,,,,,,,,,,,,,,,,,,,,,,,,,5,,,,,,,,,,,,,,,,,,,,,,,,,,,,,,,,,7,,,,,,,,,,,,,,,,,,,,,,,,,,,,,,,,,10,,,,,,,,,,,,,,,,,,,,,,,,,,,,,,,,,6,,,,,,,,,,,,,,,,,,,,,,,,,,,,,,,,,difficult to evaluate ome characteristics without seeing information represented,728.67,254.18,,,,15.32,,71.88,,117.92,,,,,,,,,,,,,,,,,,96.16,,,100.95,,,,,,,,,,,,,,,,,,,,,,,,72.26,,APPROVED,Male,49.0,FALSE
128,2022-03-21 02:56:10,19,en,1764042121,2022-03-21 02:48:02,2022-03-21 02:56:10,Y,Y,A1,,,8,,,,,,,,,,,,,,,,,,,,,,,,,,,,,,,,,2,7.0,5.0,3.0,7.0,7.0,7.0,1.0,7.0,5.0,5.0,5.0,6.0,5.0,6.0,6.0,7.0,5.0,7.0,6.0,3.0,2.0,7.0,6.0,6.0,6.0,7.0,4.0,6.0,7.0,6.0,6.0,2.0,1,7.0,7.0,5.0,7.0,7.0,7.0,3.0,7.0,7.0,7.0,7.0,7.0,6.0,7.0,7.0,6.0,7.0,5.0,6.0,6.0,6.0,7.0,7.0,6.0,7.0,7.0,6.0,7.0,7.0,7.0,7.0,3.0,0,6.0,3.0,2.0,3.0,6.0,3.0,5.0,6.0,6.0,4.0,5.0,7.0,6.0,7.0,6.0,2.0,7.0,2.0,5.0,2.0,2.0,5.0,5.0,3.0,5.0,6.0,5.0,6.0,6.0,5.0,6.0,4.0,13,,,,,,,,,,,,,,,,,,,,,,,,,,,,,,,,,7,,,,,,,,,,,,,,,,,,,,,,,,,,,,,,,,,9,,,,,,,,,,,,,,,,,,,,,,,,,,,,,,,,,11,,,,,,,,,,,,,,,,,,,,,,,,,,,,,,,,,5,,,,,,,,,,,,,,,,,,,,,,,,,,,,,,,,,10,,,,,,,,,,,,,,,,,,,,,,,,,,,,,,,,,14,,,,,,,,,,,,,,,,,,,,,,,,,,,,,,,,,6,,,,,,,,,,,,,,,,,,,,,,,,,,,,,,,,,3,,,,,,,,,,,,,,,,,,,,,,,,,,,,,,,,,4,,,,,,,,,,,,,,,,,,,,,,,,,,,,,,,,,12,,,,,,,,,,,,,,,,,,,,,,,,,,,,,,,,,,379.51,38.54,,,,43.04,,76.25,,,,,50.47,,,51.64,,,88.99,,,,,,,,,,,,,,,,,,,,,,,,,,,,,,,,,,,,30.58,,APPROVED,Male,25.0,FALSE
130,2022-03-21 02:55:01,19,en,1221123849,2022-03-21 02:48:05,2022-03-21 02:55:01,Y,Y,A1,,,14,,,,,,,,,,,,,,,,,,,,,,,,,,,,,,,,,10,,,,,,,,,,,,,,,,,,,,,,,,,,,,,,,,,5,,,,,,,,,,,,,,,,,,,,,,,,,,,,,,,,,4,,,,,,,,,,,,,,,,,,,,,,,,,,,,,,,,,3,,,,,,,,,,,,,,,,,,,,,,,,,,,,,,,,,7,,,,,,,,,,,,,,,,,,,,,,,,,,,,,,,,,6,,,,,,,,,,,,,,,,,,,,,,,,,,,,,,,,,2,6.0,7.0,7.0,5.0,5.0,7.0,3.0,4.0,5.0,7.0,5.0,7.0,7.0,5.0,5.0,7.0,6.0,5.0,7.0,6.0,5.0,7.0,6.0,5.0,6.0,6.0,5.0,6.0,7.0,6.0,7.0,1.0,13,,,,,,,,,,,,,,,,,,,,,,,,,,,,,,,,,1,2.0,6.0,1.0,2.0,2.0,1.0,7.0,2.0,6.0,5.0,2.0,2.0,2.0,3.0,6.0,2.0,4.0,3.0,3.0,3.0,5.0,1.0,2.0,3.0,1.0,5.0,5.0,3.0,2.0,2.0,1.0,3.0,12,,,,,,,,,,,,,,,,,,,,,,,,,,,,,,,,,11,,,,,,,,,,,,,,,,,,,,,,,,,,,,,,,,,0,2.0,7.0,4.0,4.0,4.0,3.0,5.0,3.0,7.0,4.0,3.0,2.0,6.0,5.0,4.0,4.0,6.0,3.0,3.0,5.0,4.0,6.0,3.0,3.0,5.0,5.0,5.0,3.0,4.0,4.0,6.0,6.0,9,,,,,,,,,,,,,,,,,,,,,,,,,,,,,,,,,8,,,,,,,,,,,,,,,,,,,,,,,,,,,,,,,,,,415.08,32.78,,,,32.36,,28.72,,,,,,,,,,,,,,,,,,,,,,,77.38,,,,,,81.3,,,,,,,,,158.35,,,,,,,,,4.19,,APPROVED,Male,20.0,FALSE
132,2022-03-21 02:57:25,19,en,1471626685,2022-03-21 02:48:06,2022-03-21 02:57:24,Y,Y,A1,,,10,,,,,,,,,,,,,,,,,,,,,,,,,,,,,,,,,0,5.0,4.0,6.0,5.0,4.0,5.0,2.0,4.0,4.0,4.0,5.0,4.0,4.0,4.0,4.0,5.0,6.0,4.0,5.0,4.0,4.0,5.0,6.0,4.0,5.0,6.0,2.0,5.0,3.0,3.0,6.0,2.0,7,,,,,,,,,,,,,,,,,,,,,,,,,,,,,,,,,6,,,,,,,,,,,,,,,,,,,,,,,,,,,,,,,,,4,,,,,,,,,,,,,,,,,,,,,,,,,,,,,,,,,2,3.0,7.0,4.0,4.0,4.0,3.0,6.0,5.0,6.0,4.0,3.0,4.0,4.0,3.0,5.0,3.0,5.0,3.0,5.0,3.0,3.0,4.0,3.0,4.0,4.0,5.0,4.0,3.0,5.0,3.0,4.0,6.0,8,,,,,,,,,,,,,,,,,,,,,,,,,,,,,,,,,11,,,,,,,,,,,,,,,,,,,,,,,,,,,,,,,,,9,,,,,,,,,,,,,,,,,,,,,,,,,,,,,,,,,3,,,,,,,,,,,,,,,,,,,,,,,,,,,,,,,,,13,,,,,,,,,,,,,,,,,,,,,,,,,,,,,,,,,14,,,,,,,,,,,,,,,,,,,,,,,,,,,,,,,,,5,,,,,,,,,,,,,,,,,,,,,,,,,,,,,,,,,12,,,,,,,,,,,,,,,,,,,,,,,,,,,,,,,,,1,4.0,6.0,5.0,5.0,5.0,3.0,5.0,6.0,5.0,4.0,5.0,5.0,4.0,5.0,5.0,4.0,5.0,4.0,4.0,4.0,4.0,4.0,3.0,4.0,4.0,4.0,4.0,4.0,6.0,3.0,3.0,1.0,,552.7,117.59,,,,19.47,,69.8,,,,,122.68,,,,,,,,,,,,108.74,,,,,,,,,,,,,,,,,,,,,,,,,,,109.42,,,5.0,,APPROVED,Male,25.0,FALSE
133,2022-03-21 03:00:49,19,en,1601392916,2022-03-21 02:48:09,2022-03-21 03:00:49,Y,Y,A1,,,11,,,,,,,,,,,,,,,,,,,,,,,,,,,,,,,,,3,,,,,,,,,,,,,,,,,,,,,,,,,,,,,,,,,0,6.0,6.0,4.0,4.0,6.0,4.0,4.0,4.0,6.0,5.0,6.0,5.0,5.0,6.0,5.0,4.0,5.0,5.0,5.0,5.0,5.0,5.0,4.0,6.0,5.0,3.0,5.0,6.0,3.0,4.0,3.0,3.0,13,,,,,,,,,,,,,,,,,,,,,,,,,,,,,,,,,5,,,,,,,,,,,,,,,,,,,,,,,,,,,,,,,,,4,,,,,,,,,,,,,,,,,,,,,,,,,,,,,,,,,6,,,,,,,,,,,,,,,,,,,,,,,,,,,,,,,,,10,,,,,,,,,,,,,,,,,,,,,,,,,,,,,,,,,12,,,,,,,,,,,,,,,,,,,,,,,,,,,,,,,,,14,,,,,,,,,,,,,,,,,,,,,,,,,,,,,,,,,9,,,,,,,,,,,,,,,,,,,,,,,,,,,,,,,,,8,,,,,,,,,,,,,,,,,,,,,,,,,,,,,,,,,1,1.0,1.0,1.0,4.0,1.0,1.0,4.0,4.0,1.0,1.0,1.0,1.0,1.0,1.0,1.0,1.0,5.0,1.0,1.0,1.0,1.0,1.0,1.0,1.0,1.0,1.0,1.0,1.0,1.0,1.0,1.0,6.0,7,,,,,,,,,,,,,,,,,,,,,,,,,,,,,,,,,2,4.0,6.0,3.0,4.0,4.0,3.0,4.0,3.0,6.0,4.0,5.0,4.0,5.0,5.0,5.0,4.0,6.0,4.0,5.0,4.0,5.0,5.0,4.0,5.0,4.0,2.0,4.0,5.0,5.0,4.0,2.0,1.0,,761.39,447.54,,,,101.67,,9.09,,,,,,,,67.23,,,,,,,,,,,,,,,,,,,,,,,,,,,,,,57.78,,,,,,74.46,,,3.62,,APPROVED,Male,29.0,FALSE
135,2022-03-21 03:02:03,19,en,226592697,2022-03-21 02:48:19,2022-03-21 03:02:03,Y,Y,A1,,,14,,,,,,,,,,,,,,,,,,,,,,,,,,,,,,,,,9,,,,,,,,,,,,,,,,,,,,,,,,,,,,,,,,,6,,,,,,,,,,,,,,,,,,,,,,,,,,,,,,,,,8,,,,,,,,,,,,,,,,,,,,,,,,,,,,,,,,,13,,,,,,,,,,,,,,,,,,,,,,,,,,,,,,,,,12,,,,,,,,,,,,,,,,,,,,,,,,,,,,,,,,,2,2.0,2.0,2.0,5.0,2.0,4.0,2.0,4.0,2.0,2.0,2.0,2.0,2.0,2.0,2.0,4.0,2.0,2.0,2.0,2.0,2.0,2.0,4.0,2.0,2.0,2.0,2.0,2.0,2.0,2.0,3.0,7.0,10,,,,,,,,,,,,,,,,,,,,,,,,,,,,,,,,,5,,,,,,,,,,,,,,,,,,,,,,,,,,,,,,,,,11,,,,,,,,,,,,,,,,,,,,,,,,,,,,,,,,,0,4.0,5.0,4.0,4.0,3.0,4.0,5.0,5.0,5.0,3.0,2.0,4.0,4.0,4.0,5.0,3.0,5.0,2.0,4.0,3.0,3.0,4.0,4.0,4.0,3.0,2.0,5.0,3.0,5.0,3.0,2.0,4.0,1,2.0,2.0,2.0,2.0,2.0,2.0,2.0,2.0,2.0,1.0,2.0,1.0,2.0,2.0,2.0,1.0,2.0,1.0,2.0,2.0,1.0,2.0,2.0,1.0,2.0,2.0,2.0,2.0,2.0,2.0,2.0,5.0,7,,,,,,,,,,,,,,,,,,,,,,,,,,,,,,,,,4,,,,,,,,,,,,,,,,,,,,,,,,,,,,,,,,,3,,,,,,,,,,,,,,,,,,,,,,,,,,,,,,,,,,526.96,42.78,,,,6.81,,27.51,,,,,,,,,,,,,,,,,,,,159.35,,,,,,,,,,,,154.24,,,131.09,,,,,,,,,,,,5.18,,APPROVED,Female,49.0,FALSE
137,2022-03-21 02:56:16,19,en,1589157266,2022-03-21 02:48:35,2022-03-21 02:56:15,Y,Y,A1,,,4,,,,,,,,,,,,,,,,,,,,,,,,,,,,,,,,,12,,,,,,,,,,,,,,,,,,,,,,,,,,,,,,,,,11,,,,,,,,,,,,,,,,,,,,,,,,,,,,,,,,,8,,,,,,,,,,,,,,,,,,,,,,,,,,,,,,,,,9,,,,,,,,,,,,,,,,,,,,,,,,,,,,,,,,,13,,,,,,,,,,,,,,,,,,,,,,,,,,,,,,,,,3,,,,,,,,,,,,,,,,,,,,,,,,,,,,,,,,,2,4.0,2.0,3.0,3.0,5.0,1.0,1.0,5.0,5.0,3.0,1.0,6.0,4.0,3.0,5.0,4.0,5.0,2.0,5.0,3.0,5.0,5.0,1.0,2.0,2.0,5.0,3.0,4.0,5.0,5.0,1.0,1.0,7,,,,,,,,,,,,,,,,,,,,,,,,,,,,,,,,,14,,,,,,,,,,,,,,,,,,,,,,,,,,,,,,,,,6,,,,,,,,,,,,,,,,,,,,,,,,,,,,,,,,,5,,,,,,,,,,,,,,,,,,,,,,,,,,,,,,,,,10,,,,,,,,,,,,,,,,,,,,,,,,,,,,,,,,,0,3.0,2.0,4.0,3.0,3.0,4.0,6.0,3.0,5.0,3.0,3.0,5.0,2.0,4.0,5.0,3.0,5.0,3.0,3.0,2.0,2.0,4.0,6.0,2.0,2.0,5.0,5.0,3.0,5.0,3.0,4.0,7.0,1,3.0,6.0,5.0,1.0,5.0,2.0,7.0,6.0,5.0,6.0,5.0,1.0,5.0,1.0,6.0,5.0,5.0,4.0,5.0,1.0,4.0,5.0,1.0,5.0,4.0,5.0,3.0,1.0,6.0,5.0,1.0,1.0,None.,461.7,80.3,,,,65.29,,77.64,,,,,,,,,,,,,,,,,,,,,,,68.92,,,,,,,,,,,,,,,,,,87.32,,,74.21,,,8.02,,APPROVED,Male,28.0,FALSE
142,2022-03-21 02:56:27,19,en,1317378532,2022-03-21 02:49:37,2022-03-21 02:56:27,Y,Y,A1,,,1,6.0,6.0,7.0,3.0,4.0,3.0,3.0,3.0,6.0,5.0,5.0,3.0,4.0,5.0,5.0,3.0,6.0,4.0,3.0,4.0,5.0,4.0,4.0,3.0,4.0,3.0,5.0,5.0,5.0,3.0,3.0,7.0,8,,,,,,,,,,,,,,,,,,,,,,,,,,,,,,,,,11,,,,,,,,,,,,,,,,,,,,,,,,,,,,,,,,,2,6.0,5.0,5.0,5.0,5.0,5.0,4.0,4.0,7.0,5.0,4.0,4.0,5.0,6.0,5.0,5.0,5.0,6.0,5.0,5.0,6.0,5.0,6.0,6.0,5.0,5.0,5.0,6.0,3.0,6.0,6.0,4.0,10,,,,,,,,,,,,,,,,,,,,,,,,,,,,,,,,,0,2.0,3.0,4.0,4.0,3.0,4.0,4.0,6.0,6.0,4.0,3.0,3.0,3.0,5.0,3.0,4.0,5.0,5.0,5.0,3.0,3.0,5.0,3.0,4.0,3.0,2.0,2.0,5.0,3.0,4.0,4.0,6.0,13,,,,,,,,,,,,,,,,,,,,,,,,,,,,,,,,,9,,,,,,,,,,,,,,,,,,,,,,,,,,,,,,,,,14,,,,,,,,,,,,,,,,,,,,,,,,,,,,,,,,,4,,,,,,,,,,,,,,,,,,,,,,,,,,,,,,,,,12,,,,,,,,,,,,,,,,,,,,,,,,,,,,,,,,,7,,,,,,,,,,,,,,,,,,,,,,,,,,,,,,,,,6,,,,,,,,,,,,,,,,,,,,,,,,,,,,,,,,,5,,,,,,,,,,,,,,,,,,,,,,,,,,,,,,,,,3,,,,,,,,,,,,,,,,,,,,,,,,,,,,,,,,,,410.56,65.99,,,,55.2,,73.72,,60.18,,,,,,,,,66.73,,,,,,84.16,,,,,,,,,,,,,,,,,,,,,,,,,,,,,,4.58,,APPROVED,Female,28.0,FALSE
146,2022-03-21 03:00:54,19,en,428997796,2022-03-21 02:49:54,2022-03-21 03:00:54,Y,Y,A2,,,9,,,,,,,,,,,,,,,,,,,,,,,,,,,,,,,,,5,,,,,,,,,,,,,,,,,,,,,,,,,,,,,,,,,13,,,,,,,,,,,,,,,,,,,,,,,,,,,,,,,,,1,6.0,6.0,7.0,5.0,7.0,5.0,4.0,5.0,7.0,6.0,6.0,5.0,7.0,6.0,7.0,5.0,7.0,6.0,6.0,5.0,6.0,6.0,6.0,5.0,5.0,7.0,3.0,7.0,7.0,3.0,7.0,4.0,4,,,,,,,,,,,,,,,,,,,,,,,,,,,,,,,,,8,,,,,,,,,,,,,,,,,,,,,,,,,,,,,,,,,0,6.0,6.0,6.0,6.0,5.0,5.0,4.0,6.0,5.0,3.0,5.0,5.0,5.0,5.0,5.0,6.0,6.0,5.0,5.0,3.0,3.0,5.0,6.0,3.0,5.0,6.0,2.0,5.0,5.0,2.0,6.0,7.0,2,2.0,1.0,1.0,2.0,1.0,3.0,2.0,1.0,2.0,2.0,1.0,2.0,1.0,1.0,2.0,1.0,1.0,1.0,1.0,1.0,2.0,2.0,2.0,2.0,1.0,1.0,4.0,2.0,1.0,1.0,2.0,1.0,12,,,,,,,,,,,,,,,,,,,,,,,,,,,,,,,,,3,,,,,,,,,,,,,,,,,,,,,,,,,,,,,,,,,6,,,,,,,,,,,,,,,,,,,,,,,,,,,,,,,,,14,,,,,,,,,,,,,,,,,,,,,,,,,,,,,,,,,10,,,,,,,,,,,,,,,,,,,,,,,,,,,,,,,,,7,,,,,,,,,,,,,,,,,,,,,,,,,,,,,,,,,11,,,,,,,,,,,,,,,,,,,,,,,,,,,,,,,,,,662.13,125.59,,,,22.76,,51.6,,,,,,,,,,,113.15,,,,,,,,,151.4,,,192.65,,,,,,,,,,,,,,,,,,,,,,,,4.98,,APPROVED,Male,35.0,FALSE
147,2022-03-21 02:59:00,19,en,1674609712,2022-03-21 02:49:55,2022-03-21 02:59:00,Y,Y,A2,,,14,,,,,,,,,,,,,,,,,,,,,,,,,,,,,,,,,8,,,,,,,,,,,,,,,,,,,,,,,,,,,,,,,,,5,,,,,,,,,,,,,,,,,,,,,,,,,,,,,,,,,12,,,,,,,,,,,,,,,,,,,,,,,,,,,,,,,,,6,,,,,,,,,,,,,,,,,,,,,,,,,,,,,,,,,2,4.0,6.0,4.0,4.0,5.0,3.0,6.0,6.0,6.0,5.0,3.0,4.0,6.0,6.0,4.0,5.0,5.0,3.0,5.0,5.0,4.0,5.0,3.0,5.0,5.0,3.0,3.0,5.0,5.0,4.0,2.0,6.0,4,,,,,,,,,,,,,,,,,,,,,,,,,,,,,,,,,1,7.0,6.0,7.0,7.0,7.0,7.0,6.0,5.0,6.0,5.0,6.0,6.0,6.0,6.0,5.0,7.0,6.0,7.0,7.0,7.0,6.0,7.0,6.0,7.0,6.0,6.0,5.0,7.0,6.0,6.0,7.0,1.0,13,,,,,,,,,,,,,,,,,,,,,,,,,,,,,,,,,11,,,,,,,,,,,,,,,,,,,,,,,,,,,,,,,,,7,,,,,,,,,,,,,,,,,,,,,,,,,,,,,,,,,3,,,,,,,,,,,,,,,,,,,,,,,,,,,,,,,,,10,,,,,,,,,,,,,,,,,,,,,,,,,,,,,,,,,9,,,,,,,,,,,,,,,,,,,,,,,,,,,,,,,,,0,7.0,7.0,7.0,5.0,7.0,6.0,4.0,7.0,7.0,7.0,6.0,7.0,7.0,7.0,7.0,7.0,7.0,6.0,6.0,7.0,7.0,7.0,6.0,7.0,7.0,6.0,7.0,7.0,7.0,6.0,6.0,1.0,,542.48,68.6,,,,15.67,,94.22,,,,,,,,,,,,,,,,,118.43,,,,,,130.09,,,,,,,,,,,,,,,,,,,,,106.43,,,9.04,,APPROVED,Male,29.0,FALSE
149,2022-03-21 02:58:25,19,en,1318361712,2022-03-21 02:49:57,2022-03-21 02:58:25,Y,Y,-oth-,HS,,3,,,,,,,,,,,,,,,,,,,,,,,,,,,,,,,,,9,,,,,,,,,,,,,,,,,,,,,,,,,,,,,,,,,1,7.0,7.0,7.0,5.0,6.0,7.0,1.0,4.0,7.0,7.0,6.0,7.0,7.0,5.0,6.0,5.0,6.0,4.0,6.0,6.0,3.0,6.0,4.0,7.0,6.0,6.0,2.0,7.0,3.0,7.0,7.0,3.0,2,3.0,3.0,1.0,1.0,3.0,1.0,6.0,4.0,1.0,2.0,1.0,5.0,1.0,1.0,2.0,4.0,4.0,2.0,5.0,2.0,2.0,2.0,1.0,1.0,3.0,5.0,3.0,2.0,7.0,1.0,1.0,4.0,7,,,,,,,,,,,,,,,,,,,,,,,,,,,,,,,,,8,,,,,,,,,,,,,,,,,,,,,,,,,,,,,,,,,4,,,,,,,,,,,,,,,,,,,,,,,,,,,,,,,,,11,,,,,,,,,,,,,,,,,,,,,,,,,,,,,,,,,12,,,,,,,,,,,,,,,,,,,,,,,,,,,,,,,,,5,,,,,,,,,,,,,,,,,,,,,,,,,,,,,,,,,6,,,,,,,,,,,,,,,,,,,,,,,,,,,,,,,,,10,,,,,,,,,,,,,,,,,,,,,,,,,,,,,,,,,13,,,,,,,,,,,,,,,,,,,,,,,,,,,,,,,,,14,,,,,,,,,,,,,,,,,,,,,,,,,,,,,,,,,0,1.0,2.0,1.0,4.0,1.0,5.0,3.0,1.0,2.0,1.0,3.0,1.0,1.0,1.0,1.0,1.0,1.0,1.0,2.0,1.0,1.0,1.0,1.0,1.0,3.0,4.0,4.0,1.0,5.0,1.0,1.0,1.0,,422.08,67.76,,,,22.13,,32.97,,,,,,,,113.22,,,92.58,,,,,,,,,,,,,,,,,,,,,,,,,,,,,,,,,89.4,,,4.02,,APPROVED,Male,23.0,FALSE
150,2022-03-21 02:58:40,19,en,778707085,2022-03-21 02:50:00,2022-03-21 02:58:40,Y,Y,A1,,,1,2.0,4.0,4.0,4.0,2.0,2.0,4.0,4.0,4.0,2.0,4.0,4.0,2.0,2.0,4.0,2.0,4.0,2.0,2.0,2.0,4.0,2.0,3.0,2.0,2.0,4.0,2.0,2.0,4.0,2.0,4.0,1.0,3,,,,,,,,,,,,,,,,,,,,,,,,,,,,,,,,,6,,,,,,,,,,,,,,,,,,,,,,,,,,,,,,,,,4,,,,,,,,,,,,,,,,,,,,,,,,,,,,,,,,,14,,,,,,,,,,,,,,,,,,,,,,,,,,,,,,,,,13,,,,,,,,,,,,,,,,,,,,,,,,,,,,,,,,,0,2.0,4.0,4.0,4.0,2.0,4.0,4.0,4.0,4.0,2.0,4.0,2.0,2.0,2.0,2.0,4.0,4.0,2.0,2.0,2.0,2.0,4.0,4.0,2.0,2.0,4.0,2.0,2.0,4.0,2.0,4.0,7.0,7,,,,,,,,,,,,,,,,,,,,,,,,,,,,,,,,,9,,,,,,,,,,,,,,,,,,,,,,,,,,,,,,,,,12,,,,,,,,,,,,,,,,,,,,,,,,,,,,,,,,,2,2.0,2.0,2.0,2.0,2.0,2.0,2.0,2.0,4.0,2.0,2.0,2.0,2.0,2.0,2.0,2.0,2.0,2.0,2.0,2.0,2.0,2.0,2.0,2.0,2.0,4.0,2.0,2.0,2.0,2.0,4.0,4.0,11,,,,,,,,,,,,,,,,,,,,,,,,,,,,,,,,,5,,,,,,,,,,,,,,,,,,,,,,,,,,,,,,,,,10,,,,,,,,,,,,,,,,,,,,,,,,,,,,,,,,,8,,,,,,,,,,,,,,,,,,,,,,,,,,,,,,,,,,441.81,25.25,,,,16.02,,7.07,,152.12,,,,,,,,,,,,,,,,,,137.76,,,,,,,,,,,,93.19,,,,,,,,,,,,,,,10.4,,APPROVED,DATA EXPIRED,26.0,FALSE
151,2022-03-21 02:59:21,19,en,942221787,2022-03-21 02:50:00,2022-03-21 02:59:21,Y,Y,-oth-,High School Diploma,,10,,,,,,,,,,,,,,,,,,,,,,,,,,,,,,,,,8,,,,,,,,,,,,,,,,,,,,,,,,,,,,,,,,,6,,,,,,,,,,,,,,,,,,,,,,,,,,,,,,,,,14,,,,,,,,,,,,,,,,,,,,,,,,,,,,,,,,,2,3.0,4.0,3.0,3.0,3.0,4.0,7.0,5.0,4.0,4.0,4.0,3.0,3.0,4.0,3.0,4.0,5.0,4.0,3.0,4.0,3.0,3.0,3.0,2.0,3.0,5.0,3.0,4.0,5.0,5.0,5.0,5.0,7,,,,,,,,,,,,,,,,,,,,,,,,,,,,,,,,,3,,,,,,,,,,,,,,,,,,,,,,,,,,,,,,,,,5,,,,,,,,,,,,,,,,,,,,,,,,,,,,,,,,,13,,,,,,,,,,,,,,,,,,,,,,,,,,,,,,,,,4,,,,,,,,,,,,,,,,,,,,,,,,,,,,,,,,,0,2.0,5.0,2.0,2.0,2.0,2.0,7.0,5.0,5.0,3.0,3.0,3.0,3.0,2.0,3.0,3.0,4.0,2.0,3.0,2.0,2.0,3.0,1.0,2.0,5.0,3.0,2.0,2.0,2.0,3.0,3.0,4.0,1,2.0,2.0,1.0,1.0,2.0,1.0,5.0,2.0,4.0,1.0,2.0,1.0,1.0,2.0,2.0,2.0,2.0,1.0,1.0,2.0,3.0,2.0,2.0,2.0,2.0,2.0,2.0,1.0,1.0,2.0,2.0,5.0,12,,,,,,,,,,,,,,,,,,,,,,,,,,,,,,,,,9,,,,,,,,,,,,,,,,,,,,,,,,,,,,,,,,,11,,,,,,,,,,,,,,,,,,,,,,,,,,,,,,,,,,370.82,20.3,,,,30.66,,38.8,,,,,,,,,,,,,,85.05,,,,,,,,,,,,,,,,,,86.63,,,104.26,,,,,,,,,,,,5.12,,APPROVED,Male,20.0,FALSE
154,2022-03-21 02:54:20,19,en,1650829684,2022-03-21 02:50:29,2022-03-21 02:54:20,Y,Y,A1,,,3,,,,,,,,,,,,,,,,,,,,,,,,,,,,,,,,,4,,,,,,,,,,,,,,,,,,,,,,,,,,,,,,,,,11,,,,,,,,,,,,,,,,,,,,,,,,,,,,,,,,,2,5.0,5.0,5.0,5.0,5.0,5.0,5.0,5.0,5.0,5.0,5.0,5.0,5.0,5.0,5.0,5.0,5.0,5.0,5.0,5.0,5.0,5.0,5.0,5.0,5.0,5.0,5.0,5.0,5.0,5.0,5.0,4.0,5,,,,,,,,,,,,,,,,,,,,,,,,,,,,,,,,,9,,,,,,,,,,,,,,,,,,,,,,,,,,,,,,,,,13,,,,,,,,,,,,,,,,,,,,,,,,,,,,,,,,,14,,,,,,,,,,,,,,,,,,,,,,,,,,,,,,,,,10,,,,,,,,,,,,,,,,,,,,,,,,,,,,,,,,,8,,,,,,,,,,,,,,,,,,,,,,,,,,,,,,,,,12,,,,,,,,,,,,,,,,,,,,,,,,,,,,,,,,,0,5.0,5.0,5.0,5.0,5.0,5.0,5.0,5.0,5.0,5.0,5.0,5.0,5.0,5.0,5.0,5.0,5.0,5.0,5.0,5.0,5.0,5.0,5.0,5.0,5.0,5.0,5.0,5.0,5.0,5.0,5.0,5.0,1,6.0,6.0,6.0,6.0,6.0,6.0,6.0,6.0,6.0,6.0,6.0,6.0,6.0,6.0,6.0,6.0,6.0,6.0,6.0,6.0,6.0,6.0,6.0,6.0,6.0,6.0,6.0,6.0,6.0,6.0,6.0,6.0,6,,,,,,,,,,,,,,,,,,,,,,,,,,,,,,,,,7,,,,,,,,,,,,,,,,,,,,,,,,,,,,,,,,,,226.63,34.5,,,,5.12,,55.67,,,,,,,,,,,26.01,,,,,,,,,,,,,,,,,,,,,,,,53.47,,,46.77,,,,,,,,,5.09,,APPROVED,Male,22.0,FALSE
155,2022-03-21 03:01:01,19,en,1163983150,2022-03-21 02:50:32,2022-03-21 03:01:01,Y,Y,A1,,,11,,,,,,,,,,,,,,,,,,,,,,,,,,,,,,,,,5,,,,,,,,,,,,,,,,,,,,,,,,,,,,,,,,,13,,,,,,,,,,,,,,,,,,,,,,,,,,,,,,,,,6,,,,,,,,,,,,,,,,,,,,,,,,,,,,,,,,,4,,,,,,,,,,,,,,,,,,,,,,,,,,,,,,,,,10,,,,,,,,,,,,,,,,,,,,,,,,,,,,,,,,,7,,,,,,,,,,,,,,,,,,,,,,,,,,,,,,,,,14,,,,,,,,,,,,,,,,,,,,,,,,,,,,,,,,,9,,,,,,,,,,,,,,,,,,,,,,,,,,,,,,,,,1,2.0,3.0,4.0,3.0,3.0,2.0,6.0,4.0,2.0,3.0,3.0,4.0,4.0,2.0,5.0,2.0,6.0,3.0,4.0,2.0,3.0,3.0,3.0,3.0,3.0,4.0,4.0,2.0,3.0,3.0,2.0,3.0,0,3.0,6.0,4.0,3.0,3.0,3.0,5.0,5.0,6.0,3.0,2.0,5.0,4.0,4.0,5.0,3.0,5.0,4.0,4.0,4.0,4.0,5.0,2.0,4.0,4.0,4.0,4.0,4.0,3.0,3.0,3.0,4.0,2,3.0,4.0,3.0,3.0,4.0,2.0,5.0,2.0,3.0,2.0,2.0,1.0,4.0,2.0,4.0,2.0,2.0,3.0,3.0,5.0,3.0,5.0,3.0,5.0,4.0,2.0,4.0,2.0,4.0,3.0,2.0,5.0,12,,,,,,,,,,,,,,,,,,,,,,,,,,,,,,,,,8,,,,,,,,,,,,,,,,,,,,,,,,,,,,,,,,,3,,,,,,,,,,,,,,,,,,,,,,,,,,,,,,,,,,631.98,199.51,,,,15.44,,51.27,,,,,,,,,,,,,,,,,,,,,,,,,,,,,139.89,,,130.83,,,88.55,,,,,,,,,,,,6.49,,APPROVED,Female,21.0,FALSE
156,2022-03-21 02:58:57,19,en,1798709763,2022-03-21 02:50:32,2022-03-21 02:58:57,Y,Y,-oth-,Undergraduate,,5,,,,,,,,,,,,,,,,,,,,,,,,,,,,,,,,,14,,,,,,,,,,,,,,,,,,,,,,,,,,,,,,,,,0,5.0,6.0,5.0,5.0,4.0,6.0,2.0,7.0,5.0,3.0,4.0,3.0,6.0,5.0,4.0,6.0,5.0,3.0,5.0,5.0,2.0,5.0,4.0,6.0,5.0,2.0,3.0,5.0,3.0,3.0,2.0,3.0,11,,,,,,,,,,,,,,,,,,,,,,,,,,,,,,,,,13,,,,,,,,,,,,,,,,,,,,,,,,,,,,,,,,,9,,,,,,,,,,,,,,,,,,,,,,,,,,,,,,,,,10,,,,,,,,,,,,,,,,,,,,,,,,,,,,,,,,,2,3.0,6.0,3.0,3.0,3.0,2.0,5.0,5.0,5.0,2.0,3.0,5.0,5.0,5.0,5.0,2.0,5.0,6.0,6.0,5.0,3.0,5.0,2.0,3.0,3.0,2.0,4.0,3.0,3.0,3.0,3.0,1.0,1,1.0,1.0,2.0,2.0,1.0,2.0,6.0,6.0,2.0,2.0,2.0,2.0,1.0,3.0,2.0,2.0,3.0,2.0,1.0,2.0,2.0,2.0,5.0,2.0,2.0,3.0,4.0,2.0,3.0,2.0,1.0,2.0,3,,,,,,,,,,,,,,,,,,,,,,,,,,,,,,,,,4,,,,,,,,,,,,,,,,,,,,,,,,,,,,,,,,,7,,,,,,,,,,,,,,,,,,,,,,,,,,,,,,,,,8,,,,,,,,,,,,,,,,,,,,,,,,,,,,,,,,,6,,,,,,,,,,,,,,,,,,,,,,,,,,,,,,,,,12,,,,,,,,,,,,,,,,,,,,,,,,,,,,,,,,,,318.78,15.72,,,,25.75,,29.83,,,,,,,,92.2,,,,,,,,,,,,,,,70.04,,,82.66,,,,,,,,,,,,,,,,,,,,,2.58,,APPROVED,Male,22.0,FALSE
157,2022-03-21 02:59:24,19,en,1850443146,2022-03-21 02:50:32,2022-03-21 02:59:24,Y,Y,A1,,,11,,,,,,,,,,,,,,,,,,,,,,,,,,,,,,,,,14,,,,,,,,,,,,,,,,,,,,,,,,,,,,,,,,,2,5.0,5.0,7.0,7.0,7.0,5.0,2.0,6.0,4.0,5.0,5.0,4.0,6.0,6.0,6.0,6.0,6.0,4.0,7.0,6.0,4.0,6.0,6.0,6.0,6.0,3.0,4.0,7.0,5.0,5.0,6.0,3.0,8,,,,,,,,,,,,,,,,,,,,,,,,,,,,,,,,,10,,,,,,,,,,,,,,,,,,,,,,,,,,,,,,,,,0,4.0,7.0,3.0,2.0,3.0,1.0,6.0,3.0,6.0,5.0,3.0,4.0,6.0,5.0,6.0,3.0,7.0,4.0,5.0,5.0,4.0,5.0,2.0,5.0,5.0,3.0,2.0,6.0,4.0,4.0,2.0,6.0,1,3.0,3.0,3.0,5.0,2.0,6.0,3.0,5.0,4.0,4.0,5.0,3.0,5.0,5.0,4.0,5.0,6.0,4.0,3.0,4.0,2.0,5.0,6.0,3.0,3.0,2.0,2.0,5.0,2.0,4.0,6.0,7.0,4,,,,,,,,,,,,,,,,,,,,,,,,,,,,,,,,,6,,,,,,,,,,,,,,,,,,,,,,,,,,,,,,,,,5,,,,,,,,,,,,,,,,,,,,,,,,,,,,,,,,,7,,,,,,,,,,,,,,,,,,,,,,,,,,,,,,,,,13,,,,,,,,,,,,,,,,,,,,,,,,,,,,,,,,,9,,,,,,,,,,,,,,,,,,,,,,,,,,,,,,,,,3,,,,,,,,,,,,,,,,,,,,,,,,,,,,,,,,,12,,,,,,,,,,,,,,,,,,,,,,,,,,,,,,,,,,464.62,45.65,,,,47.53,,65.88,,,,,,,,88.77,,,,,,,,,101.77,,,109.56,,,,,,,,,,,,,,,,,,,,,,,,,,,5.46,,APPROVED,Male,21.0,FALSE
159,2022-03-21 03:03:04,19,en,1426530796,2022-03-21 02:50:37,2022-03-21 03:03:04,Y,Y,A1,,,11,,,,,,,,,,,,,,,,,,,,,,,,,,,,,,,,,10,,,,,,,,,,,,,,,,,,,,,,,,,,,,,,,,,8,,,,,,,,,,,,,,,,,,,,,,,,,,,,,,,,,7,,,,,,,,,,,,,,,,,,,,,,,,,,,,,,,,,14,,,,,,,,,,,,,,,,,,,,,,,,,,,,,,,,,2,4.0,7.0,4.0,5.0,5.0,3.0,7.0,6.0,7.0,5.0,3.0,5.0,5.0,6.0,6.0,5.0,5.0,6.0,6.0,5.0,4.0,5.0,3.0,4.0,5.0,6.0,6.0,5.0,5.0,4.0,7.0,6.0,1,3.0,6.0,2.0,4.0,3.0,5.0,5.0,5.0,6.0,2.0,2.0,4.0,3.0,2.0,6.0,3.0,5.0,4.0,3.0,3.0,3.0,3.0,5.0,2.0,3.0,5.0,1.0,4.0,5.0,4.0,6.0,7.0,12,,,,,,,,,,,,,,,,,,,,,,,,,,,,,,,,,3,,,,,,,,,,,,,,,,,,,,,,,,,,,,,,,,,0,7.0,7.0,6.0,7.0,7.0,5.0,2.0,6.0,7.0,6.0,6.0,6.0,7.0,6.0,4.0,6.0,7.0,7.0,7.0,6.0,5.0,5.0,5.0,6.0,6.0,6.0,4.0,7.0,5.0,6.0,6.0,1.0,9,,,,,,,,,,,,,,,,,,,,,,,,,,,,,,,,,4,,,,,,,,,,,,,,,,,,,,,,,,,,,,,,,,,5,,,,,,,,,,,,,,,,,,,,,,,,,,,,,,,,,6,,,,,,,,,,,,,,,,,,,,,,,,,,,,,,,,,13,,,,,,,,,,,,,,,,,,,,,,,,,,,,,,,,,,582.82,50.74,,,,10.5,,63.48,,,,,,,,,,,,,,,,,162.03,,,121.19,,,,,,,,,166.02,,,,,,,,,,,,,,,,,,8.86,,APPROVED,Female,22.0,FALSE
160,2022-03-21 02:59:31,19,en,618098952,2022-03-21 02:50:37,2022-03-21 02:59:31,Y,Y,A1,,,11,,,,,,,,,,,,,,,,,,,,,,,,,,,,,,,,,3,,,,,,,,,,,,,,,,,,,,,,,,,,,,,,,,,5,,,,,,,,,,,,,,,,,,,,,,,,,,,,,,,,,9,,,,,,,,,,,,,,,,,,,,,,,,,,,,,,,,,6,,,,,,,,,,,,,,,,,,,,,,,,,,,,,,,,,13,,,,,,,,,,,,,,,,,,,,,,,,,,,,,,,,,14,,,,,,,,,,,,,,,,,,,,,,,,,,,,,,,,,2,3.0,4.0,4.0,3.0,3.0,3.0,3.0,4.0,4.0,4.0,4.0,4.0,2.0,4.0,3.0,4.0,4.0,3.0,4.0,4.0,3.0,4.0,4.0,4.0,2.0,5.0,4.0,4.0,2.0,4.0,3.0,1.0,4,,,,,,,,,,,,,,,,,,,,,,,,,,,,,,,,,8,,,,,,,,,,,,,,,,,,,,,,,,,,,,,,,,,10,,,,,,,,,,,,,,,,,,,,,,,,,,,,,,,,,1,6.0,7.0,7.0,6.0,7.0,7.0,4.0,5.0,6.0,6.0,7.0,7.0,6.0,6.0,7.0,7.0,7.0,6.0,7.0,6.0,5.0,7.0,7.0,6.0,6.0,6.0,6.0,6.0,6.0,7.0,6.0,5.0,0,7.0,7.0,6.0,6.0,7.0,6.0,3.0,4.0,6.0,6.0,7.0,6.0,6.0,6.0,7.0,4.0,7.0,6.0,7.0,7.0,6.0,6.0,7.0,6.0,7.0,6.0,1.0,6.0,6.0,6.0,7.0,6.0,7,,,,,,,,,,,,,,,,,,,,,,,,,,,,,,,,,12,,,,,,,,,,,,,,,,,,,,,,,,,,,,,,,,,,536.0,277.46,,,,11.04,,51.37,,,,,,,,,,,,,,,,,,,,,,,54.67,,,,,,,,,,,,55.64,,,80.26,,,,,,,,,5.56,,APPROVED,Male,25.0,FALSE
164,2022-03-21 03:02:27,19,en,1648161339,2022-03-21 02:51:33,2022-03-21 03:02:27,Y,Y,A1,,,11,,,,,,,,,,,,,,,,,,,,,,,,,,,,,,,,,5,,,,,,,,,,,,,,,,,,,,,,,,,,,,,,,,,1,6.0,5.0,6.0,6.0,5.0,6.0,3.0,6.0,5.0,6.0,4.0,6.0,6.0,5.0,5.0,6.0,6.0,6.0,6.0,5.0,5.0,6.0,6.0,6.0,6.0,6.0,6.0,6.0,6.0,6.0,5.0,3.0,7,,,,,,,,,,,,,,,,,,,,,,,,,,,,,,,,,13,,,,,,,,,,,,,,,,,,,,,,,,,,,,,,,,,2,5.0,5.0,5.0,3.0,5.0,2.0,5.0,5.0,5.0,4.0,2.0,5.0,4.0,5.0,5.0,3.0,5.0,4.0,5.0,5.0,3.0,4.0,2.0,5.0,5.0,4.0,5.0,4.0,3.0,4.0,2.0,6.0,8,,,,,,,,,,,,,,,,,,,,,,,,,,,,,,,,,9,,,,,,,,,,,,,,,,,,,,,,,,,,,,,,,,,3,,,,,,,,,,,,,,,,,,,,,,,,,,,,,,,,,4,,,,,,,,,,,,,,,,,,,,,,,,,,,,,,,,,12,,,,,,,,,,,,,,,,,,,,,,,,,,,,,,,,,10,,,,,,,,,,,,,,,,,,,,,,,,,,,,,,,,,14,,,,,,,,,,,,,,,,,,,,,,,,,,,,,,,,,6,,,,,,,,,,,,,,,,,,,,,,,,,,,,,,,,,0,5.0,6.0,5.0,5.0,3.0,3.0,3.0,6.0,6.0,3.0,3.0,6.0,5.0,5.0,5.0,5.0,5.0,3.0,5.0,3.0,5.0,3.0,5.0,5.0,3.0,5.0,5.0,3.0,5.0,4.0,5.0,1.0,,656.5,117.59,,,,12.62,,57.2,,,,,,,,130.0,,,,,,,,,151.65,,,,,,,,,,,,,,,,,,,,,,,,,,,180.91,,,6.53,,APPROVED,Female,38.0,FALSE
165,2022-03-21 03:00:12,19,en,1129321203,2022-03-21 02:51:44,2022-03-21 03:00:12,Y,Y,A1,,,0,5.0,7.0,5.0,5.0,6.0,6.0,4.0,5.0,6.0,4.0,6.0,6.0,6.0,6.0,5.0,5.0,6.0,5.0,6.0,4.0,4.0,6.0,5.0,5.0,6.0,4.0,4.0,5.0,7.0,5.0,5.0,1.0,14,,,,,,,,,,,,,,,,,,,,,,,,,,,,,,,,,5,,,,,,,,,,,,,,,,,,,,,,,,,,,,,,,,,6,,,,,,,,,,,,,,,,,,,,,,,,,,,,,,,,,13,,,,,,,,,,,,,,,,,,,,,,,,,,,,,,,,,1,6.0,6.0,7.0,3.0,5.0,4.0,4.0,6.0,6.0,7.0,4.0,7.0,6.0,6.0,6.0,4.0,7.0,6.0,6.0,5.0,4.0,7.0,2.0,6.0,6.0,5.0,5.0,6.0,6.0,4.0,4.0,6.0,12,,,,,,,,,,,,,,,,,,,,,,,,,,,,,,,,,10,,,,,,,,,,,,,,,,,,,,,,,,,,,,,,,,,4,,,,,,,,,,,,,,,,,,,,,,,,,,,,,,,,,11,,,,,,,,,,,,,,,,,,,,,,,,,,,,,,,,,7,,,,,,,,,,,,,,,,,,,,,,,,,,,,,,,,,9,,,,,,,,,,,,,,,,,,,,,,,,,,,,,,,,,3,,,,,,,,,,,,,,,,,,,,,,,,,,,,,,,,,2,4.0,2.0,3.0,2.0,2.0,5.0,4.0,3.0,5.0,3.0,4.0,3.0,3.0,5.0,5.0,4.0,6.0,3.0,3.0,4.0,2.0,4.0,6.0,5.0,2.0,5.0,3.0,4.0,3.0,3.0,5.0,7.0,8,,,,,,,,,,,,,,,,,,,,,,,,,,,,,,,,,it was fun :),404.56,32.41,,,,8.08,,44.61,,79.4,,,,,,,,,,,,,,,91.75,,,,,,,,,,,,,,,,,,,,,,,,82.13,,,,,,66.18,,APPROVED,Male,33.0,FALSE
166,2022-03-21 02:57:25,19,en,63534058,2022-03-21 02:51:58,2022-03-21 02:57:25,Y,Y,A1,,,12,,,,,,,,,,,,,,,,,,,,,,,,,,,,,,,,,3,,,,,,,,,,,,,,,,,,,,,,,,,,,,,,,,,13,,,,,,,,,,,,,,,,,,,,,,,,,,,,,,,,,7,,,,,,,,,,,,,,,,,,,,,,,,,,,,,,,,,8,,,,,,,,,,,,,,,,,,,,,,,,,,,,,,,,,1,5.0,5.0,4.0,4.0,6.0,5.0,4.0,5.0,6.0,5.0,6.0,4.0,5.0,4.0,4.0,5.0,7.0,4.0,4.0,5.0,4.0,5.0,5.0,4.0,4.0,2.0,4.0,6.0,5.0,4.0,6.0,6.0,14,,,,,,,,,,,,,,,,,,,,,,,,,,,,,,,,,6,,,,,,,,,,,,,,,,,,,,,,,,,,,,,,,,,10,,,,,,,,,,,,,,,,,,,,,,,,,,,,,,,,,0,2.0,5.0,4.0,4.0,2.0,2.0,1.0,6.0,3.0,4.0,3.0,4.0,3.0,4.0,4.0,2.0,5.0,3.0,1.0,2.0,4.0,5.0,2.0,2.0,2.0,2.0,2.0,4.0,4.0,3.0,2.0,3.0,11,,,,,,,,,,,,,,,,,,,,,,,,,,,,,,,,,5,,,,,,,,,,,,,,,,,,,,,,,,,,,,,,,,,2,4.0,5.0,3.0,2.0,2.0,3.0,2.0,3.0,5.0,4.0,2.0,2.0,3.0,4.0,2.0,5.0,4.0,3.0,3.0,3.0,2.0,3.0,2.0,4.0,3.0,2.0,3.0,5.0,3.0,4.0,2.0,6.0,4,,,,,,,,,,,,,,,,,,,,,,,,,,,,,,,,,9,,,,,,,,,,,,,,,,,,,,,,,,,,,,,,,,,,329.45,25.11,,,,49.23,,28.32,,,,,,,,,,,,,,,,,51.66,,,,,,,,,,,,109.7,,,,,,,,,61.01,,,,,,,,,4.42,,APPROVED,Male,24.0,FALSE
167,2022-03-21 02:59:09,19,en,2008872170,2022-03-21 02:52:00,2022-03-21 02:59:09,Y,Y,A1,,,14,,,,,,,,,,,,,,,,,,,,,,,,,,,,,,,,,13,,,,,,,,,,,,,,,,,,,,,,,,,,,,,,,,,6,,,,,,,,,,,,,,,,,,,,,,,,,,,,,,,,,8,,,,,,,,,,,,,,,,,,,,,,,,,,,,,,,,,7,,,,,,,,,,,,,,,,,,,,,,,,,,,,,,,,,5,,,,,,,,,,,,,,,,,,,,,,,,,,,,,,,,,11,,,,,,,,,,,,,,,,,,,,,,,,,,,,,,,,,12,,,,,,,,,,,,,,,,,,,,,,,,,,,,,,,,,1,4.0,6.0,6.0,3.0,5.0,2.0,6.0,2.0,5.0,2.0,2.0,4.0,5.0,5.0,5.0,2.0,6.0,3.0,5.0,4.0,4.0,5.0,2.0,3.0,4.0,2.0,5.0,5.0,2.0,3.0,2.0,2.0,2,5.0,6.0,6.0,5.0,5.0,3.0,5.0,6.0,5.0,5.0,6.0,6.0,6.0,6.0,5.0,5.0,5.0,5.0,5.0,5.0,5.0,6.0,3.0,5.0,6.0,4.0,5.0,6.0,5.0,5.0,4.0,3.0,4,,,,,,,,,,,,,,,,,,,,,,,,,,,,,,,,,0,5.0,5.0,4.0,4.0,4.0,2.0,7.0,2.0,5.0,4.0,5.0,4.0,5.0,3.0,5.0,3.0,2.0,5.0,2.0,4.0,5.0,2.0,3.0,5.0,4.0,5.0,2.0,5.0,5.0,4.0,4.0,5.0,3,,,,,,,,,,,,,,,,,,,,,,,,,,,,,,,,,10,,,,,,,,,,,,,,,,,,,,,,,,,,,,,,,,,9,,,,,,,,,,,,,,,,,,,,,,,,,,,,,,,,,,431.67,31.14,,,,29.95,,41.69,,,,,,,,,,,,,,,,,,,,,,,,,,140.31,,,92.91,,,,,,89.7,,,,,,,,,,,,5.97,,APPROVED,Female,23.0,FALSE
168,2022-03-21 02:57:40,19,en,22820852,2022-03-21 02:52:04,2022-03-21 02:57:40,Y,Y,-oth-,Part of Bachelor,,4,,,,,,,,,,,,,,,,,,,,,,,,,,,,,,,,,1,6.0,2.0,6.0,6.0,5.0,5.0,3.0,6.0,3.0,6.0,4.0,5.0,6.0,6.0,3.0,6.0,5.0,6.0,6.0,4.0,5.0,6.0,6.0,6.0,6.0,4.0,2.0,6.0,3.0,6.0,6.0,2.0,12,,,,,,,,,,,,,,,,,,,,,,,,,,,,,,,,,6,,,,,,,,,,,,,,,,,,,,,,,,,,,,,,,,,2,1.0,2.0,1.0,1.0,1.0,1.0,7.0,3.0,1.0,1.0,1.0,1.0,2.0,1.0,1.0,1.0,1.0,1.0,2.0,1.0,2.0,2.0,1.0,1.0,1.0,2.0,5.0,1.0,1.0,1.0,2.0,6.0,9,,,,,,,,,,,,,,,,,,,,,,,,,,,,,,,,,7,,,,,,,,,,,,,,,,,,,,,,,,,,,,,,,,,5,,,,,,,,,,,,,,,,,,,,,,,,,,,,,,,,,3,,,,,,,,,,,,,,,,,,,,,,,,,,,,,,,,,10,,,,,,,,,,,,,,,,,,,,,,,,,,,,,,,,,14,,,,,,,,,,,,,,,,,,,,,,,,,,,,,,,,,13,,,,,,,,,,,,,,,,,,,,,,,,,,,,,,,,,8,,,,,,,,,,,,,,,,,,,,,,,,,,,,,,,,,0,1.0,1.0,1.0,1.0,1.0,1.0,6.0,5.0,3.0,1.0,1.0,1.0,1.0,1.0,1.0,1.0,1.0,1.0,1.0,1.0,1.0,1.0,1.0,1.0,1.0,4.0,7.0,1.0,1.0,1.0,1.0,7.0,11,,,,,,,,,,,,,,,,,,,,,,,,,,,,,,,,,,226.56,17.76,,,,31.51,,7.43,,,,,60.48,,,,,,,,,52.06,,,,,,,,,,,,,,,,,,,,,,,,,,,54.06,,,,,,3.26,,APPROVED,Male,20.0,FALSE
169,2022-03-21 03:02:08,19,en,2013365101,2022-03-21 02:52:04,2022-03-21 03:02:08,Y,Y,-oth-,undergrad,,3,,,,,,,,,,,,,,,,,,,,,,,,,,,,,,,,,5,,,,,,,,,,,,,,,,,,,,,,,,,,,,,,,,,2,7.0,7.0,7.0,4.0,7.0,7.0,1.0,7.0,7.0,7.0,7.0,7.0,7.0,7.0,7.0,7.0,7.0,6.0,7.0,7.0,7.0,7.0,7.0,7.0,7.0,7.0,4.0,7.0,6.0,7.0,7.0,3.0,8,,,,,,,,,,,,,,,,,,,,,,,,,,,,,,,,,9,,,,,,,,,,,,,,,,,,,,,,,,,,,,,,,,,13,,,,,,,,,,,,,,,,,,,,,,,,,,,,,,,,,12,,,,,,,,,,,,,,,,,,,,,,,,,,,,,,,,,10,,,,,,,,,,,,,,,,,,,,,,,,,,,,,,,,,6,,,,,,,,,,,,,,,,,,,,,,,,,,,,,,,,,1,2.0,6.0,2.0,2.0,5.0,1.0,7.0,1.0,4.0,2.0,2.0,1.0,2.0,2.0,4.0,7.0,5.0,1.0,5.0,2.0,2.0,3.0,2.0,2.0,4.0,4.0,4.0,7.0,4.0,2.0,2.0,3.0,11,,,,,,,,,,,,,,,,,,,,,,,,,,,,,,,,,0,6.0,6.0,6.0,6.0,7.0,6.0,2.0,7.0,7.0,6.0,6.0,7.0,7.0,7.0,6.0,5.0,7.0,6.0,7.0,7.0,5.0,6.0,7.0,7.0,7.0,7.0,4.0,7.0,4.0,6.0,6.0,5.0,14,,,,,,,,,,,,,,,,,,,,,,,,,,,,,,,,,4,,,,,,,,,,,,,,,,,,,,,,,,,,,,,,,,,7,,,,,,,,,,,,,,,,,,,,,,,,,,,,,,,,,,330.91,4.69,,,,28.4,,43.0,,,,,,,,61.28,,,,,,,,,,,,,,,,,,,,,93.26,,,,,,96.81,,,,,,,,,,,,3.47,,APPROVED,Male,20.0,FALSE
171,2022-03-21 03:05:40,19,en,1146032021,2022-03-21 02:52:41,2022-03-21 03:05:40,Y,Y,A1,,,11,,,,,,,,,,,,,,,,,,,,,,,,,,,,,,,,,3,,,,,,,,,,,,,,,,,,,,,,,,,,,,,,,,,13,,,,,,,,,,,,,,,,,,,,,,,,,,,,,,,,,7,,,,,,,,,,,,,,,,,,,,,,,,,,,,,,,,,1,5.0,5.0,4.0,4.0,3.0,3.0,4.0,3.0,5.0,2.0,5.0,4.0,3.0,4.0,4.0,3.0,2.0,3.0,4.0,3.0,1.0,4.0,4.0,3.0,3.0,4.0,3.0,3.0,5.0,4.0,4.0,5.0,12,,,,,,,,,,,,,,,,,,,,,,,,,,,,,,,,,0,4.0,6.0,4.0,3.0,5.0,3.0,6.0,5.0,5.0,4.0,2.0,5.0,6.0,5.0,5.0,3.0,5.0,5.0,5.0,7.0,5.0,5.0,2.0,5.0,5.0,1.0,7.0,5.0,4.0,6.0,3.0,7.0,8,,,,,,,,,,,,,,,,,,,,,,,,,,,,,,,,,6,,,,,,,,,,,,,,,,,,,,,,,,,,,,,,,,,4,,,,,,,,,,,,,,,,,,,,,,,,,,,,,,,,,10,,,,,,,,,,,,,,,,,,,,,,,,,,,,,,,,,9,,,,,,,,,,,,,,,,,,,,,,,,,,,,,,,,,2,4.0,4.0,5.0,6.0,5.0,3.0,5.0,4.0,5.0,5.0,5.0,4.0,5.0,5.0,6.0,6.0,6.0,4.0,5.0,5.0,5.0,5.0,5.0,5.0,5.0,6.0,4.0,5.0,6.0,5.0,6.0,6.0,5,,,,,,,,,,,,,,,,,,,,,,,,,,,,,,,,,14,,,,,,,,,,,,,,,,,,,,,,,,,,,,,,,,,,764.22,35.31,,,,8.37,,235.51,,,,,,,,,,,,,,153.19,,,,,,121.04,,,,,,,,,,,,,,,,,,205.57,,,,,,,,,5.23,,APPROVED,Male,24.0,FALSE
172,2022-03-21 03:09:42,19,en,2021561513,2022-03-21 02:52:57,2022-03-21 03:09:42,Y,Y,-oth-,High school degree,,0,4.0,4.0,5.0,4.0,4.0,1.0,4.0,6.0,5.0,5.0,4.0,5.0,5.0,5.0,5.0,4.0,5.0,3.0,5.0,5.0,6.0,5.0,1.0,3.0,4.0,1.0,1.0,6.0,3.0,3.0,1.0,1.0,9,,,,,,,,,,,,,,,,,,,,,,,,,,,,,,,,,5,,,,,,,,,,,,,,,,,,,,,,,,,,,,,,,,,6,,,,,,,,,,,,,,,,,,,,,,,,,,,,,,,,,7,,,,,,,,,,,,,,,,,,,,,,,,,,,,,,,,,2,6.0,5.0,4.0,4.0,4.0,4.0,4.0,5.0,5.0,4.0,5.0,3.0,4.0,5.0,4.0,4.0,6.0,5.0,6.0,5.0,4.0,5.0,5.0,5.0,4.0,1.0,1.0,5.0,1.0,3.0,5.0,6.0,11,,,,,,,,,,,,,,,,,,,,,,,,,,,,,,,,,13,,,,,,,,,,,,,,,,,,,,,,,,,,,,,,,,,3,,,,,,,,,,,,,,,,,,,,,,,,,,,,,,,,,10,,,,,,,,,,,,,,,,,,,,,,,,,,,,,,,,,8,,,,,,,,,,,,,,,,,,,,,,,,,,,,,,,,,14,,,,,,,,,,,,,,,,,,,,,,,,,,,,,,,,,12,,,,,,,,,,,,,,,,,,,,,,,,,,,,,,,,,1,5.0,4.0,1.0,4.0,3.0,5.0,4.0,6.0,1.0,4.0,3.0,7.0,6.0,4.0,6.0,4.0,6.0,4.0,4.0,4.0,4.0,4.0,6.0,4.0,3.0,6.0,1.0,4.0,3.0,3.0,7.0,7.0,4,,,,,,,,,,,,,,,,,,,,,,,,,,,,,,,,,,1007.04,417.63,,,,22.02,,18.28,,129.43,,,,,,,,,,,,,,,340.16,,,,,,,,,,,,,,,,,,,,,,,,77.34,,,,,,2.18,,APPROVED,Male,19.0,FALSE
173,2022-03-21 02:58:54,19,en,1698369931,2022-03-21 02:53:03,2022-03-21 02:58:54,Y,Y,A1,,,4,,,,,,,,,,,,,,,,,,,,,,,,,,,,,,,,,11,,,,,,,,,,,,,,,,,,,,,,,,,,,,,,,,,12,,,,,,,,,,,,,,,,,,,,,,,,,,,,,,,,,0,6.0,7.0,6.0,6.0,7.0,3.0,6.0,7.0,7.0,5.0,6.0,5.0,6.0,6.0,6.0,5.0,6.0,5.0,6.0,5.0,3.0,6.0,3.0,6.0,6.0,5.0,4.0,6.0,6.0,6.0,5.0,4.0,2,5.0,5.0,5.0,6.0,5.0,6.0,3.0,6.0,3.0,5.0,3.0,5.0,5.0,5.0,2.0,5.0,5.0,6.0,6.0,5.0,5.0,6.0,6.0,5.0,5.0,5.0,3.0,5.0,3.0,6.0,6.0,5.0,6,,,,,,,,,,,,,,,,,,,,,,,,,,,,,,,,,5,,,,,,,,,,,,,,,,,,,,,,,,,,,,,,,,,8,,,,,,,,,,,,,,,,,,,,,,,,,,,,,,,,,13,,,,,,,,,,,,,,,,,,,,,,,,,,,,,,,,,1,2.0,2.0,2.0,2.0,2.0,2.0,6.0,2.0,1.0,2.0,5.0,1.0,1.0,2.0,5.0,2.0,2.0,1.0,2.0,2.0,1.0,2.0,2.0,2.0,2.0,5.0,4.0,2.0,3.0,2.0,3.0,3.0,7,,,,,,,,,,,,,,,,,,,,,,,,,,,,,,,,,14,,,,,,,,,,,,,,,,,,,,,,,,,,,,,,,,,10,,,,,,,,,,,,,,,,,,,,,,,,,,,,,,,,,9,,,,,,,,,,,,,,,,,,,,,,,,,,,,,,,,,3,,,,,,,,,,,,,,,,,,,,,,,,,,,,,,,,,,353.52,46.93,,,,9.51,,24.83,,,,,,,,,,,93.37,,,97.15,,,,,,,,,,,,,,,77.95,,,,,,,,,,,,,,,,,,3.78,,APPROVED,Female,24.0,FALSE
176,2022-03-21 02:59:34,19,en,941780667,2022-03-21 02:53:12,2022-03-21 02:59:34,Y,Y,A1,,,2,5.0,7.0,6.0,5.0,6.0,5.0,4.0,4.0,7.0,5.0,6.0,6.0,6.0,6.0,6.0,6.0,6.0,5.0,6.0,6.0,5.0,6.0,4.0,6.0,6.0,4.0,6.0,5.0,6.0,6.0,6.0,7.0,10,,,,,,,,,,,,,,,,,,,,,,,,,,,,,,,,,4,,,,,,,,,,,,,,,,,,,,,,,,,,,,,,,,,9,,,,,,,,,,,,,,,,,,,,,,,,,,,,,,,,,7,,,,,,,,,,,,,,,,,,,,,,,,,,,,,,,,,1,3.0,5.0,5.0,3.0,4.0,3.0,6.0,4.0,4.0,4.0,3.0,4.0,4.0,4.0,4.0,3.0,4.0,3.0,4.0,4.0,3.0,4.0,3.0,4.0,4.0,4.0,4.0,4.0,4.0,4.0,4.0,6.0,13,,,,,,,,,,,,,,,,,,,,,,,,,,,,,,,,,14,,,,,,,,,,,,,,,,,,,,,,,,,,,,,,,,,11,,,,,,,,,,,,,,,,,,,,,,,,,,,,,,,,,3,,,,,,,,,,,,,,,,,,,,,,,,,,,,,,,,,12,,,,,,,,,,,,,,,,,,,,,,,,,,,,,,,,,6,,,,,,,,,,,,,,,,,,,,,,,,,,,,,,,,,0,5.0,5.0,5.0,4.0,5.0,4.0,3.0,4.0,5.0,5.0,5.0,4.0,5.0,5.0,4.0,5.0,5.0,4.0,5.0,5.0,4.0,5.0,4.0,5.0,5.0,5.0,3.0,5.0,5.0,5.0,5.0,6.0,5,,,,,,,,,,,,,,,,,,,,,,,,,,,,,,,,,8,,,,,,,,,,,,,,,,,,,,,,,,,,,,,,,,,,383.21,48.59,,,,10.12,,61.19,,83.7,,,,,,,,,,,,,,,78.11,,,,,,,,,,,,,,,,,,,,,95.72,,,,,,,,,5.78,,APPROVED,Male,27.0,FALSE
177,2022-03-21 03:01:36,19,en,1805457938,2022-03-21 02:53:15,2022-03-21 03:01:36,Y,Y,A1,,,9,,,,,,,,,,,,,,,,,,,,,,,,,,,,,,,,,14,,,,,,,,,,,,,,,,,,,,,,,,,,,,,,,,,4,,,,,,,,,,,,,,,,,,,,,,,,,,,,,,,,,5,,,,,,,,,,,,,,,,,,,,,,,,,,,,,,,,,7,,,,,,,,,,,,,,,,,,,,,,,,,,,,,,,,,11,,,,,,,,,,,,,,,,,,,,,,,,,,,,,,,,,6,,,,,,,,,,,,,,,,,,,,,,,,,,,,,,,,,0,3.0,2.0,2.0,6.0,3.0,3.0,6.0,6.0,2.0,4.0,3.0,4.0,3.0,5.0,3.0,1.0,5.0,3.0,5.0,3.0,5.0,4.0,6.0,3.0,3.0,4.0,5.0,4.0,2.0,4.0,2.0,1.0,8,,,,,,,,,,,,,,,,,,,,,,,,,,,,,,,,,10,,,,,,,,,,,,,,,,,,,,,,,,,,,,,,,,,12,,,,,,,,,,,,,,,,,,,,,,,,,,,,,,,,,3,,,,,,,,,,,,,,,,,,,,,,,,,,,,,,,,,13,,,,,,,,,,,,,,,,,,,,,,,,,,,,,,,,,2,3.0,3.0,3.0,4.0,3.0,5.0,3.0,5.0,3.0,4.0,1.0,5.0,5.0,5.0,6.0,5.0,6.0,4.0,2.0,2.0,4.0,4.0,6.0,3.0,3.0,6.0,4.0,4.0,2.0,3.0,5.0,7.0,1,2.0,5.0,2.0,2.0,3.0,2.0,6.0,5.0,6.0,4.0,3.0,5.0,3.0,4.0,2.0,2.0,5.0,5.0,4.0,3.0,1.0,4.0,2.0,3.0,3.0,2.0,4.0,4.0,2.0,3.0,4.0,1.0,,474.03,13.92,,,,14.75,,38.02,,,,,,,,,,,,,,,,,,,,,,,160.09,,,,,,,,,,,,,,,,,,131.93,,,110.45,,,4.87,,APPROVED,Male,26.0,FALSE
179,2022-03-21 03:04:30,19,en,813189475,2022-03-21 02:53:16,2022-03-21 03:04:30,Y,Y,A1,,,11,,,,,,,,,,,,,,,,,,,,,,,,,,,,,,,,,2,4.0,1.0,5.0,6.0,6.0,6.0,1.0,7.0,2.0,5.0,5.0,5.0,5.0,4.0,4.0,6.0,3.0,4.0,5.0,4.0,4.0,5.0,7.0,4.0,5.0,7.0,4.0,4.0,2.0,4.0,7.0,2.0,4,,,,,,,,,,,,,,,,,,,,,,,,,,,,,,,,,1,5.0,6.0,6.0,5.0,6.0,3.0,5.0,7.0,6.0,5.0,5.0,6.0,6.0,4.0,6.0,5.0,6.0,5.0,5.0,4.0,4.0,5.0,3.0,5.0,5.0,5.0,2.0,5.0,3.0,4.0,6.0,4.0,8,,,,,,,,,,,,,,,,,,,,,,,,,,,,,,,,,0,5.0,7.0,5.0,3.0,5.0,3.0,6.0,2.0,7.0,5.0,2.0,6.0,6.0,5.0,5.0,3.0,5.0,5.0,6.0,4.0,4.0,5.0,3.0,5.0,6.0,3.0,2.0,3.0,3.0,2.0,3.0,6.0,5,,,,,,,,,,,,,,,,,,,,,,,,,,,,,,,,,12,,,,,,,,,,,,,,,,,,,,,,,,,,,,,,,,,7,,,,,,,,,,,,,,,,,,,,,,,,,,,,,,,,,14,,,,,,,,,,,,,,,,,,,,,,,,,,,,,,,,,3,,,,,,,,,,,,,,,,,,,,,,,,,,,,,,,,,13,,,,,,,,,,,,,,,,,,,,,,,,,,,,,,,,,10,,,,,,,,,,,,,,,,,,,,,,,,,,,,,,,,,9,,,,,,,,,,,,,,,,,,,,,,,,,,,,,,,,,6,,,,,,,,,,,,,,,,,,,,,,,,,,,,,,,,,,674.53,36.0,,,,18.25,,50.1,,,,,134.67,,,,,,157.65,,,,,,272.82,,,,,,,,,,,,,,,,,,,,,,,,,,,,,,5.04,,APPROVED,Female,22.0,FALSE
180,2022-03-21 03:01:00,19,en,1272204293,2022-03-21 02:53:27,2022-03-21 03:01:00,Y,Y,A1,,,10,,,,,,,,,,,,,,,,,,,,,,,,,,,,,,,,,14,,,,,,,,,,,,,,,,,,,,,,,,,,,,,,,,,13,,,,,,,,,,,,,,,,,,,,,,,,,,,,,,,,,11,,,,,,,,,,,,,,,,,,,,,,,,,,,,,,,,,7,,,,,,,,,,,,,,,,,,,,,,,,,,,,,,,,,1,5.0,5.0,5.0,5.0,5.0,4.0,2.0,6.0,6.0,6.0,6.0,5.0,6.0,5.0,6.0,5.0,5.0,5.0,6.0,3.0,5.0,6.0,6.0,6.0,6.0,6.0,2.0,5.0,6.0,5.0,6.0,6.0,2,6.0,6.0,6.0,3.0,6.0,5.0,6.0,3.0,6.0,6.0,5.0,3.0,5.0,4.0,6.0,6.0,6.0,2.0,6.0,5.0,3.0,6.0,3.0,6.0,6.0,4.0,6.0,6.0,6.0,5.0,2.0,7.0,5,,,,,,,,,,,,,,,,,,,,,,,,,,,,,,,,,0,2.0,3.0,1.0,2.0,2.0,2.0,7.0,1.0,5.0,4.0,2.0,5.0,3.0,3.0,5.0,5.0,5.0,2.0,3.0,2.0,2.0,2.0,6.0,2.0,2.0,5.0,1.0,1.0,4.0,2.0,1.0,2.0,3,,,,,,,,,,,,,,,,,,,,,,,,,,,,,,,,,8,,,,,,,,,,,,,,,,,,,,,,,,,,,,,,,,,9,,,,,,,,,,,,,,,,,,,,,,,,,,,,,,,,,4,,,,,,,,,,,,,,,,,,,,,,,,,,,,,,,,,6,,,,,,,,,,,,,,,,,,,,,,,,,,,,,,,,,12,,,,,,,,,,,,,,,,,,,,,,,,,,,,,,,,,,455.07,57.42,,,,72.92,,36.57,,,,,,,,,,,,,,,,,103.4,,,76.7,,,,,,105.27,,,,,,,,,,,,,,,,,,,,,2.79,,APPROVED,Male,24.0,FALSE
182,2022-03-21 03:02:19,19,en,1284094498,2022-03-21 02:53:34,2022-03-21 03:02:19,Y,Y,-oth-,Degree (3 years),,0,5.0,7.0,3.0,3.0,3.0,2.0,5.0,6.0,7.0,4.0,6.0,3.0,3.0,4.0,5.0,5.0,6.0,5.0,6.0,4.0,4.0,4.0,1.0,3.0,5.0,2.0,7.0,5.0,5.0,4.0,4.0,1.0,11,,,,,,,,,,,,,,,,,,,,,,,,,,,,,,,,,3,,,,,,,,,,,,,,,,,,,,,,,,,,,,,,,,,9,,,,,,,,,,,,,,,,,,,,,,,,,,,,,,,,,8,,,,,,,,,,,,,,,,,,,,,,,,,,,,,,,,,2,6.0,6.0,5.0,6.0,5.0,3.0,2.0,7.0,6.0,4.0,5.0,6.0,6.0,5.0,4.0,5.0,6.0,6.0,7.0,4.0,4.0,5.0,6.0,5.0,5.0,5.0,5.0,5.0,3.0,6.0,6.0,6.0,10,,,,,,,,,,,,,,,,,,,,,,,,,,,,,,,,,12,,,,,,,,,,,,,,,,,,,,,,,,,,,,,,,,,7,,,,,,,,,,,,,,,,,,,,,,,,,,,,,,,,,14,,,,,,,,,,,,,,,,,,,,,,,,,,,,,,,,,13,,,,,,,,,,,,,,,,,,,,,,,,,,,,,,,,,4,,,,,,,,,,,,,,,,,,,,,,,,,,,,,,,,,1,5.0,3.0,6.0,5.0,4.0,7.0,1.0,6.0,6.0,4.0,6.0,7.0,3.0,4.0,4.0,6.0,7.0,5.0,4.0,4.0,6.0,4.0,6.0,5.0,4.0,6.0,5.0,4.0,6.0,6.0,5.0,6.0,5,,,,,,,,,,,,,,,,,,,,,,,,,,,,,,,,,6,,,,,,,,,,,,,,,,,,,,,,,,,,,,,,,,,,510.16,57.77,,,,71.37,,30.51,,115.74,,,,,,,,,,,,,,,114.01,,,,,,,,,,,,,,,,,,,,,115.73,,,,,,,,,5.03,,APPROVED,Female,22.0,FALSE
183,2022-03-21 02:59:47,19,en,797621633,2022-03-21 02:53:51,2022-03-21 02:59:47,Y,Y,A1,,,13,,,,,,,,,,,,,,,,,,,,,,,,,,,,,,,,,5,,,,,,,,,,,,,,,,,,,,,,,,,,,,,,,,,0,6.0,5.0,5.0,5.0,4.0,5.0,5.0,3.0,2.0,5.0,4.0,6.0,5.0,6.0,2.0,5.0,3.0,4.0,5.0,4.0,2.0,6.0,4.0,5.0,5.0,6.0,5.0,5.0,3.0,7.0,5.0,3.0,9,,,,,,,,,,,,,,,,,,,,,,,,,,,,,,,,,14,,,,,,,,,,,,,,,,,,,,,,,,,,,,,,,,,7,,,,,,,,,,,,,,,,,,,,,,,,,,,,,,,,,4,,,,,,,,,,,,,,,,,,,,,,,,,,,,,,,,,12,,,,,,,,,,,,,,,,,,,,,,,,,,,,,,,,,1,1.0,1.0,1.0,1.0,1.0,1.0,1.0,1.0,1.0,1.0,1.0,1.0,2.0,1.0,3.0,1.0,1.0,1.0,1.0,1.0,1.0,1.0,1.0,1.0,1.0,1.0,1.0,2.0,1.0,1.0,1.0,2.0,6,,,,,,,,,,,,,,,,,,,,,,,,,,,,,,,,,11,,,,,,,,,,,,,,,,,,,,,,,,,,,,,,,,,3,,,,,,,,,,,,,,,,,,,,,,,,,,,,,,,,,2,5.0,5.0,5.0,4.0,5.0,4.0,4.0,2.0,5.0,5.0,5.0,5.0,5.0,5.0,5.0,5.0,6.0,4.0,5.0,5.0,5.0,5.0,2.0,5.0,5.0,5.0,5.0,5.0,5.0,4.0,5.0,6.0,10,,,,,,,,,,,,,,,,,,,,,,,,,,,,,,,,,8,,,,,,,,,,,,,,,,,,,,,,,,,,,,,,,,,"All visuals needed more colors, I think.",359.41,58.6,,,,7.05,,37.44,,,,,,,,94.15,,,,,,,,,,,,,,,,,,60.1,,,,,,,,,,,,78.67,,,,,,,,,23.4,,APPROVED,Male,36.0,FALSE
184,2022-03-21 03:00:07,19,en,2052423708,2022-03-21 02:53:56,2022-03-21 03:00:07,Y,Y,A1,,,10,,,,,,,,,,,,,,,,,,,,,,,,,,,,,,,,,4,,,,,,,,,,,,,,,,,,,,,,,,,,,,,,,,,5,,,,,,,,,,,,,,,,,,,,,,,,,,,,,,,,,7,,,,,,,,,,,,,,,,,,,,,,,,,,,,,,,,,12,,,,,,,,,,,,,,,,,,,,,,,,,,,,,,,,,14,,,,,,,,,,,,,,,,,,,,,,,,,,,,,,,,,6,,,,,,,,,,,,,,,,,,,,,,,,,,,,,,,,,3,,,,,,,,,,,,,,,,,,,,,,,,,,,,,,,,,1,6.0,1.0,1.0,4.0,1.0,1.0,7.0,2.0,1.0,1.0,1.0,4.0,1.0,1.0,7.0,3.0,7.0,1.0,2.0,4.0,7.0,3.0,2.0,1.0,1.0,1.0,4.0,1.0,4.0,4.0,4.0,2.0,9,,,,,,,,,,,,,,,,,,,,,,,,,,,,,,,,,13,,,,,,,,,,,,,,,,,,,,,,,,,,,,,,,,,8,,,,,,,,,,,,,,,,,,,,,,,,,,,,,,,,,0,6.0,7.0,7.0,4.0,7.0,7.0,3.0,7.0,7.0,5.0,4.0,5.0,6.0,7.0,6.0,4.0,7.0,2.0,7.0,6.0,4.0,5.0,2.0,7.0,7.0,2.0,2.0,7.0,2.0,4.0,5.0,6.0,11,,,,,,,,,,,,,,,,,,,,,,,,,,,,,,,,,2,3.0,7.0,3.0,2.0,5.0,7.0,5.0,5.0,6.0,3.0,7.0,1.0,4.0,4.0,1.0,4.0,4.0,1.0,4.0,4.0,1.0,3.0,1.0,4.0,7.0,2.0,4.0,4.0,3.0,1.0,2.0,1.0,,373.78,64.53,,,,4.47,,42.76,,,,,,,,,,,,,,,,,,,,,,,,,,81.83,,,,,,,,,,,,90.49,,,,,,86.18,,,3.52,,APPROVED,Male,30.0,FALSE
185,2022-03-21 03:03:21,19,en,2050754225,2022-03-21 02:54:03,2022-03-21 03:03:21,Y,Y,-oth-,secondary high school,,9,,,,,,,,,,,,,,,,,,,,,,,,,,,,,,,,,5,,,,,,,,,,,,,,,,,,,,,,,,,,,,,,,,,1,4.0,4.0,5.0,5.0,3.0,6.0,5.0,3.0,4.0,5.0,5.0,5.0,5.0,4.0,4.0,6.0,5.0,5.0,5.0,5.0,4.0,4.0,4.0,4.0,4.0,1.0,2.0,4.0,1.0,4.0,2.0,3.0,7,,,,,,,,,,,,,,,,,,,,,,,,,,,,,,,,,0,4.0,6.0,4.0,5.0,7.0,6.0,6.0,5.0,6.0,1.0,6.0,4.0,4.0,6.0,6.0,5.0,6.0,4.0,4.0,6.0,5.0,5.0,7.0,5.0,6.0,5.0,4.0,6.0,6.0,4.0,6.0,5.0,13,,,,,,,,,,,,,,,,,,,,,,,,,,,,,,,,,12,,,,,,,,,,,,,,,,,,,,,,,,,,,,,,,,,6,,,,,,,,,,,,,,,,,,,,,,,,,,,,,,,,,4,,,,,,,,,,,,,,,,,,,,,,,,,,,,,,,,,8,,,,,,,,,,,,,,,,,,,,,,,,,,,,,,,,,10,,,,,,,,,,,,,,,,,,,,,,,,,,,,,,,,,3,,,,,,,,,,,,,,,,,,,,,,,,,,,,,,,,,14,,,,,,,,,,,,,,,,,,,,,,,,,,,,,,,,,11,,,,,,,,,,,,,,,,,,,,,,,,,,,,,,,,,2,6.0,7.0,6.0,6.0,6.0,7.0,6.0,6.0,6.0,6.0,7.0,7.0,7.0,5.0,7.0,6.0,4.0,6.0,6.0,6.0,6.0,4.0,6.0,7.0,7.0,7.0,6.0,6.0,5.0,6.0,7.0,1.0,,496.63,37.06,,,,38.49,,37.41,,,,,,,,162.74,,,,,,136.27,,,,,,,,,,,,,,,,,,,,,,,,,,,,,,74.34,,,10.32,,APPROVED,Female,20.0,FALSE
186,2022-03-21 03:02:18,19,en,159086838,2022-03-21 02:54:05,2022-03-21 03:02:18,Y,Y,A2,,,1,6.0,6.0,6.0,6.0,6.0,4.0,3.0,6.0,6.0,7.0,6.0,5.0,5.0,6.0,6.0,6.0,6.0,6.0,5.0,6.0,6.0,6.0,5.0,6.0,5.0,6.0,5.0,5.0,6.0,6.0,6.0,1.0,14,,,,,,,,,,,,,,,,,,,,,,,,,,,,,,,,,2,4.0,7.0,6.0,4.0,6.0,6.0,6.0,6.0,7.0,6.0,6.0,6.0,6.0,6.0,6.0,6.0,7.0,6.0,6.0,7.0,6.0,5.0,4.0,7.0,6.0,5.0,6.0,7.0,7.0,6.0,6.0,3.0,13,,,,,,,,,,,,,,,,,,,,,,,,,,,,,,,,,3,,,,,,,,,,,,,,,,,,,,,,,,,,,,,,,,,10,,,,,,,,,,,,,,,,,,,,,,,,,,,,,,,,,6,,,,,,,,,,,,,,,,,,,,,,,,,,,,,,,,,7,,,,,,,,,,,,,,,,,,,,,,,,,,,,,,,,,0,4.0,5.0,2.0,2.0,2.0,2.0,2.0,4.0,5.0,2.0,2.0,2.0,2.0,3.0,3.0,3.0,6.0,3.0,2.0,2.0,2.0,2.0,2.0,3.0,3.0,4.0,2.0,4.0,5.0,2.0,4.0,2.0,11,,,,,,,,,,,,,,,,,,,,,,,,,,,,,,,,,9,,,,,,,,,,,,,,,,,,,,,,,,,,,,,,,,,4,,,,,,,,,,,,,,,,,,,,,,,,,,,,,,,,,5,,,,,,,,,,,,,,,,,,,,,,,,,,,,,,,,,12,,,,,,,,,,,,,,,,,,,,,,,,,,,,,,,,,8,,,,,,,,,,,,,,,,,,,,,,,,,,,,,,,,,none,496.27,18.01,,,,11.14,,30.78,,55.46,,,,,,49.02,,,,,,,,,,,,,,,,,,324.34,,,,,,,,,,,,,,,,,,,,,7.52,,APPROVED,Male,42.0,FALSE
187,2022-03-21 03:00:04,19,en,206906508,2022-03-21 02:54:05,2022-03-21 03:00:04,Y,Y,A1,,,10,,,,,,,,,,,,,,,,,,,,,,,,,,,,,,,,,12,,,,,,,,,,,,,,,,,,,,,,,,,,,,,,,,,5,,,,,,,,,,,,,,,,,,,,,,,,,,,,,,,,,2,4.0,5.0,5.0,4.0,4.0,5.0,5.0,4.0,4.0,4.0,5.0,4.0,5.0,5.0,4.0,4.0,6.0,4.0,5.0,4.0,3.0,5.0,6.0,4.0,4.0,6.0,5.0,5.0,4.0,5.0,5.0,4.0,9,,,,,,,,,,,,,,,,,,,,,,,,,,,,,,,,,11,,,,,,,,,,,,,,,,,,,,,,,,,,,,,,,,,0,6.0,4.0,4.0,2.0,4.0,5.0,4.0,5.0,5.0,4.0,5.0,5.0,6.0,3.0,5.0,5.0,5.0,4.0,5.0,3.0,4.0,5.0,6.0,5.0,4.0,5.0,3.0,4.0,4.0,4.0,5.0,7.0,6,,,,,,,,,,,,,,,,,,,,,,,,,,,,,,,,,8,,,,,,,,,,,,,,,,,,,,,,,,,,,,,,,,,1,4.0,5.0,3.0,3.0,3.0,3.0,4.0,2.0,5.0,4.0,4.0,4.0,3.0,4.0,5.0,4.0,5.0,3.0,5.0,3.0,5.0,4.0,2.0,4.0,4.0,3.0,4.0,5.0,3.0,5.0,5.0,3.0,3,,,,,,,,,,,,,,,,,,,,,,,,,,,,,,,,,14,,,,,,,,,,,,,,,,,,,,,,,,,,,,,,,,,4,,,,,,,,,,,,,,,,,,,,,,,,,,,,,,,,,7,,,,,,,,,,,,,,,,,,,,,,,,,,,,,,,,,13,,,,,,,,,,,,,,,,,,,,,,,,,,,,,,,,,,361.55,13.27,,,,13.24,,68.05,,,,,,,,,,,72.64,,,,,,,,,86.37,,,,,,,,,104.51,,,,,,,,,,,,,,,,,,3.47,,APPROVED,Male,23.0,FALSE
189,2022-03-21 03:01:36,19,en,2089100477,2022-03-21 02:54:11,2022-03-21 03:01:36,Y,Y,A1,,,2,2.0,6.0,2.0,2.0,2.0,1.0,6.0,5.0,5.0,3.0,5.0,3.0,3.0,2.0,3.0,6.0,4.0,1.0,2.0,3.0,2.0,3.0,2.0,3.0,3.0,4.0,3.0,2.0,4.0,3.0,5.0,1.0,5,,,,,,,,,,,,,,,,,,,,,,,,,,,,,,,,,12,,,,,,,,,,,,,,,,,,,,,,,,,,,,,,,,,0,3.0,6.0,5.0,6.0,6.0,5.0,2.0,6.0,4.0,4.0,4.0,2.0,4.0,3.0,4.0,5.0,4.0,3.0,4.0,4.0,5.0,4.0,5.0,5.0,6.0,5.0,3.0,5.0,5.0,4.0,5.0,4.0,9,,,,,,,,,,,,,,,,,,,,,,,,,,,,,,,,,4,,,,,,,,,,,,,,,,,,,,,,,,,,,,,,,,,3,,,,,,,,,,,,,,,,,,,,,,,,,,,,,,,,,10,,,,,,,,,,,,,,,,,,,,,,,,,,,,,,,,,11,,,,,,,,,,,,,,,,,,,,,,,,,,,,,,,,,7,,,,,,,,,,,,,,,,,,,,,,,,,,,,,,,,,14,,,,,,,,,,,,,,,,,,,,,,,,,,,,,,,,,6,,,,,,,,,,,,,,,,,,,,,,,,,,,,,,,,,13,,,,,,,,,,,,,,,,,,,,,,,,,,,,,,,,,1,5.0,2.0,2.0,4.0,3.0,6.0,2.0,5.0,4.0,3.0,3.0,5.0,5.0,5.0,5.0,3.0,6.0,4.0,3.0,2.0,5.0,5.0,5.0,3.0,3.0,6.0,5.0,6.0,3.0,4.0,5.0,7.0,8,,,,,,,,,,,,,,,,,,,,,,,,,,,,,,,,,,448.52,147.89,,,,6.39,,48.01,,75.37,,,,,,,,,93.69,,,,,,,,,,,,,,,,,,,,,,,,,,,,,,73.18,,,,,,3.99,,APPROVED,Male,30.0,FALSE
190,2022-03-21 03:03:55,19,en,1188816389,2022-03-21 02:54:36,2022-03-21 03:03:55,Y,Y,-oth-,Youth Training ,,4,,,,,,,,,,,,,,,,,,,,,,,,,,,,,,,,,13,,,,,,,,,,,,,,,,,,,,,,,,,,,,,,,,,3,,,,,,,,,,,,,,,,,,,,,,,,,,,,,,,,,9,,,,,,,,,,,,,,,,,,,,,,,,,,,,,,,,,8,,,,,,,,,,,,,,,,,,,,,,,,,,,,,,,,,12,,,,,,,,,,,,,,,,,,,,,,,,,,,,,,,,,14,,,,,,,,,,,,,,,,,,,,,,,,,,,,,,,,,10,,,,,,,,,,,,,,,,,,,,,,,,,,,,,,,,,1,1.0,4.0,1.0,2.0,2.0,2.0,7.0,2.0,5.0,4.0,2.0,2.0,1.0,1.0,3.0,2.0,4.0,1.0,2.0,1.0,1.0,2.0,6.0,2.0,2.0,5.0,4.0,1.0,5.0,2.0,3.0,2.0,11,,,,,,,,,,,,,,,,,,,,,,,,,,,,,,,,,5,,,,,,,,,,,,,,,,,,,,,,,,,,,,,,,,,0,5.0,6.0,5.0,4.0,5.0,4.0,4.0,5.0,4.0,4.0,4.0,5.0,5.0,4.0,7.0,5.0,5.0,5.0,5.0,4.0,4.0,6.0,4.0,5.0,6.0,7.0,1.0,4.0,5.0,4.0,6.0,5.0,6,,,,,,,,,,,,,,,,,,,,,,,,,,,,,,,,,2,4.0,4.0,3.0,4.0,2.0,5.0,2.0,4.0,4.0,2.0,6.0,4.0,3.0,3.0,5.0,3.0,6.0,4.0,4.0,3.0,4.0,5.0,6.0,2.0,4.0,6.0,1.0,4.0,4.0,1.0,5.0,7.0,7,,,,,,,,,,,,,,,,,,,,,,,,,,,,,,,,,,563.56,43.63,,,,94.49,,37.68,,,,,,,,,,,,,,,,,,,,,,,,,,109.79,,,,,,,,,146.52,,,,,,119.48,,,,,,11.97,,APPROVED,Male,40.0,FALSE
191,2022-03-21 02:58:42,19,en,1261072593,2022-03-21 02:54:39,2022-03-21 02:58:42,Y,Y,A1,,,1,1.0,1.0,1.0,1.0,2.0,1.0,3.0,2.0,6.0,3.0,1.0,1.0,1.0,2.0,3.0,1.0,2.0,1.0,1.0,3.0,1.0,1.0,2.0,1.0,1.0,1.0,1.0,1.0,2.0,1.0,3.0,1.0,13,,,,,,,,,,,,,,,,,,,,,,,,,,,,,,,,,12,,,,,,,,,,,,,,,,,,,,,,,,,,,,,,,,,10,,,,,,,,,,,,,,,,,,,,,,,,,,,,,,,,,6,,,,,,,,,,,,,,,,,,,,,,,,,,,,,,,,,2,2.0,6.0,5.0,5.0,5.0,6.0,1.0,5.0,4.0,5.0,3.0,5.0,6.0,2.0,5.0,4.0,6.0,1.0,4.0,5.0,3.0,5.0,5.0,5.0,5.0,6.0,3.0,5.0,5.0,5.0,6.0,6.0,3,,,,,,,,,,,,,,,,,,,,,,,,,,,,,,,,,7,,,,,,,,,,,,,,,,,,,,,,,,,,,,,,,,,0,1.0,1.0,1.0,1.0,1.0,1.0,7.0,1.0,1.0,1.0,1.0,1.0,1.0,1.0,1.0,1.0,1.0,1.0,1.0,1.0,1.0,1.0,1.0,1.0,1.0,1.0,1.0,1.0,1.0,1.0,1.0,2.0,14,,,,,,,,,,,,,,,,,,,,,,,,,,,,,,,,,11,,,,,,,,,,,,,,,,,,,,,,,,,,,,,,,,,9,,,,,,,,,,,,,,,,,,,,,,,,,,,,,,,,,4,,,,,,,,,,,,,,,,,,,,,,,,,,,,,,,,,5,,,,,,,,,,,,,,,,,,,,,,,,,,,,,,,,,8,,,,,,,,,,,,,,,,,,,,,,,,,,,,,,,,,,246.11,37.89,,,,5.58,,31.31,,51.73,,,,,,,,,,,,,,,55.58,,,,,,,,,57.19,,,,,,,,,,,,,,,,,,,,,6.83,,APPROVED,Male,24.0,FALSE
192,2022-03-21 03:01:10,19,en,1992555700,2022-03-21 02:54:48,2022-03-21 03:01:10,Y,Y,A1,,,14,,,,,,,,,,,,,,,,,,,,,,,,,,,,,,,,,9,,,,,,,,,,,,,,,,,,,,,,,,,,,,,,,,,5,,,,,,,,,,,,,,,,,,,,,,,,,,,,,,,,,10,,,,,,,,,,,,,,,,,,,,,,,,,,,,,,,,,12,,,,,,,,,,,,,,,,,,,,,,,,,,,,,,,,,2,6.0,6.0,6.0,5.0,5.0,6.0,5.0,7.0,6.0,6.0,6.0,6.0,6.0,5.0,5.0,5.0,5.0,6.0,6.0,6.0,5.0,6.0,1.0,5.0,6.0,5.0,2.0,5.0,6.0,6.0,5.0,6.0,3,,,,,,,,,,,,,,,,,,,,,,,,,,,,,,,,,13,,,,,,,,,,,,,,,,,,,,,,,,,,,,,,,,,1,2.0,5.0,1.0,2.0,2.0,1.0,7.0,1.0,5.0,2.0,2.0,2.0,2.0,1.0,2.0,1.0,5.0,2.0,2.0,2.0,2.0,2.0,1.0,2.0,2.0,1.0,6.0,1.0,2.0,1.0,1.0,2.0,4,,,,,,,,,,,,,,,,,,,,,,,,,,,,,,,,,11,,,,,,,,,,,,,,,,,,,,,,,,,,,,,,,,,6,,,,,,,,,,,,,,,,,,,,,,,,,,,,,,,,,7,,,,,,,,,,,,,,,,,,,,,,,,,,,,,,,,,8,,,,,,,,,,,,,,,,,,,,,,,,,,,,,,,,,0,7.0,6.0,6.0,6.0,6.0,6.0,2.0,6.0,7.0,6.0,6.0,6.0,6.0,6.0,6.0,6.0,6.0,6.0,6.0,6.0,5.0,6.0,5.0,6.0,7.0,6.0,5.0,6.0,7.0,6.0,6.0,1.0,,382.7,10.61,,,,5.12,,17.1,,,,,,,,,,,,,,,,,61.06,,,,,,,,,46.06,,,,,,,,,,,,,,,,,,239.46,,,3.29,,APPROVED,Male,24.0,FALSE
193,2022-03-21 03:07:18,19,en,1243882013,2022-03-21 02:55:02,2022-03-21 03:07:18,Y,Y,-oth-,Still in high school,,13,,,,,,,,,,,,,,,,,,,,,,,,,,,,,,,,,5,,,,,,,,,,,,,,,,,,,,,,,,,,,,,,,,,8,,,,,,,,,,,,,,,,,,,,,,,,,,,,,,,,,7,,,,,,,,,,,,,,,,,,,,,,,,,,,,,,,,,0,1.0,5.0,3.0,2.0,2.0,5.0,6.0,3.0,4.0,2.0,2.0,2.0,3.0,2.0,2.0,3.0,1.0,2.0,2.0,2.0,2.0,4.0,4.0,2.0,2.0,5.0,1.0,2.0,4.0,2.0,3.0,5.0,12,,,,,,,,,,,,,,,,,,,,,,,,,,,,,,,,,3,,,,,,,,,,,,,,,,,,,,,,,,,,,,,,,,,14,,,,,,,,,,,,,,,,,,,,,,,,,,,,,,,,,4,,,,,,,,,,,,,,,,,,,,,,,,,,,,,,,,,2,4.0,6.0,6.0,4.0,7.0,3.0,3.0,4.0,4.0,4.0,4.0,6.0,4.0,4.0,5.0,3.0,4.0,6.0,6.0,5.0,3.0,4.0,6.0,5.0,3.0,6.0,1.0,3.0,4.0,3.0,6.0,3.0,1,3.0,5.0,3.0,3.0,4.0,1.0,4.0,4.0,3.0,3.0,3.0,2.0,3.0,2.0,3.0,3.0,2.0,2.0,4.0,2.0,1.0,5.0,5.0,2.0,2.0,2.0,1.0,2.0,3.0,3.0,5.0,4.0,11,,,,,,,,,,,,,,,,,,,,,,,,,,,,,,,,,6,,,,,,,,,,,,,,,,,,,,,,,,,,,,,,,,,9,,,,,,,,,,,,,,,,,,,,,,,,,,,,,,,,,10,,,,,,,,,,,,,,,,,,,,,,,,,,,,,,,,,,739.73,37.78,,,,43.33,,93.5,,,,,,,,,,,,,,233.52,,,,,,,,,,,,,,,174.1,,,147.62,,,,,,,,,,,,,,,9.88,,APPROVED,Male,20.0,FALSE
194,2022-03-21 03:13:01,19,en,1331874717,2022-03-21 02:55:14,2022-03-21 03:13:01,Y,Y,-oth-,College Certificate,,9,,,,,,,,,,,,,,,,,,,,,,,,,,,,,,,,,11,,,,,,,,,,,,,,,,,,,,,,,,,,,,,,,,,14,,,,,,,,,,,,,,,,,,,,,,,,,,,,,,,,,7,,,,,,,,,,,,,,,,,,,,,,,,,,,,,,,,,10,,,,,,,,,,,,,,,,,,,,,,,,,,,,,,,,,3,,,,,,,,,,,,,,,,,,,,,,,,,,,,,,,,,5,,,,,,,,,,,,,,,,,,,,,,,,,,,,,,,,,6,,,,,,,,,,,,,,,,,,,,,,,,,,,,,,,,,4,,,,,,,,,,,,,,,,,,,,,,,,,,,,,,,,,2,6.0,7.0,6.0,6.0,6.0,6.0,2.0,3.0,6.0,6.0,6.0,6.0,6.0,6.0,6.0,6.0,6.0,6.0,7.0,6.0,7.0,6.0,6.0,7.0,6.0,7.0,7.0,7.0,7.0,6.0,6.0,3.0,1,4.0,5.0,5.0,5.0,4.0,6.0,2.0,5.0,6.0,3.0,2.0,6.0,5.0,3.0,2.0,4.0,5.0,5.0,5.0,4.0,3.0,6.0,4.0,3.0,4.0,4.0,4.0,2.0,5.0,4.0,3.0,4.0,8,,,,,,,,,,,,,,,,,,,,,,,,,,,,,,,,,12,,,,,,,,,,,,,,,,,,,,,,,,,,,,,,,,,13,,,,,,,,,,,,,,,,,,,,,,,,,,,,,,,,,0,6.0,6.0,6.0,5.0,6.0,6.0,2.0,6.0,6.0,5.0,5.0,6.0,5.0,4.0,4.0,4.0,6.0,5.0,6.0,4.0,4.0,6.0,6.0,5.0,5.0,4.0,5.0,4.0,6.0,4.0,6.0,1.0,,1071.51,81.43,,,,35.76,,102.68,,,,,,,,,,,,,,,,,,,,,,,,,,,,,148.67,,,391.42,,,,,,,,,,,,304.43,,,7.12,,APPROVED,Male,28.0,FALSE
196,2022-03-21 03:05:54,19,en,1395502561,2022-03-21 02:55:27,2022-03-21 03:05:54,Y,Y,A1,,,2,6.0,6.0,6.0,5.0,5.0,4.0,7.0,5.0,5.0,4.0,6.0,5.0,6.0,5.0,6.0,6.0,4.0,4.0,5.0,5.0,4.0,6.0,2.0,4.0,5.0,6.0,6.0,3.0,6.0,4.0,6.0,1.0,13,,,,,,,,,,,,,,,,,,,,,,,,,,,,,,,,,4,,,,,,,,,,,,,,,,,,,,,,,,,,,,,,,,,3,,,,,,,,,,,,,,,,,,,,,,,,,,,,,,,,,9,,,,,,,,,,,,,,,,,,,,,,,,,,,,,,,,,10,,,,,,,,,,,,,,,,,,,,,,,,,,,,,,,,,7,,,,,,,,,,,,,,,,,,,,,,,,,,,,,,,,,6,,,,,,,,,,,,,,,,,,,,,,,,,,,,,,,,,11,,,,,,,,,,,,,,,,,,,,,,,,,,,,,,,,,14,,,,,,,,,,,,,,,,,,,,,,,,,,,,,,,,,8,,,,,,,,,,,,,,,,,,,,,,,,,,,,,,,,,12,,,,,,,,,,,,,,,,,,,,,,,,,,,,,,,,,0,6.0,6.0,6.0,3.0,5.0,6.0,5.0,6.0,6.0,6.0,6.0,5.0,6.0,5.0,6.0,5.0,6.0,2.0,6.0,6.0,6.0,6.0,6.0,6.0,6.0,6.0,2.0,6.0,6.0,7.0,6.0,6.0,5,,,,,,,,,,,,,,,,,,,,,,,,,,,,,,,,,1,5.0,7.0,5.0,2.0,2.0,2.0,6.0,4.0,6.0,2.0,6.0,2.0,6.0,6.0,5.0,1.0,5.0,4.0,3.0,1.0,2.0,6.0,2.0,4.0,4.0,7.0,6.0,4.0,6.0,6.0,6.0,1.0,,630.06,19.01,,,,5.79,,8.31,,207.16,,,,,,,,,,,,,,,,,,,,,,,,,,,,,,,,,,,,50.47,,,,,,335.86,,,3.46,,APPROVED,Male,22.0,FALSE
197,2022-03-21 03:02:59,19,en,629717092,2022-03-21 02:55:39,2022-03-21 03:02:59,Y,Y,-oth-,High School Graduate,,4,,,,,,,,,,,,,,,,,,,,,,,,,,,,,,,,,14,,,,,,,,,,,,,,,,,,,,,,,,,,,,,,,,,2,7.0,7.0,7.0,4.0,7.0,6.0,7.0,7.0,7.0,6.0,4.0,6.0,7.0,7.0,7.0,6.0,7.0,5.0,7.0,6.0,6.0,6.0,5.0,7.0,6.0,5.0,3.0,6.0,5.0,6.0,3.0,3.0,8,,,,,,,,,,,,,,,,,,,,,,,,,,,,,,,,,3,,,,,,,,,,,,,,,,,,,,,,,,,,,,,,,,,11,,,,,,,,,,,,,,,,,,,,,,,,,,,,,,,,,9,,,,,,,,,,,,,,,,,,,,,,,,,,,,,,,,,5,,,,,,,,,,,,,,,,,,,,,,,,,,,,,,,,,13,,,,,,,,,,,,,,,,,,,,,,,,,,,,,,,,,7,,,,,,,,,,,,,,,,,,,,,,,,,,,,,,,,,0,1.0,5.0,1.0,1.0,1.0,1.0,7.0,3.0,5.0,2.0,1.0,2.0,2.0,5.0,3.0,2.0,6.0,1.0,2.0,1.0,3.0,1.0,1.0,2.0,1.0,1.0,5.0,2.0,2.0,1.0,1.0,4.0,6,,,,,,,,,,,,,,,,,,,,,,,,,,,,,,,,,12,,,,,,,,,,,,,,,,,,,,,,,,,,,,,,,,,1,1.0,1.0,1.0,2.0,1.0,4.0,5.0,1.0,3.0,1.0,1.0,5.0,1.0,5.0,5.0,2.0,7.0,1.0,1.0,1.0,4.0,1.0,5.0,1.0,1.0,5.0,1.0,1.0,1.0,1.0,4.0,7.0,10,,,,,,,,,,,,,,,,,,,,,,,,,,,,,,,,,,441.29,22.05,,,,24.39,,40.54,,,,,,,,103.7,,,,,,,,,,,,,,,,,,,,,,,,126.14,,,,,,,,,120.03,,,,,,4.44,,APPROVED,Male,29.0,FALSE
198,2022-03-21 03:00:27,19,en,827308780,2022-03-21 02:55:47,2022-03-21 03:00:27,Y,Y,A3,,,3,,,,,,,,,,,,,,,,,,,,,,,,,,,,,,,,,2,5.0,3.0,3.0,6.0,3.0,6.0,4.0,5.0,3.0,4.0,5.0,5.0,2.0,3.0,4.0,4.0,5.0,3.0,4.0,2.0,3.0,4.0,5.0,4.0,3.0,5.0,4.0,5.0,4.0,4.0,3.0,2.0,14,,,,,,,,,,,,,,,,,,,,,,,,,,,,,,,,,10,,,,,,,,,,,,,,,,,,,,,,,,,,,,,,,,,7,,,,,,,,,,,,,,,,,,,,,,,,,,,,,,,,,6,,,,,,,,,,,,,,,,,,,,,,,,,,,,,,,,,12,,,,,,,,,,,,,,,,,,,,,,,,,,,,,,,,,1,5.0,5.0,5.0,4.0,4.0,2.0,4.0,5.0,6.0,6.0,4.0,6.0,5.0,5.0,2.0,5.0,5.0,5.0,4.0,5.0,5.0,5.0,2.0,4.0,4.0,2.0,4.0,3.0,5.0,4.0,3.0,1.0,13,,,,,,,,,,,,,,,,,,,,,,,,,,,,,,,,,0,2.0,5.0,1.0,1.0,1.0,1.0,1.0,1.0,1.0,1.0,1.0,1.0,1.0,1.0,1.0,1.0,1.0,1.0,1.0,1.0,2.0,1.0,1.0,1.0,1.0,4.0,5.0,2.0,3.0,1.0,2.0,3.0,11,,,,,,,,,,,,,,,,,,,,,,,,,,,,,,,,,5,,,,,,,,,,,,,,,,,,,,,,,,,,,,,,,,,4,,,,,,,,,,,,,,,,,,,,,,,,,,,,,,,,,8,,,,,,,,,,,,,,,,,,,,,,,,,,,,,,,,,9,,,,,,,,,,,,,,,,,,,,,,,,,,,,,,,,,,283.89,10.75,,,,10.16,,18.5,,,,,102.27,,,,,,,,,,,,,,,,,,74.58,,,,,,64.76,,,,,,,,,,,,,,,,,,2.87,,APPROVED,Male,21.0,FALSE
199,2022-03-21 03:01:36,19,en,408085601,2022-03-21 02:55:56,2022-03-21 03:01:36,Y,Y,-oth-,highscool,,9,,,,,,,,,,,,,,,,,,,,,,,,,,,,,,,,,10,,,,,,,,,,,,,,,,,,,,,,,,,,,,,,,,,7,,,,,,,,,,,,,,,,,,,,,,,,,,,,,,,,,4,,,,,,,,,,,,,,,,,,,,,,,,,,,,,,,,,1,5.0,5.0,5.0,5.0,5.0,3.0,7.0,5.0,6.0,5.0,5.0,6.0,5.0,5.0,5.0,5.0,5.0,5.0,5.0,3.0,5.0,5.0,6.0,3.0,5.0,5.0,3.0,5.0,5.0,5.0,5.0,5.0,5,,,,,,,,,,,,,,,,,,,,,,,,,,,,,,,,,2,1.0,5.0,1.0,4.0,1.0,5.0,7.0,5.0,6.0,2.0,3.0,1.0,1.0,3.0,5.0,1.0,6.0,3.0,3.0,1.0,2.0,2.0,6.0,2.0,2.0,3.0,6.0,1.0,2.0,1.0,3.0,7.0,12,,,,,,,,,,,,,,,,,,,,,,,,,,,,,,,,,14,,,,,,,,,,,,,,,,,,,,,,,,,,,,,,,,,8,,,,,,,,,,,,,,,,,,,,,,,,,,,,,,,,,0,1.0,5.0,1.0,2.0,1.0,1.0,6.0,2.0,5.0,2.0,2.0,1.0,1.0,2.0,6.0,2.0,5.0,2.0,1.0,1.0,1.0,1.0,3.0,1.0,1.0,1.0,5.0,2.0,2.0,2.0,1.0,4.0,3,,,,,,,,,,,,,,,,,,,,,,,,,,,,,,,,,11,,,,,,,,,,,,,,,,,,,,,,,,,,,,,,,,,6,,,,,,,,,,,,,,,,,,,,,,,,,,,,,,,,,13,,,,,,,,,,,,,,,,,,,,,,,,,,,,,,,,,,343.71,15.72,,,,25.77,,18.44,,,,,,,,,,,,,,87.83,,,,,,89.33,,,,,,,,,,,,99.57,,,,,,,,,,,,,,,7.05,,APPROVED,Female,19.0,FALSE
200,2022-03-21 03:03:41,19,en,1439660426,2022-03-21 02:56:07,2022-03-21 03:03:41,Y,Y,A1,,,9,,,,,,,,,,,,,,,,,,,,,,,,,,,,,,,,,14,,,,,,,,,,,,,,,,,,,,,,,,,,,,,,,,,1,6.0,7.0,6.0,6.0,6.0,6.0,3.0,7.0,6.0,5.0,6.0,6.0,6.0,6.0,7.0,6.0,6.0,6.0,6.0,7.0,6.0,6.0,6.0,6.0,6.0,5.0,3.0,6.0,6.0,5.0,5.0,3.0,5,,,,,,,,,,,,,,,,,,,,,,,,,,,,,,,,,0,5.0,5.0,5.0,5.0,3.0,4.0,5.0,4.0,5.0,4.0,5.0,5.0,5.0,5.0,5.0,4.0,5.0,5.0,5.0,5.0,5.0,4.0,5.0,5.0,5.0,4.0,2.0,5.0,5.0,5.0,5.0,5.0,7,,,,,,,,,,,,,,,,,,,,,,,,,,,,,,,,,13,,,,,,,,,,,,,,,,,,,,,,,,,,,,,,,,,8,,,,,,,,,,,,,,,,,,,,,,,,,,,,,,,,,4,,,,,,,,,,,,,,,,,,,,,,,,,,,,,,,,,3,,,,,,,,,,,,,,,,,,,,,,,,,,,,,,,,,10,,,,,,,,,,,,,,,,,,,,,,,,,,,,,,,,,12,,,,,,,,,,,,,,,,,,,,,,,,,,,,,,,,,6,,,,,,,,,,,,,,,,,,,,,,,,,,,,,,,,,11,,,,,,,,,,,,,,,,,,,,,,,,,,,,,,,,,2,3.0,4.0,4.0,4.0,4.0,4.0,4.0,2.0,7.0,3.0,4.0,3.0,4.0,4.0,4.0,3.0,4.0,4.0,4.0,4.0,4.0,4.0,4.0,3.0,4.0,4.0,5.0,4.0,4.0,3.0,4.0,1.0,,457.99,15.47,,,,5.85,,27.08,,,,,,,,237.62,,,,,,83.19,,,,,,,,,,,,,,,,,,,,,,,,,,,,,,84.85,,,3.93,,APPROVED,Male,34.0,FALSE
201,2022-03-21 03:03:59,19,en,1407362187,2022-03-21 02:56:20,2022-03-21 03:03:58,Y,Y,A1,,,14,,,,,,,,,,,,,,,,,,,,,,,,,,,,,,,,,2,7.0,6.0,6.0,6.0,6.0,7.0,4.0,6.0,6.0,6.0,4.0,5.0,6.0,6.0,6.0,6.0,6.0,6.0,6.0,4.0,6.0,7.0,6.0,5.0,6.0,6.0,6.0,6.0,5.0,6.0,6.0,2.0,9,,,,,,,,,,,,,,,,,,,,,,,,,,,,,,,,,13,,,,,,,,,,,,,,,,,,,,,,,,,,,,,,,,,6,,,,,,,,,,,,,,,,,,,,,,,,,,,,,,,,,12,,,,,,,,,,,,,,,,,,,,,,,,,,,,,,,,,3,,,,,,,,,,,,,,,,,,,,,,,,,,,,,,,,,8,,,,,,,,,,,,,,,,,,,,,,,,,,,,,,,,,11,,,,,,,,,,,,,,,,,,,,,,,,,,,,,,,,,1,5.0,6.0,5.0,3.0,5.0,2.0,4.0,5.0,6.0,5.0,5.0,6.0,5.0,5.0,5.0,3.0,5.0,3.0,5.0,4.0,5.0,6.0,3.0,5.0,6.0,5.0,4.0,5.0,5.0,4.0,4.0,3.0,10,,,,,,,,,,,,,,,,,,,,,,,,,,,,,,,,,5,,,,,,,,,,,,,,,,,,,,,,,,,,,,,,,,,0,2.0,6.0,2.0,2.0,5.0,3.0,5.0,5.0,5.0,3.0,3.0,4.0,5.0,3.0,3.0,2.0,5.0,2.0,4.0,3.0,2.0,4.0,4.0,4.0,4.0,2.0,4.0,4.0,3.0,4.0,1.0,6.0,4,,,,,,,,,,,,,,,,,,,,,,,,,,,,,,,,,7,,,,,,,,,,,,,,,,,,,,,,,,,,,,,,,,,,464.2,31.64,,,,11.08,,23.57,,,,,153.67,,,,,,,,,,,,,,,,,,,,,,,,130.74,,,,,,,,,109.5,,,,,,,,,4.0,,APPROVED,Female,24.0,FALSE
202,2022-03-21 03:09:20,19,en,490496324,2022-03-21 02:56:38,2022-03-21 03:09:20,Y,Y,-oth-,none,,10,,,,,,,,,,,,,,,,,,,,,,,,,,,,,,,,,9,,,,,,,,,,,,,,,,,,,,,,,,,,,,,,,,,13,,,,,,,,,,,,,,,,,,,,,,,,,,,,,,,,,14,,,,,,,,,,,,,,,,,,,,,,,,,,,,,,,,,12,,,,,,,,,,,,,,,,,,,,,,,,,,,,,,,,,3,,,,,,,,,,,,,,,,,,,,,,,,,,,,,,,,,1,1.0,4.0,1.0,2.0,1.0,1.0,6.0,6.0,1.0,1.0,1.0,1.0,1.0,3.0,1.0,1.0,1.0,1.0,3.0,1.0,1.0,1.0,4.0,4.0,4.0,1.0,1.0,6.0,1.0,1.0,1.0,7.0,0,6.0,1.0,6.0,4.0,6.0,7.0,6.0,1.0,6.0,1.0,1.0,7.0,5.0,6.0,7.0,2.0,7.0,7.0,3.0,1.0,7.0,1.0,1.0,1.0,1.0,4.0,4.0,1.0,2.0,4.0,2.0,1.0,5,,,,,,,,,,,,,,,,,,,,,,,,,,,,,,,,,4,,,,,,,,,,,,,,,,,,,,,,,,,,,,,,,,,6,,,,,,,,,,,,,,,,,,,,,,,,,,,,,,,,,2,5.0,4.0,7.0,3.0,7.0,7.0,1.0,1.0,3.0,5.0,4.0,6.0,7.0,7.0,7.0,6.0,7.0,6.0,6.0,5.0,6.0,3.0,6.0,7.0,4.0,6.0,4.0,7.0,6.0,4.0,3.0,5.0,11,,,,,,,,,,,,,,,,,,,,,,,,,,,,,,,,,8,,,,,,,,,,,,,,,,,,,,,,,,,,,,,,,,,7,,,,,,,,,,,,,,,,,,,,,,,,,,,,,,,,,"Survay did not load at the begining. I had to to wait to start couple of minutes, but ater all nice survey and I enjoyed it!!!",767.18,17.43,,,,66.63,,39.72,,,,,,,,,,,,,,,,,,,,116.04,,,179.94,,,,,,,,,,,,200.24,,,,,,,,,,,,147.18,,APPROVED,Female,38.0,FALSE
203,2022-03-21 03:06:15,19,en,1888536812,2022-03-21 02:56:59,2022-03-21 03:06:15,Y,Y,-oth-,High School (or equivalent),,7,,,,,,,,,,,,,,,,,,,,,,,,,,,,,,,,,6,,,,,,,,,,,,,,,,,,,,,,,,,,,,,,,,,11,,,,,,,,,,,,,,,,,,,,,,,,,,,,,,,,,4,,,,,,,,,,,,,,,,,,,,,,,,,,,,,,,,,13,,,,,,,,,,,,,,,,,,,,,,,,,,,,,,,,,1,6.0,6.0,6.0,6.0,6.0,3.0,5.0,7.0,6.0,5.0,3.0,6.0,5.0,5.0,6.0,7.0,6.0,6.0,6.0,6.0,6.0,7.0,5.0,5.0,7.0,3.0,3.0,5.0,3.0,5.0,5.0,6.0,3,,,,,,,,,,,,,,,,,,,,,,,,,,,,,,,,,10,,,,,,,,,,,,,,,,,,,,,,,,,,,,,,,,,0,2.0,1.0,2.0,6.0,2.0,6.0,6.0,6.0,3.0,2.0,5.0,3.0,3.0,1.0,2.0,5.0,3.0,2.0,3.0,1.0,2.0,2.0,5.0,2.0,2.0,5.0,5.0,2.0,5.0,2.0,2.0,2.0,8,,,,,,,,,,,,,,,,,,,,,,,,,,,,,,,,,9,,,,,,,,,,,,,,,,,,,,,,,,,,,,,,,,,2,6.0,7.0,6.0,3.0,7.0,2.0,6.0,7.0,6.0,6.0,5.0,5.0,6.0,5.0,6.0,7.0,5.0,3.0,5.0,6.0,3.0,6.0,3.0,6.0,6.0,3.0,6.0,6.0,6.0,5.0,5.0,5.0,5,,,,,,,,,,,,,,,,,,,,,,,,,,,,,,,,,14,,,,,,,,,,,,,,,,,,,,,,,,,,,,,,,,,12,,,,,,,,,,,,,,,,,,,,,,,,,,,,,,,,,"Interesting study, best wishes!",559.54,67.67,,,,45.5,,39.84,,,,,,,,,,,,,,,,,131.34,,,,,,,,,136.7,,,,,,,,,112.36,,,,,,,,,,,,26.13,,APPROVED,Female,28.0,FALSE
205,2022-03-21 03:01:27,19,en,1866402314,2022-03-21 02:57:10,2022-03-21 03:01:27,Y,Y,A1,,,11,,,,,,,,,,,,,,,,,,,,,,,,,,,,,,,,,10,,,,,,,,,,,,,,,,,,,,,,,,,,,,,,,,,2,7.0,7.0,6.0,6.0,7.0,7.0,4.0,7.0,7.0,4.0,7.0,6.0,5.0,5.0,6.0,7.0,6.0,5.0,5.0,5.0,4.0,4.0,5.0,6.0,6.0,4.0,6.0,7.0,5.0,6.0,6.0,3.0,7,,,,,,,,,,,,,,,,,,,,,,,,,,,,,,,,,1,3.0,2.0,3.0,3.0,2.0,4.0,6.0,6.0,3.0,2.0,2.0,5.0,3.0,3.0,3.0,3.0,5.0,3.0,3.0,2.0,2.0,3.0,5.0,2.0,2.0,4.0,3.0,2.0,5.0,5.0,5.0,5.0,0,2.0,7.0,1.0,4.0,2.0,2.0,7.0,4.0,5.0,2.0,2.0,6.0,2.0,4.0,4.0,2.0,5.0,2.0,2.0,2.0,2.0,2.0,2.0,2.0,2.0,3.0,7.0,2.0,3.0,1.0,3.0,6.0,14,,,,,,,,,,,,,,,,,,,,,,,,,,,,,,,,,5,,,,,,,,,,,,,,,,,,,,,,,,,,,,,,,,,9,,,,,,,,,,,,,,,,,,,,,,,,,,,,,,,,,13,,,,,,,,,,,,,,,,,,,,,,,,,,,,,,,,,6,,,,,,,,,,,,,,,,,,,,,,,,,,,,,,,,,3,,,,,,,,,,,,,,,,,,,,,,,,,,,,,,,,,4,,,,,,,,,,,,,,,,,,,,,,,,,,,,,,,,,8,,,,,,,,,,,,,,,,,,,,,,,,,,,,,,,,,12,,,,,,,,,,,,,,,,,,,,,,,,,,,,,,,,,,260.93,14.5,,,,4.8,,26.28,,,,,,,,69.81,,,,,,63.03,,,73.74,,,,,,,,,,,,,,,,,,,,,,,,,,,,,,8.77,,APPROVED,Male,25.0,FALSE
206,2022-03-21 03:00:48,19,en,1882681990,2022-03-21 02:57:12,2022-03-21 03:00:48,Y,Y,A1,,,7,,,,,,,,,,,,,,,,,,,,,,,,,,,,,,,,,3,,,,,,,,,,,,,,,,,,,,,,,,,,,,,,,,,11,,,,,,,,,,,,,,,,,,,,,,,,,,,,,,,,,2,7.0,6.0,5.0,7.0,5.0,7.0,7.0,7.0,7.0,6.0,7.0,6.0,5.0,5.0,6.0,6.0,7.0,7.0,7.0,7.0,5.0,7.0,7.0,7.0,5.0,7.0,5.0,7.0,7.0,7.0,7.0,4.0,9,,,,,,,,,,,,,,,,,,,,,,,,,,,,,,,,,12,,,,,,,,,,,,,,,,,,,,,,,,,,,,,,,,,5,,,,,,,,,,,,,,,,,,,,,,,,,,,,,,,,,0,4.0,1.0,3.0,7.0,6.0,1.0,3.0,1.0,4.0,1.0,7.0,3.0,3.0,3.0,4.0,3.0,1.0,5.0,5.0,2.0,4.0,6.0,7.0,3.0,1.0,3.0,1.0,6.0,2.0,1.0,6.0,1.0,13,,,,,,,,,,,,,,,,,,,,,,,,,,,,,,,,,8,,,,,,,,,,,,,,,,,,,,,,,,,,,,,,,,,14,,,,,,,,,,,,,,,,,,,,,,,,,,,,,,,,,10,,,,,,,,,,,,,,,,,,,,,,,,,,,,,,,,,6,,,,,,,,,,,,,,,,,,,,,,,,,,,,,,,,,1,3.0,5.0,2.0,4.0,5.0,7.0,4.0,7.0,5.0,4.0,2.0,3.0,5.0,2.0,5.0,4.0,6.0,2.0,5.0,4.0,5.0,5.0,7.0,6.0,7.0,7.0,3.0,7.0,7.0,7.0,7.0,7.0,4,,,,,,,,,,,,,,,,,,,,,,,,,,,,,,,,,,206.22,13.62,,,,7.07,,25.74,,,,,,,,,,,44.03,,,,,,,,,,,,62.84,,,,,,,,,,,,,,,,,,49.84,,,,,,3.08,,APPROVED,Male,24.0,FALSE
207,2022-03-21 03:13:34,19,en,1572243500,2022-03-21 02:57:15,2022-03-21 03:13:34,Y,Y,A1,,,1,3.0,7.0,2.0,1.0,2.0,1.0,4.0,1.0,6.0,2.0,1.0,2.0,2.0,2.0,2.0,1.0,6.0,2.0,3.0,3.0,2.0,3.0,1.0,2.0,3.0,5.0,4.0,2.0,4.0,4.0,4.0,1.0,0,6.0,2.0,6.0,6.0,4.0,6.0,4.0,6.0,4.0,4.0,6.0,4.0,5.0,3.0,4.0,5.0,5.0,4.0,5.0,4.0,4.0,6.0,6.0,5.0,5.0,5.0,2.0,4.0,4.0,4.0,6.0,2.0,6,,,,,,,,,,,,,,,,,,,,,,,,,,,,,,,,,11,,,,,,,,,,,,,,,,,,,,,,,,,,,,,,,,,8,,,,,,,,,,,,,,,,,,,,,,,,,,,,,,,,,3,,,,,,,,,,,,,,,,,,,,,,,,,,,,,,,,,5,,,,,,,,,,,,,,,,,,,,,,,,,,,,,,,,,4,,,,,,,,,,,,,,,,,,,,,,,,,,,,,,,,,7,,,,,,,,,,,,,,,,,,,,,,,,,,,,,,,,,13,,,,,,,,,,,,,,,,,,,,,,,,,,,,,,,,,12,,,,,,,,,,,,,,,,,,,,,,,,,,,,,,,,,2,3.0,3.0,1.0,3.0,4.0,5.0,4.0,6.0,4.0,3.0,6.0,3.0,4.0,2.0,2.0,2.0,4.0,2.0,4.0,3.0,6.0,6.0,1.0,6.0,3.0,4.0,3.0,3.0,6.0,4.0,5.0,5.0,14,,,,,,,,,,,,,,,,,,,,,,,,,,,,,,,,,10,,,,,,,,,,,,,,,,,,,,,,,,,,,,,,,,,9,,,,,,,,,,,,,,,,,,,,,,,,,,,,,,,,,,1144.91,310.98,,,,79.68,,551.26,,70.28,,,68.65,,,,,,,,,,,,,,,,,,,,,,,,,,,,,,61.04,,,,,,,,,,,,3.02,,APPROVED,Male,20.0,FALSE
208,2022-03-21 03:07:14,19,en,1193307945,2022-03-21 02:58:07,2022-03-21 03:07:14,Y,Y,A1,,,0,3.0,2.0,3.0,2.0,3.0,3.0,6.0,6.0,3.0,2.0,3.0,5.0,5.0,5.0,2.0,5.0,3.0,2.0,5.0,2.0,3.0,5.0,3.0,5.0,6.0,2.0,5.0,5.0,5.0,3.0,3.0,1.0,7,,,,,,,,,,,,,,,,,,,,,,,,,,,,,,,,,8,,,,,,,,,,,,,,,,,,,,,,,,,,,,,,,,,14,,,,,,,,,,,,,,,,,,,,,,,,,,,,,,,,,10,,,,,,,,,,,,,,,,,,,,,,,,,,,,,,,,,9,,,,,,,,,,,,,,,,,,,,,,,,,,,,,,,,,5,,,,,,,,,,,,,,,,,,,,,,,,,,,,,,,,,13,,,,,,,,,,,,,,,,,,,,,,,,,,,,,,,,,6,,,,,,,,,,,,,,,,,,,,,,,,,,,,,,,,,3,,,,,,,,,,,,,,,,,,,,,,,,,,,,,,,,,1,3.0,6.0,6.0,5.0,6.0,5.0,5.0,6.0,6.0,5.0,6.0,6.0,6.0,6.0,5.0,5.0,6.0,6.0,6.0,6.0,6.0,6.0,3.0,6.0,5.0,4.0,5.0,5.0,5.0,6.0,5.0,4.0,12,,,,,,,,,,,,,,,,,,,,,,,,,,,,,,,,,11,,,,,,,,,,,,,,,,,,,,,,,,,,,,,,,,,2,5.0,2.0,5.0,5.0,5.0,6.0,2.0,5.0,4.0,4.0,3.0,5.0,5.0,5.0,6.0,3.0,6.0,5.0,6.0,3.0,5.0,6.0,6.0,4.0,5.0,6.0,3.0,4.0,5.0,4.0,6.0,7.0,4,,,,,,,,,,,,,,,,,,,,,,,,,,,,,,,,,,549.06,44.89,,,,6.96,,100.17,,138.95,,,,,,,,,,,,,,,,,,,,,,,,,,,,,,141.21,,,,,,,,,111.83,,,,,,5.05,,APPROVED,Male,22.0,FALSE
209,2022-03-21 03:02:24,19,en,2115216268,2022-03-21 02:58:08,2022-03-21 03:02:24,Y,Y,A1,,,6,,,,,,,,,,,,,,,,,,,,,,,,,,,,,,,,,2,6.0,2.0,5.0,6.0,4.0,5.0,3.0,3.0,2.0,5.0,5.0,5.0,5.0,5.0,2.0,5.0,6.0,5.0,5.0,5.0,5.0,5.0,5.0,5.0,5.0,6.0,4.0,6.0,4.0,6.0,5.0,2.0,5,,,,,,,,,,,,,,,,,,,,,,,,,,,,,,,,,9,,,,,,,,,,,,,,,,,,,,,,,,,,,,,,,,,4,,,,,,,,,,,,,,,,,,,,,,,,,,,,,,,,,14,,,,,,,,,,,,,,,,,,,,,,,,,,,,,,,,,1,5.0,2.0,5.0,6.0,5.0,6.0,4.0,6.0,5.0,4.0,6.0,5.0,5.0,5.0,4.0,6.0,3.0,5.0,6.0,3.0,5.0,5.0,6.0,5.0,5.0,5.0,4.0,5.0,5.0,6.0,6.0,7.0,7,,,,,,,,,,,,,,,,,,,,,,,,,,,,,,,,,12,,,,,,,,,,,,,,,,,,,,,,,,,,,,,,,,,3,,,,,,,,,,,,,,,,,,,,,,,,,,,,,,,,,11,,,,,,,,,,,,,,,,,,,,,,,,,,,,,,,,,13,,,,,,,,,,,,,,,,,,,,,,,,,,,,,,,,,10,,,,,,,,,,,,,,,,,,,,,,,,,,,,,,,,,0,2.0,1.0,1.0,2.0,1.0,2.0,6.0,2.0,2.0,2.0,1.0,3.0,2.0,2.0,5.0,2.0,5.0,2.0,2.0,2.0,2.0,2.0,3.0,2.0,2.0,3.0,5.0,2.0,2.0,1.0,2.0,7.0,8,,,,,,,,,,,,,,,,,,,,,,,,,,,,,,,,,,260.09,14.37,,,,4.86,,32.44,,,,,68.91,,,,,,,,,,,,,,,67.89,,,,,,,,,,,,,,,,,,,,,68.27,,,,,,3.35,,APPROVED,Male,25.0,FALSE
210,2022-03-21 03:05:13,19,en,887536025,2022-03-21 02:58:58,2022-03-21 03:05:13,Y,Y,A1,,,14,,,,,,,,,,,,,,,,,,,,,,,,,,,,,,,,,9,,,,,,,,,,,,,,,,,,,,,,,,,,,,,,,,,8,,,,,,,,,,,,,,,,,,,,,,,,,,,,,,,,,10,,,,,,,,,,,,,,,,,,,,,,,,,,,,,,,,,7,,,,,,,,,,,,,,,,,,,,,,,,,,,,,,,,,6,,,,,,,,,,,,,,,,,,,,,,,,,,,,,,,,,5,,,,,,,,,,,,,,,,,,,,,,,,,,,,,,,,,1,5.0,6.0,3.0,4.0,4.0,3.0,5.0,5.0,5.0,4.0,3.0,5.0,5.0,4.0,4.0,4.0,4.0,4.0,4.0,4.0,4.0,5.0,2.0,5.0,5.0,2.0,4.0,3.0,5.0,5.0,5.0,1.0,0,6.0,7.0,5.0,4.0,5.0,5.0,3.0,4.0,6.0,5.0,6.0,5.0,5.0,5.0,6.0,6.0,5.0,4.0,5.0,3.0,3.0,3.0,5.0,5.0,5.0,2.0,4.0,5.0,6.0,5.0,6.0,2.0,2,5.0,6.0,6.0,6.0,6.0,6.0,5.0,4.0,6.0,4.0,6.0,3.0,3.0,5.0,6.0,4.0,6.0,4.0,5.0,4.0,3.0,5.0,5.0,5.0,5.0,3.0,5.0,5.0,5.0,6.0,6.0,3.0,12,,,,,,,,,,,,,,,,,,,,,,,,,,,,,,,,,3,,,,,,,,,,,,,,,,,,,,,,,,,,,,,,,,,4,,,,,,,,,,,,,,,,,,,,,,,,,,,,,,,,,13,,,,,,,,,,,,,,,,,,,,,,,,,,,,,,,,,11,,,,,,,,,,,,,,,,,,,,,,,,,,,,,,,,,,378.33,43.44,,,,24.39,,61.85,,,,,,,,,,,,,,,,,,,,,,,85.02,,,90.85,,,68.72,,,,,,,,,,,,,,,,,,4.06,,APPROVED,Male,21.0,FALSE
211,2022-03-21 03:01:59,19,en,493054806,2022-03-21 02:59:19,2022-03-21 03:01:59,Y,Y,A1,,,0,5.0,5.0,5.0,5.0,5.0,5.0,5.0,6.0,6.0,6.0,5.0,5.0,5.0,5.0,5.0,5.0,5.0,5.0,5.0,6.0,5.0,5.0,5.0,5.0,5.0,6.0,5.0,5.0,4.0,5.0,6.0,1.0,2,5.0,5.0,4.0,6.0,5.0,5.0,5.0,6.0,4.0,5.0,5.0,5.0,5.0,5.0,5.0,5.0,5.0,4.0,4.0,5.0,6.0,5.0,6.0,4.0,4.0,5.0,3.0,5.0,5.0,6.0,4.0,2.0,10,,,,,,,,,,,,,,,,,,,,,,,,,,,,,,,,,6,,,,,,,,,,,,,,,,,,,,,,,,,,,,,,,,,4,,,,,,,,,,,,,,,,,,,,,,,,,,,,,,,,,12,,,,,,,,,,,,,,,,,,,,,,,,,,,,,,,,,5,,,,,,,,,,,,,,,,,,,,,,,,,,,,,,,,,8,,,,,,,,,,,,,,,,,,,,,,,,,,,,,,,,,9,,,,,,,,,,,,,,,,,,,,,,,,,,,,,,,,,3,,,,,,,,,,,,,,,,,,,,,,,,,,,,,,,,,1,3.0,3.0,2.0,3.0,2.0,2.0,3.0,4.0,4.0,3.0,2.0,4.0,3.0,3.0,4.0,2.0,3.0,3.0,4.0,2.0,3.0,3.0,2.0,3.0,3.0,5.0,2.0,3.0,3.0,3.0,3.0,4.0,7,,,,,,,,,,,,,,,,,,,,,,,,,,,,,,,,,14,,,,,,,,,,,,,,,,,,,,,,,,,,,,,,,,,11,,,,,,,,,,,,,,,,,,,,,,,,,,,,,,,,,13,,,,,,,,,,,,,,,,,,,,,,,,,,,,,,,,,,163.02,9.26,,,,3.63,,12.4,,35.4,,,35.25,,,,,,,,,,,,,,,,,,,,,,,,,,,64.09,,,,,,,,,,,,,,,2.99,,APPROVED,Male,24.0,FALSE
212,2022-03-21 03:07:41,19,en,746704691,2022-03-21 02:59:21,2022-03-21 03:07:41,Y,Y,A1,,,2,2.0,5.0,3.0,4.0,3.0,2.0,6.0,3.0,5.0,2.0,2.0,3.0,6.0,5.0,6.0,4.0,5.0,3.0,3.0,2.0,4.0,3.0,3.0,5.0,2.0,3.0,4.0,5.0,4.0,3.0,3.0,1.0,5,,,,,,,,,,,,,,,,,,,,,,,,,,,,,,,,,11,,,,,,,,,,,,,,,,,,,,,,,,,,,,,,,,,8,,,,,,,,,,,,,,,,,,,,,,,,,,,,,,,,,6,,,,,,,,,,,,,,,,,,,,,,,,,,,,,,,,,1,5.0,6.0,5.0,4.0,5.0,5.0,5.0,4.0,7.0,4.0,4.0,5.0,5.0,5.0,6.0,4.0,7.0,5.0,5.0,3.0,6.0,5.0,5.0,4.0,5.0,5.0,5.0,4.0,6.0,5.0,4.0,6.0,9,,,,,,,,,,,,,,,,,,,,,,,,,,,,,,,,,12,,,,,,,,,,,,,,,,,,,,,,,,,,,,,,,,,10,,,,,,,,,,,,,,,,,,,,,,,,,,,,,,,,,3,,,,,,,,,,,,,,,,,,,,,,,,,,,,,,,,,14,,,,,,,,,,,,,,,,,,,,,,,,,,,,,,,,,7,,,,,,,,,,,,,,,,,,,,,,,,,,,,,,,,,1,5.0,6.0,6.0,5.0,5.0,3.0,7.0,6.0,7.0,4.0,5.0,5.0,6.0,6.0,6.0,4.0,7.0,4.0,5.0,5.0,5.0,5.0,5.0,4.0,5.0,6.0,4.0,6.0,7.0,6.0,5.0,6.0,13,,,,,,,,,,,,,,,,,,,,,,,,,,,,,,,,,4,,,,,,,,,,,,,,,,,,,,,,,,,,,,,,,,,,506.54,15.91,,,,18.44,,44.49,,106.82,,,,,,,,,,,,,,,145.11,,,,,,,,,,,,,,,,,,,,,159.05,,,,,,,,,16.72,,APPROVED,Female,28.0,FALSE
213,2022-03-21 03:03:57,19,en,1929193580,2022-03-21 02:59:21,2022-03-21 03:03:57,Y,Y,A1,,,14,,,,,,,,,,,,,,,,,,,,,,,,,,,,,,,,,10,,,,,,,,,,,,,,,,,,,,,,,,,,,,,,,,,6,,,,,,,,,,,,,,,,,,,,,,,,,,,,,,,,,11,,,,,,,,,,,,,,,,,,,,,,,,,,,,,,,,,2,1.0,6.0,1.0,3.0,1.0,4.0,6.0,5.0,4.0,1.0,3.0,2.0,2.0,1.0,1.0,1.0,1.0,3.0,1.0,1.0,1.0,1.0,1.0,1.0,1.0,2.0,6.0,1.0,1.0,1.0,1.0,5.0,5,,,,,,,,,,,,,,,,,,,,,,,,,,,,,,,,,0,1.0,2.0,1.0,1.0,1.0,1.0,6.0,1.0,1.0,1.0,2.0,1.0,1.0,1.0,1.0,2.0,1.0,1.0,1.0,1.0,1.0,1.0,2.0,1.0,1.0,5.0,5.0,1.0,2.0,1.0,1.0,7.0,9,,,,,,,,,,,,,,,,,,,,,,,,,,,,,,,,,7,,,,,,,,,,,,,,,,,,,,,,,,,,,,,,,,,3,,,,,,,,,,,,,,,,,,,,,,,,,,,,,,,,,1,1.0,5.0,1.0,1.0,1.0,1.0,6.0,5.0,5.0,1.0,1.0,3.0,1.0,1.0,4.0,1.0,1.0,1.0,1.0,1.0,1.0,1.0,1.0,1.0,1.0,1.0,6.0,1.0,1.0,1.0,1.0,4.0,12,,,,,,,,,,,,,,,,,,,,,,,,,,,,,,,,,4,,,,,,,,,,,,,,,,,,,,,,,,,,,,,,,,,13,,,,,,,,,,,,,,,,,,,,,,,,,,,,,,,,,8,,,,,,,,,,,,,,,,,,,,,,,,,,,,,,,,,,280.75,23.59,,,,7.63,,34.18,,,,,,,,,,,,,,63.92,,,,,,76.96,,,,,,,,,,,,67.93,,,,,,,,,,,,,,,6.54,,APPROVED,Female,33.0,FALSE
214,2022-03-21 03:06:09,19,en,79541731,2022-03-21 02:59:45,2022-03-21 03:06:09,Y,Y,A1,,,0,4.0,7.0,5.0,5.0,5.0,5.0,5.0,4.0,7.0,4.0,6.0,6.0,4.0,5.0,5.0,5.0,6.0,5.0,6.0,5.0,6.0,5.0,4.0,6.0,6.0,6.0,4.0,5.0,5.0,5.0,6.0,1.0,14,,,,,,,,,,,,,,,,,,,,,,,,,,,,,,,,,6,,,,,,,,,,,,,,,,,,,,,,,,,,,,,,,,,12,,,,,,,,,,,,,,,,,,,,,,,,,,,,,,,,,5,,,,,,,,,,,,,,,,,,,,,,,,,,,,,,,,,7,,,,,,,,,,,,,,,,,,,,,,,,,,,,,,,,,11,,,,,,,,,,,,,,,,,,,,,,,,,,,,,,,,,13,,,,,,,,,,,,,,,,,,,,,,,,,,,,,,,,,2,2.0,3.0,3.0,2.0,3.0,3.0,2.0,4.0,2.0,3.0,1.0,2.0,2.0,3.0,1.0,2.0,2.0,1.0,2.0,3.0,3.0,3.0,5.0,1.0,2.0,4.0,1.0,4.0,2.0,1.0,2.0,2.0,10,,,,,,,,,,,,,,,,,,,,,,,,,,,,,,,,,8,,,,,,,,,,,,,,,,,,,,,,,,,,,,,,,,,4,,,,,,,,,,,,,,,,,,,,,,,,,,,,,,,,,1,1.0,2.0,1.0,2.0,2.0,1.0,2.0,2.0,2.0,1.0,1.0,1.0,2.0,2.0,2.0,1.0,2.0,1.0,2.0,2.0,2.0,2.0,1.0,2.0,2.0,4.0,2.0,2.0,1.0,2.0,2.0,6.0,3,,,,,,,,,,,,,,,,,,,,,,,,,,,,,,,,,9,,,,,,,,,,,,,,,,,,,,,,,,,,,,,,,,,,388.34,16.35,,,,27.76,,28.5,,160.65,,,,,,,,,,,,,,,,,,,,,,,,99.88,,,,,,,,,,,,49.8,,,,,,,,,5.4,,APPROVED,Male,26.0,FALSE
215,2022-03-21 03:03:36,19,en,518390229,2022-03-21 02:59:52,2022-03-21 03:03:36,Y,Y,A1,,,10,,,,,,,,,,,,,,,,,,,,,,,,,,,,,,,,,9,,,,,,,,,,,,,,,,,,,,,,,,,,,,,,,,,14,,,,,,,,,,,,,,,,,,,,,,,,,,,,,,,,,6,,,,,,,,,,,,,,,,,,,,,,,,,,,,,,,,,13,,,,,,,,,,,,,,,,,,,,,,,,,,,,,,,,,8,,,,,,,,,,,,,,,,,,,,,,,,,,,,,,,,,4,,,,,,,,,,,,,,,,,,,,,,,,,,,,,,,,,0,4.0,2.0,6.0,3.0,4.0,3.0,4.0,4.0,4.0,4.0,4.0,4.0,4.0,4.0,4.0,3.0,6.0,4.0,4.0,4.0,4.0,6.0,3.0,2.0,2.0,5.0,4.0,4.0,4.0,4.0,2.0,1.0,7,,,,,,,,,,,,,,,,,,,,,,,,,,,,,,,,,11,,,,,,,,,,,,,,,,,,,,,,,,,,,,,,,,,5,,,,,,,,,,,,,,,,,,,,,,,,,,,,,,,,,12,,,,,,,,,,,,,,,,,,,,,,,,,,,,,,,,,3,,,,,,,,,,,,,,,,,,,,,,,,,,,,,,,,,1,4.0,3.0,4.0,3.0,3.0,5.0,4.0,4.0,4.0,4.0,4.0,3.0,4.0,4.0,4.0,4.0,6.0,4.0,2.0,2.0,4.0,2.0,4.0,4.0,2.0,5.0,4.0,4.0,4.0,4.0,4.0,7.0,2,4.0,4.0,4.0,4.0,4.0,4.0,4.0,4.0,4.0,4.0,4.0,4.0,4.0,4.0,4.0,4.0,4.0,4.0,4.0,4.0,4.0,4.0,4.0,4.0,4.0,4.0,4.0,4.0,4.0,4.0,4.0,1.0,,227.45,20.32,,,,7.85,,13.36,,,,,,,,,,,,,,,,,,,,,,,63.75,,,,,,,,,,,,,,,,,,72.43,,,45.55,,,4.19,,APPROVED,Female,26.0,FALSE
216,2022-03-21 03:06:30,19,en,1534983654,2022-03-21 03:00:41,2022-03-21 03:06:30,Y,Y,A1,,,14,,,,,,,,,,,,,,,,,,,,,,,,,,,,,,,,,9,,,,,,,,,,,,,,,,,,,,,,,,,,,,,,,,,11,,,,,,,,,,,,,,,,,,,,,,,,,,,,,,,,,5,,,,,,,,,,,,,,,,,,,,,,,,,,,,,,,,,7,,,,,,,,,,,,,,,,,,,,,,,,,,,,,,,,,8,,,,,,,,,,,,,,,,,,,,,,,,,,,,,,,,,3,,,,,,,,,,,,,,,,,,,,,,,,,,,,,,,,,2,5.0,2.0,3.0,6.0,3.0,2.0,7.0,7.0,3.0,5.0,2.0,5.0,5.0,2.0,6.0,3.0,6.0,4.0,4.0,2.0,2.0,6.0,7.0,4.0,5.0,7.0,2.0,2.0,3.0,5.0,7.0,1.0,12,,,,,,,,,,,,,,,,,,,,,,,,,,,,,,,,,13,,,,,,,,,,,,,,,,,,,,,,,,,,,,,,,,,6,,,,,,,,,,,,,,,,,,,,,,,,,,,,,,,,,2,6.0,7.0,5.0,7.0,7.0,3.0,2.0,7.0,7.0,7.0,6.0,5.0,2.0,7.0,6.0,5.0,7.0,2.0,3.0,4.0,4.0,4.0,6.0,7.0,4.0,7.0,7.0,6.0,6.0,5.0,6.0,5.0,10,,,,,,,,,,,,,,,,,,,,,,,,,,,,,,,,,4,,,,,,,,,,,,,,,,,,,,,,,,,,,,,,,,,2,6.0,7.0,6.0,5.0,5.0,6.0,7.0,7.0,7.0,6.0,6.0,4.0,5.0,6.0,7.0,4.0,7.0,2.0,5.0,5.0,3.0,6.0,4.0,7.0,4.0,6.0,6.0,3.0,7.0,4.0,5.0,1.0,Good luck with the study,354.42,28.5,,,,6.57,,34.57,,,,,,,,,,,,,,,,,,,,,,,83.82,,,,,,,,,,,,107.24,,,,,,,,,84.88,,,8.84,,APPROVED,Male,24.0,FALSE
217,2022-03-21 03:08:56,19,en,409670583,2022-03-21 03:00:58,2022-03-21 03:08:56,Y,Y,A1,,,11,,,,,,,,,,,,,,,,,,,,,,,,,,,,,,,,,6,,,,,,,,,,,,,,,,,,,,,,,,,,,,,,,,,8,,,,,,,,,,,,,,,,,,,,,,,,,,,,,,,,,9,,,,,,,,,,,,,,,,,,,,,,,,,,,,,,,,,2,6.0,7.0,7.0,7.0,5.0,7.0,4.0,7.0,7.0,4.0,4.0,7.0,6.0,7.0,6.0,7.0,7.0,7.0,6.0,7.0,7.0,7.0,7.0,7.0,1.0,7.0,1.0,7.0,4.0,7.0,7.0,5.0,1,7.0,7.0,7.0,7.0,7.0,7.0,1.0,7.0,7.0,7.0,7.0,7.0,7.0,7.0,7.0,7.0,7.0,7.0,7.0,7.0,7.0,7.0,7.0,7.0,7.0,7.0,1.0,7.0,7.0,7.0,7.0,6.0,3,,,,,,,,,,,,,,,,,,,,,,,,,,,,,,,,,13,,,,,,,,,,,,,,,,,,,,,,,,,,,,,,,,,12,,,,,,,,,,,,,,,,,,,,,,,,,,,,,,,,,0,6.0,7.0,6.0,6.0,4.0,4.0,6.0,1.0,6.0,1.0,1.0,6.0,6.0,7.0,1.0,4.0,7.0,7.0,1.0,6.0,2.0,1.0,1.0,1.0,1.0,4.0,1.0,6.0,6.0,6.0,6.0,3.0,5,,,,,,,,,,,,,,,,,,,,,,,,,,,,,,,,,4,,,,,,,,,,,,,,,,,,,,,,,,,,,,,,,,,14,,,,,,,,,,,,,,,,,,,,,,,,,,,,,,,,,7,,,,,,,,,,,,,,,,,,,,,,,,,,,,,,,,,10,,,,,,,,,,,,,,,,,,,,,,,,,,,,,,,,,,473.6,31.13,,,,17.64,,50.12,,,,,,,,,,,,,,103.22,,,81.33,,,,,,,,,,,,179.8,,,,,,,,,,,,,,,,,,10.36,,APPROVED,Male,30.0,FALSE
218,2022-03-21 03:07:06,19,en,221586200,2022-03-21 03:01:10,2022-03-21 03:07:06,Y,Y,-oth-,none,,0,3.0,5.0,3.0,3.0,3.0,3.0,5.0,5.0,5.0,3.0,3.0,3.0,3.0,3.0,3.0,3.0,3.0,3.0,3.0,5.0,3.0,3.0,3.0,3.0,5.0,5.0,3.0,3.0,5.0,3.0,3.0,1.0,1,6.0,5.0,6.0,6.0,6.0,6.0,2.0,6.0,6.0,6.0,6.0,6.0,6.0,6.0,6.0,6.0,6.0,6.0,6.0,6.0,6.0,6.0,6.0,6.0,6.0,6.0,2.0,6.0,5.0,6.0,6.0,2.0,3,,,,,,,,,,,,,,,,,,,,,,,,,,,,,,,,,6,,,,,,,,,,,,,,,,,,,,,,,,,,,,,,,,,4,,,,,,,,,,,,,,,,,,,,,,,,,,,,,,,,,2,5.0,6.0,6.0,5.0,5.0,5.0,5.0,6.0,6.0,5.0,5.0,6.0,6.0,5.0,6.0,5.0,6.0,6.0,6.0,5.0,5.0,6.0,5.0,6.0,6.0,6.0,3.0,6.0,5.0,5.0,5.0,6.0,13,,,,,,,,,,,,,,,,,,,,,,,,,,,,,,,,,11,,,,,,,,,,,,,,,,,,,,,,,,,,,,,,,,,10,,,,,,,,,,,,,,,,,,,,,,,,,,,,,,,,,8,,,,,,,,,,,,,,,,,,,,,,,,,,,,,,,,,12,,,,,,,,,,,,,,,,,,,,,,,,,,,,,,,,,14,,,,,,,,,,,,,,,,,,,,,,,,,,,,,,,,,7,,,,,,,,,,,,,,,,,,,,,,,,,,,,,,,,,5,,,,,,,,,,,,,,,,,,,,,,,,,,,,,,,,,9,,,,,,,,,,,,,,,,,,,,,,,,,,,,,,,,,,359.51,25.51,,,,38.77,,51.16,,107.54,,,61.28,,,,,,,,,,,,67.71,,,,,,,,,,,,,,,,,,,,,,,,,,,,,,7.54,,APPROVED,Male,29.0,FALSE
219,2022-03-21 03:04:42,19,en,937753240,2022-03-21 03:01:28,2022-03-21 03:04:42,Y,Y,A1,,,0,2.0,5.0,3.0,2.0,2.0,1.0,6.0,4.0,4.0,2.0,2.0,5.0,3.0,3.0,4.0,3.0,5.0,2.0,3.0,3.0,2.0,3.0,3.0,6.0,3.0,2.0,5.0,2.0,2.0,3.0,5.0,1.0,8,,,,,,,,,,,,,,,,,,,,,,,,,,,,,,,,,2,5.0,3.0,4.0,6.0,4.0,4.0,3.0,5.0,5.0,4.0,5.0,4.0,4.0,4.0,4.0,2.0,5.0,5.0,4.0,5.0,3.0,3.0,5.0,3.0,5.0,5.0,2.0,5.0,4.0,5.0,5.0,1.0,5,,,,,,,,,,,,,,,,,,,,,,,,,,,,,,,,,13,,,,,,,,,,,,,,,,,,,,,,,,,,,,,,,,,1,6.0,6.0,5.0,4.0,4.0,4.0,3.0,6.0,7.0,5.0,4.0,5.0,5.0,5.0,5.0,5.0,6.0,4.0,5.0,5.0,3.0,5.0,3.0,6.0,5.0,5.0,3.0,6.0,3.0,5.0,6.0,6.0,10,,,,,,,,,,,,,,,,,,,,,,,,,,,,,,,,,3,,,,,,,,,,,,,,,,,,,,,,,,,,,,,,,,,4,,,,,,,,,,,,,,,,,,,,,,,,,,,,,,,,,9,,,,,,,,,,,,,,,,,,,,,,,,,,,,,,,,,12,,,,,,,,,,,,,,,,,,,,,,,,,,,,,,,,,7,,,,,,,,,,,,,,,,,,,,,,,,,,,,,,,,,6,,,,,,,,,,,,,,,,,,,,,,,,,,,,,,,,,14,,,,,,,,,,,,,,,,,,,,,,,,,,,,,,,,,11,,,,,,,,,,,,,,,,,,,,,,,,,,,,,,,,,,197.37,13.51,,,,3.58,,18.62,,50.71,,,,,,67.08,,,,,,,,,41.34,,,,,,,,,,,,,,,,,,,,,,,,,,,,,,2.53,,APPROVED,Female,22.0,FALSE
220,2022-03-21 03:06:23,19,en,1359221163,2022-03-21 03:02:02,2022-03-21 03:06:23,Y,Y,A1,,,10,,,,,,,,,,,,,,,,,,,,,,,,,,,,,,,,,14,,,,,,,,,,,,,,,,,,,,,,,,,,,,,,,,,7,,,,,,,,,,,,,,,,,,,,,,,,,,,,,,,,,4,,,,,,,,,,,,,,,,,,,,,,,,,,,,,,,,,6,,,,,,,,,,,,,,,,,,,,,,,,,,,,,,,,,5,,,,,,,,,,,,,,,,,,,,,,,,,,,,,,,,,9,,,,,,,,,,,,,,,,,,,,,,,,,,,,,,,,,1,6.0,3.0,5.0,3.0,3.0,3.0,5.0,5.0,6.0,6.0,2.0,6.0,6.0,4.0,4.0,4.0,6.0,5.0,6.0,6.0,6.0,5.0,3.0,6.0,5.0,1.0,3.0,6.0,3.0,5.0,2.0,1.0,12,,,,,,,,,,,,,,,,,,,,,,,,,,,,,,,,,8,,,,,,,,,,,,,,,,,,,,,,,,,,,,,,,,,2,1.0,5.0,1.0,1.0,3.0,1.0,7.0,6.0,5.0,1.0,2.0,1.0,1.0,1.0,1.0,1.0,1.0,1.0,1.0,1.0,1.0,3.0,1.0,1.0,1.0,5.0,1.0,1.0,5.0,1.0,1.0,4.0,13,,,,,,,,,,,,,,,,,,,,,,,,,,,,,,,,,3,,,,,,,,,,,,,,,,,,,,,,,,,,,,,,,,,11,,,,,,,,,,,,,,,,,,,,,,,,,,,,,,,,,0,4.0,5.0,3.0,3.0,6.0,3.0,6.0,4.0,6.0,4.0,4.0,3.0,4.0,4.0,4.0,3.0,5.0,3.0,4.0,4.0,3.0,5.0,2.0,5.0,6.0,6.0,4.0,2.0,5.0,4.0,3.0,1.0,,262.93,14.77,,,,5.07,,29.27,,,,,,,,,,,,,,,,,,,,,,,64.89,,,,,,,,,66.27,,,,,,,,,,,,79.32,,,3.34,,APPROVED,Male,21.0,FALSE
221,2022-03-21 03:07:38,19,en,10843582,2022-03-21 03:03:09,2022-03-21 03:07:38,Y,Y,-oth-,high school,,0,1.0,1.0,1.0,1.0,1.0,1.0,7.0,1.0,1.0,1.0,1.0,1.0,1.0,1.0,1.0,1.0,1.0,1.0,1.0,1.0,1.0,1.0,1.0,1.0,1.0,2.0,2.0,1.0,1.0,1.0,1.0,1.0,2,4.0,4.0,6.0,4.0,5.0,5.0,2.0,6.0,4.0,4.0,4.0,5.0,5.0,4.0,4.0,4.0,5.0,4.0,5.0,4.0,4.0,4.0,6.0,4.0,5.0,4.0,4.0,4.0,4.0,4.0,5.0,2.0,4,,,,,,,,,,,,,,,,,,,,,,,,,,,,,,,,,9,,,,,,,,,,,,,,,,,,,,,,,,,,,,,,,,,6,,,,,,,,,,,,,,,,,,,,,,,,,,,,,,,,,11,,,,,,,,,,,,,,,,,,,,,,,,,,,,,,,,,14,,,,,,,,,,,,,,,,,,,,,,,,,,,,,,,,,7,,,,,,,,,,,,,,,,,,,,,,,,,,,,,,,,,10,,,,,,,,,,,,,,,,,,,,,,,,,,,,,,,,,12,,,,,,,,,,,,,,,,,,,,,,,,,,,,,,,,,1,5.0,4.0,3.0,4.0,4.0,3.0,3.0,5.0,5.0,3.0,3.0,5.0,4.0,4.0,3.0,5.0,5.0,2.0,3.0,3.0,2.0,4.0,3.0,3.0,5.0,3.0,2.0,3.0,5.0,5.0,3.0,4.0,8,,,,,,,,,,,,,,,,,,,,,,,,,,,,,,,,,5,,,,,,,,,,,,,,,,,,,,,,,,,,,,,,,,,13,,,,,,,,,,,,,,,,,,,,,,,,,,,,,,,,,3,,,,,,,,,,,,,,,,,,,,,,,,,,,,,,,,,,272.27,40.25,,,,10.29,,55.12,,49.66,,,49.33,,,,,,,,,,,,,,,,,,,,,,,,,,,60.71,,,,,,,,,,,,,,,6.91,,APPROVED,Male,29.0,FALSE
222,2022-03-21 03:12:27,19,en,504869363,2022-03-21 03:03:21,2022-03-21 03:12:27,Y,Y,A1,,,8,,,,,,,,,,,,,,,,,,,,,,,,,,,,,,,,,6,,,,,,,,,,,,,,,,,,,,,,,,,,,,,,,,,5,,,,,,,,,,,,,,,,,,,,,,,,,,,,,,,,,4,,,,,,,,,,,,,,,,,,,,,,,,,,,,,,,,,14,,,,,,,,,,,,,,,,,,,,,,,,,,,,,,,,,13,,,,,,,,,,,,,,,,,,,,,,,,,,,,,,,,,9,,,,,,,,,,,,,,,,,,,,,,,,,,,,,,,,,2,1.0,2.0,1.0,1.0,1.0,1.0,6.0,1.0,2.0,3.0,1.0,1.0,1.0,2.0,4.0,1.0,1.0,2.0,1.0,1.0,1.0,1.0,1.0,1.0,1.0,1.0,1.0,1.0,1.0,1.0,1.0,1.0,11,,,,,,,,,,,,,,,,,,,,,,,,,,,,,,,,,7,,,,,,,,,,,,,,,,,,,,,,,,,,,,,,,,,2,5.0,6.0,4.0,4.0,4.0,3.0,3.0,6.0,6.0,3.0,6.0,5.0,4.0,4.0,5.0,4.0,5.0,5.0,4.0,4.0,4.0,5.0,5.0,4.0,3.0,5.0,3.0,5.0,5.0,4.0,5.0,4.0,12,,,,,,,,,,,,,,,,,,,,,,,,,,,,,,,,,10,,,,,,,,,,,,,,,,,,,,,,,,,,,,,,,,,3,,,,,,,,,,,,,,,,,,,,,,,,,,,,,,,,,0,4.0,6.0,4.0,2.0,5.0,1.0,5.0,1.0,7.0,1.0,5.0,3.0,1.0,1.0,5.0,1.0,6.0,4.0,2.0,1.0,1.0,1.0,2.0,4.0,5.0,4.0,1.0,2.0,2.0,3.0,4.0,1.0,"Thank you for providing a ""Back"" button, since this enabled me to verify that I had indeed responded correctly to each of the ""Attention Check"" questions.  As I recall, the correct responses were ""Disagree Strongly"", ""Disagree Strongly"" and ""Neutral"" respectively.",552.99,20.58,,,,8.09,,23.77,,,,,,,,,,,,,,,,,,,,,,,124.96,,,,,,,,,106.16,,,,,,,,,,,,127.19,,,142.24,,APPROVED,Male,71.0,FALSE
223,2022-03-21 03:09:48,19,en,1530295757,2022-03-21 03:03:45,2022-03-21 03:09:48,Y,Y,A1,,,1,1.0,1.0,1.0,2.0,1.0,1.0,7.0,1.0,7.0,1.0,1.0,1.0,1.0,1.0,6.0,1.0,1.0,1.0,1.0,1.0,1.0,1.0,1.0,1.0,1.0,1.0,5.0,1.0,1.0,1.0,1.0,1.0,0,5.0,4.0,4.0,5.0,4.0,5.0,3.0,7.0,2.0,4.0,3.0,5.0,4.0,4.0,4.0,3.0,4.0,4.0,5.0,2.0,4.0,5.0,4.0,4.0,4.0,4.0,3.0,5.0,3.0,5.0,4.0,2.0,8,,,,,,,,,,,,,,,,,,,,,,,,,,,,,,,,,9,,,,,,,,,,,,,,,,,,,,,,,,,,,,,,,,,6,,,,,,,,,,,,,,,,,,,,,,,,,,,,,,,,,10,,,,,,,,,,,,,,,,,,,,,,,,,,,,,,,,,5,,,,,,,,,,,,,,,,,,,,,,,,,,,,,,,,,4,,,,,,,,,,,,,,,,,,,,,,,,,,,,,,,,,13,,,,,,,,,,,,,,,,,,,,,,,,,,,,,,,,,7,,,,,,,,,,,,,,,,,,,,,,,,,,,,,,,,,11,,,,,,,,,,,,,,,,,,,,,,,,,,,,,,,,,12,,,,,,,,,,,,,,,,,,,,,,,,,,,,,,,,,2,1.0,1.0,1.0,1.0,1.0,1.0,7.0,1.0,2.0,1.0,1.0,1.0,1.0,1.0,1.0,1.0,1.0,1.0,1.0,1.0,1.0,1.0,1.0,1.0,1.0,1.0,5.0,1.0,1.0,1.0,1.0,6.0,14,,,,,,,,,,,,,,,,,,,,,,,,,,,,,,,,,3,,,,,,,,,,,,,,,,,,,,,,,,,,,,,,,,,,366.5,27.71,,,,13.12,,31.21,,78.88,,,139.76,,,,,,,,,,,,,,,,,,,,,,,,,,,,,,,,,70.03,,,,,,,,,5.79,,APPROVED,Female,29.0,FALSE
224,2022-03-21 03:09:20,19,en,1940062903,2022-03-21 03:04:08,2022-03-21 03:09:20,Y,Y,A1,,,8,,,,,,,,,,,,,,,,,,,,,,,,,,,,,,,,,1,4.0,5.0,5.0,6.0,6.0,5.0,4.0,3.0,4.0,4.0,5.0,6.0,4.0,5.0,5.0,4.0,5.0,6.0,5.0,5.0,4.0,5.0,4.0,4.0,4.0,5.0,4.0,6.0,5.0,5.0,6.0,2.0,4,,,,,,,,,,,,,,,,,,,,,,,,,,,,,,,,,2,4.0,4.0,4.0,5.0,6.0,6.0,3.0,4.0,3.0,5.0,4.0,3.0,3.0,4.0,5.0,4.0,3.0,5.0,4.0,4.0,3.0,4.0,5.0,5.0,5.0,4.0,3.0,4.0,2.0,4.0,5.0,4.0,6,,,,,,,,,,,,,,,,,,,,,,,,,,,,,,,,,13,,,,,,,,,,,,,,,,,,,,,,,,,,,,,,,,,11,,,,,,,,,,,,,,,,,,,,,,,,,,,,,,,,,0,4.0,3.0,4.0,4.0,4.0,4.0,4.0,4.0,4.0,3.0,4.0,4.0,3.0,4.0,3.0,4.0,3.0,5.0,4.0,3.0,4.0,5.0,3.0,3.0,4.0,5.0,3.0,4.0,4.0,4.0,3.0,1.0,5,,,,,,,,,,,,,,,,,,,,,,,,,,,,,,,,,9,,,,,,,,,,,,,,,,,,,,,,,,,,,,,,,,,14,,,,,,,,,,,,,,,,,,,,,,,,,,,,,,,,,10,,,,,,,,,,,,,,,,,,,,,,,,,,,,,,,,,7,,,,,,,,,,,,,,,,,,,,,,,,,,,,,,,,,3,,,,,,,,,,,,,,,,,,,,,,,,,,,,,,,,,12,,,,,,,,,,,,,,,,,,,,,,,,,,,,,,,,,,316.12,21.48,,,,6.85,,4.48,,,,,60.22,,,,,,100.55,,,,,,,,,,,,116.56,,,,,,,,,,,,,,,,,,,,,,,,5.98,,APPROVED,Male,28.0,FALSE
225,2022-03-21 03:07:13,19,en,1908949715,2022-03-21 03:04:32,2022-03-21 03:07:13,Y,Y,A1,,,8,,,,,,,,,,,,,,,,,,,,,,,,,,,,,,,,,3,,,,,,,,,,,,,,,,,,,,,,,,,,,,,,,,,9,,,,,,,,,,,,,,,,,,,,,,,,,,,,,,,,,11,,,,,,,,,,,,,,,,,,,,,,,,,,,,,,,,,12,,,,,,,,,,,,,,,,,,,,,,,,,,,,,,,,,5,,,,,,,,,,,,,,,,,,,,,,,,,,,,,,,,,14,,,,,,,,,,,,,,,,,,,,,,,,,,,,,,,,,13,,,,,,,,,,,,,,,,,,,,,,,,,,,,,,,,,7,,,,,,,,,,,,,,,,,,,,,,,,,,,,,,,,,2,5.0,5.0,6.0,3.0,5.0,6.0,5.0,5.0,5.0,4.0,6.0,4.0,5.0,3.0,4.0,4.0,6.0,4.0,4.0,4.0,3.0,2.0,3.0,6.0,3.0,4.0,4.0,4.0,6.0,3.0,4.0,3.0,0,5.0,5.0,5.0,4.0,5.0,5.0,4.0,6.0,4.0,6.0,5.0,3.0,4.0,5.0,4.0,4.0,4.0,4.0,5.0,4.0,4.0,4.0,4.0,5.0,5.0,5.0,4.0,5.0,6.0,3.0,4.0,4.0,4,,,,,,,,,,,,,,,,,,,,,,,,,,,,,,,,,10,,,,,,,,,,,,,,,,,,,,,,,,,,,,,,,,,1,3.0,3.0,4.0,5.0,3.0,4.0,5.0,5.0,4.0,3.0,4.0,5.0,3.0,4.0,4.0,3.0,5.0,4.0,4.0,3.0,5.0,4.0,5.0,3.0,4.0,5.0,5.0,3.0,5.0,3.0,4.0,7.0,6,,,,,,,,,,,,,,,,,,,,,,,,,,,,,,,,,,164.84,8.36,,,,4.88,,10.31,,,,,,,,,,,,,,,,,,,,,,,,,,,,,23.41,,,71.35,,,,,,,,,43.83,,,,,,2.7,,APPROVED,Male,21.0,FALSE
227,2022-03-21 03:12:26,19,en,662587437,2022-03-21 03:08:18,2022-03-21 03:12:26,Y,Y,A1,,,5,,,,,,,,,,,,,,,,,,,,,,,,,,,,,,,,,11,,,,,,,,,,,,,,,,,,,,,,,,,,,,,,,,,13,,,,,,,,,,,,,,,,,,,,,,,,,,,,,,,,,1,6.0,6.0,5.0,7.0,5.0,5.0,5.0,6.0,6.0,4.0,4.0,6.0,6.0,5.0,6.0,3.0,5.0,5.0,5.0,6.0,5.0,5.0,3.0,5.0,5.0,5.0,4.0,4.0,5.0,4.0,4.0,4.0,9,,,,,,,,,,,,,,,,,,,,,,,,,,,,,,,,,8,,,,,,,,,,,,,,,,,,,,,,,,,,,,,,,,,0,5.0,5.0,5.0,3.0,7.0,2.0,4.0,6.0,6.0,6.0,4.0,4.0,5.0,3.0,6.0,3.0,6.0,4.0,6.0,5.0,4.0,6.0,4.0,6.0,5.0,4.0,6.0,5.0,5.0,5.0,5.0,7.0,6,,,,,,,,,,,,,,,,,,,,,,,,,,,,,,,,,2,2.0,3.0,2.0,2.0,2.0,6.0,2.0,3.0,4.0,2.0,4.0,3.0,2.0,2.0,2.0,2.0,1.0,2.0,3.0,2.0,2.0,3.0,5.0,2.0,2.0,5.0,1.0,2.0,5.0,2.0,4.0,2.0,12,,,,,,,,,,,,,,,,,,,,,,,,,,,,,,,,,7,,,,,,,,,,,,,,,,,,,,,,,,,,,,,,,,,3,,,,,,,,,,,,,,,,,,,,,,,,,,,,,,,,,4,,,,,,,,,,,,,,,,,,,,,,,,,,,,,,,,,10,,,,,,,,,,,,,,,,,,,,,,,,,,,,,,,,,14,,,,,,,,,,,,,,,,,,,,,,,,,,,,,,,,,,249.51,30.05,,,,6.02,,19.91,,,,,,,,,,,51.01,,,,,,,,,86.22,,,,,,52.59,,,,,,,,,,,,,,,,,,,,,3.71,,APPROVED,Male,21.0,FALSE
228,2022-03-21 03:11:14,19,en,2064642935,2022-03-21 03:08:21,2022-03-21 03:11:14,Y,Y,A1,,,1,7.0,7.0,6.0,2.0,6.0,2.0,7.0,6.0,6.0,6.0,7.0,6.0,5.0,5.0,5.0,3.0,7.0,5.0,6.0,6.0,3.0,7.0,1.0,6.0,6.0,1.0,6.0,5.0,2.0,6.0,7.0,1.0,12,,,,,,,,,,,,,,,,,,,,,,,,,,,,,,,,,9,,,,,,,,,,,,,,,,,,,,,,,,,,,,,,,,,13,,,,,,,,,,,,,,,,,,,,,,,,,,,,,,,,,10,,,,,,,,,,,,,,,,,,,,,,,,,,,,,,,,,5,,,,,,,,,,,,,,,,,,,,,,,,,,,,,,,,,7,,,,,,,,,,,,,,,,,,,,,,,,,,,,,,,,,11,,,,,,,,,,,,,,,,,,,,,,,,,,,,,,,,,2,1.0,1.0,1.0,1.0,1.0,1.0,7.0,1.0,1.0,1.0,1.0,1.0,1.0,1.0,1.0,1.0,5.0,1.0,1.0,1.0,1.0,1.0,1.0,1.0,1.0,1.0,5.0,1.0,1.0,1.0,1.0,2.0,8,,,,,,,,,,,,,,,,,,,,,,,,,,,,,,,,,4,,,,,,,,,,,,,,,,,,,,,,,,,,,,,,,,,0,6.0,6.0,6.0,3.0,6.0,2.0,5.0,6.0,5.0,6.0,6.0,3.0,5.0,6.0,5.0,4.0,7.0,6.0,6.0,4.0,4.0,6.0,3.0,6.0,6.0,3.0,1.0,6.0,6.0,5.0,6.0,5.0,14,,,,,,,,,,,,,,,,,,,,,,,,,,,,,,,,,6,,,,,,,,,,,,,,,,,,,,,,,,,,,,,,,,,3,,,,,,,,,,,,,,,,,,,,,,,,,,,,,,,,,,176.39,10.15,,,,6.68,,10.46,,44.47,,,,,,,,,,,,,,,,,,,,,,,,40.58,,,,,,,,,57.37,,,,,,,,,,,,6.68,,APPROVED,Male,21.0,FALSE
229,2022-03-21 03:22:51,19,en,2069087078,2022-03-21 03:13:33,2022-03-21 03:22:51,Y,Y,A1,,,9,,,,,,,,,,,,,,,,,,,,,,,,,,,,,,,,,11,,,,,,,,,,,,,,,,,,,,,,,,,,,,,,,,,12,,,,,,,,,,,,,,,,,,,,,,,,,,,,,,,,,6,,,,,,,,,,,,,,,,,,,,,,,,,,,,,,,,,7,,,,,,,,,,,,,,,,,,,,,,,,,,,,,,,,,13,,,,,,,,,,,,,,,,,,,,,,,,,,,,,,,,,3,,,,,,,,,,,,,,,,,,,,,,,,,,,,,,,,,2,4.0,6.0,5.0,6.0,3.0,4.0,5.0,4.0,6.0,4.0,5.0,6.0,4.0,5.0,5.0,4.0,5.0,5.0,5.0,3.0,3.0,5.0,5.0,5.0,4.0,4.0,5.0,6.0,5.0,5.0,6.0,1.0,1,1.0,1.0,1.0,4.0,1.0,4.0,5.0,1.0,2.0,1.0,3.0,1.0,2.0,1.0,2.0,3.0,2.0,2.0,2.0,1.0,1.0,2.0,5.0,2.0,1.0,4.0,3.0,2.0,3.0,4.0,4.0,2.0,14,,,,,,,,,,,,,,,,,,,,,,,,,,,,,,,,,5,,,,,,,,,,,,,,,,,,,,,,,,,,,,,,,,,8,,,,,,,,,,,,,,,,,,,,,,,,,,,,,,,,,4,,,,,,,,,,,,,,,,,,,,,,,,,,,,,,,,,0,4.0,6.0,5.0,6.0,5.0,6.0,2.0,7.0,7.0,4.0,5.0,7.0,5.0,6.0,7.0,4.0,7.0,6.0,5.0,3.0,4.0,4.0,5.0,5.0,4.0,5.0,7.0,5.0,6.0,5.0,5.0,7.0,10,,,,,,,,,,,,,,,,,,,,,,,,,,,,,,,,,good luck with your research :),443.82,34.65,,,,7.1,,26.97,,,,,,,,,,,,,,,,,,,,,,,106.32,,,137.43,,,,,,,,,,,,,,,117.25,,,,,,14.1,,APPROVED,Female,35.0,FALSE
230,2022-03-21 03:20:15,19,en,1605512242,2022-03-21 03:15:03,2022-03-21 03:20:15,Y,Y,A1,,,6,,,,,,,,,,,,,,,,,,,,,,,,,,,,,,,,,13,,,,,,,,,,,,,,,,,,,,,,,,,,,,,,,,,1,3.0,4.0,4.0,6.0,4.0,4.0,5.0,6.0,3.0,6.0,6.0,2.0,6.0,5.0,5.0,5.0,6.0,6.0,6.0,4.0,6.0,5.0,6.0,5.0,3.0,5.0,6.0,4.0,5.0,3.0,5.0,3.0,2,5.0,5.0,5.0,5.0,6.0,4.0,5.0,5.0,4.0,6.0,6.0,6.0,6.0,6.0,4.0,4.0,6.0,4.0,5.0,4.0,6.0,2.0,4.0,3.0,4.0,5.0,6.0,6.0,5.0,3.0,6.0,4.0,5,,,,,,,,,,,,,,,,,,,,,,,,,,,,,,,,,10,,,,,,,,,,,,,,,,,,,,,,,,,,,,,,,,,4,,,,,,,,,,,,,,,,,,,,,,,,,,,,,,,,,14,,,,,,,,,,,,,,,,,,,,,,,,,,,,,,,,,11,,,,,,,,,,,,,,,,,,,,,,,,,,,,,,,,,8,,,,,,,,,,,,,,,,,,,,,,,,,,,,,,,,,12,,,,,,,,,,,,,,,,,,,,,,,,,,,,,,,,,7,,,,,,,,,,,,,,,,,,,,,,,,,,,,,,,,,3,,,,,,,,,,,,,,,,,,,,,,,,,,,,,,,,,0,6.0,6.0,6.0,6.0,6.0,7.0,5.0,5.0,6.0,5.0,7.0,6.0,7.0,2.0,7.0,6.0,6.0,7.0,6.0,6.0,5.0,6.0,6.0,5.0,6.0,6.0,3.0,6.0,5.0,6.0,7.0,7.0,9,,,,,,,,,,,,,,,,,,,,,,,,,,,,,,,,,,316.0,14.45,,,,8.94,,22.33,,,,,,,,92.74,,,50.21,,,,,,,,,,,,,,,,,,,,,,,,,,,,,,121.87,,,,,,5.46,,APPROVED,Male,22.0,FALSE
243,2022-03-21 15:40:11,19,en,1118091564,2022-03-21 15:23:20,2022-03-21 15:40:11,Y,Y,A1,,,9,,,,,,,,,,,,,,,,,,,,,,,,,,,,,,,,,3,,,,,,,,,,,,,,,,,,,,,,,,,,,,,,,,,13,,,,,,,,,,,,,,,,,,,,,,,,,,,,,,,,,4,,,,,,,,,,,,,,,,,,,,,,,,,,,,,,,,,10,,,,,,,,,,,,,,,,,,,,,,,,,,,,,,,,,8,,,,,,,,,,,,,,,,,,,,,,,,,,,,,,,,,12,,,,,,,,,,,,,,,,,,,,,,,,,,,,,,,,,2,4.0,4.0,1.0,1.0,1.0,1.0,7.0,6.0,4.0,1.0,1.0,4.0,1.0,1.0,2.0,5.0,5.0,1.0,2.0,1.0,1.0,1.0,1.0,1.0,2.0,1.0,4.0,1.0,1.0,2.0,1.0,1.0,5,,,,,,,,,,,,,,,,,,,,,,,,,,,,,,,,,7,,,,,,,,,,,,,,,,,,,,,,,,,,,,,,,,,1,5.0,7.0,5.0,2.0,4.0,2.0,6.0,7.0,7.0,4.0,1.0,5.0,6.0,5.0,7.0,5.0,6.0,5.0,5.0,4.0,4.0,5.0,4.0,4.0,5.0,3.0,6.0,4.0,4.0,5.0,3.0,4.0,14,,,,,,,,,,,,,,,,,,,,,,,,,,,,,,,,,6,,,,,,,,,,,,,,,,,,,,,,,,,,,,,,,,,0,1.0,3.0,1.0,4.0,1.0,5.0,3.0,2.0,3.0,1.0,1.0,2.0,1.0,1.0,5.0,3.0,6.0,1.0,1.0,1.0,2.0,1.0,5.0,1.0,1.0,5.0,5.0,1.0,2.0,1.0,2.0,7.0,11,,,,,,,,,,,,,,,,,,,,,,,,,,,,,,,,,,1015.8,81.66,,,,5.57,,128.87,,,,,,,,,,,,,,,,,,,,,,,188.7,,,,,,,,,427.79,,,,,,,,,176.83,,,,,,6.38,,APPROVED,Male,26.0,FALSE
244,2022-03-21 15:58:49,19,en,1251636461,2022-03-21 15:23:27,2022-03-21 15:58:49,Y,Y,A1,,,11,,,,,,,,,,,,,,,,,,,,,,,,,,,,,,,,,5,,,,,,,,,,,,,,,,,,,,,,,,,,,,,,,,,1,6.0,6.0,6.0,6.0,5.0,5.0,6.0,7.0,6.0,5.0,5.0,5.0,6.0,6.0,5.0,6.0,6.0,5.0,6.0,4.0,5.0,5.0,5.0,6.0,5.0,6.0,2.0,6.0,6.0,5.0,6.0,3.0,3,,,,,,,,,,,,,,,,,,,,,,,,,,,,,,,,,12,,,,,,,,,,,,,,,,,,,,,,,,,,,,,,,,,10,,,,,,,,,,,,,,,,,,,,,,,,,,,,,,,,,2,5.0,5.0,2.0,5.0,2.0,5.0,5.0,5.0,5.0,2.0,2.0,3.0,6.0,3.0,2.0,2.0,2.0,5.0,2.0,2.0,2.0,2.0,1.0,2.0,5.0,2.0,3.0,2.0,2.0,2.0,2.0,7.0,9,,,,,,,,,,,,,,,,,,,,,,,,,,,,,,,,,6,,,,,,,,,,,,,,,,,,,,,,,,,,,,,,,,,4,,,,,,,,,,,,,,,,,,,,,,,,,,,,,,,,,14,,,,,,,,,,,,,,,,,,,,,,,,,,,,,,,,,0,6.0,6.0,6.0,6.0,7.0,5.0,2.0,7.0,6.0,6.0,6.0,5.0,6.0,6.0,6.0,6.0,6.0,5.0,6.0,6.0,6.0,6.0,5.0,6.0,5.0,6.0,2.0,7.0,5.0,6.0,6.0,3.0,7,,,,,,,,,,,,,,,,,,,,,,,,,,,,,,,,,8,,,,,,,,,,,,,,,,,,,,,,,,,,,,,,,,,13,,,,,,,,,,,,,,,,,,,,,,,,,,,,,,,,,,2124.73,110.93,,,,15.44,,41.4,,,,,,,,64.34,,,,,,,,,,,,1808.57,,,,,,,,,,,,,,,80.78,,,,,,,,,,,,3.27,,TIMED-OUT,Female,21.0,FALSE
248,2022-03-21 15:32:38,19,en,2055835221,2022-03-21 15:23:31,2022-03-21 15:32:38,Y,Y,A1,,,9,,,,,,,,,,,,,,,,,,,,,,,,,,,,,,,,,3,,,,,,,,,,,,,,,,,,,,,,,,,,,,,,,,,14,,,,,,,,,,,,,,,,,,,,,,,,,,,,,,,,,1,5.0,5.0,5.0,5.0,5.0,3.0,4.0,5.0,5.0,5.0,5.0,4.0,5.0,4.0,4.0,4.0,5.0,5.0,5.0,5.0,4.0,5.0,4.0,5.0,5.0,5.0,4.0,5.0,5.0,5.0,4.0,4.0,0,2.0,3.0,2.0,2.0,3.0,2.0,2.0,2.0,2.0,2.0,2.0,2.0,2.0,2.0,3.0,2.0,2.0,2.0,2.0,2.0,2.0,2.0,2.0,2.0,2.0,2.0,2.0,2.0,2.0,2.0,3.0,5.0,8,,,,,,,,,,,,,,,,,,,,,,,,,,,,,,,,,13,,,,,,,,,,,,,,,,,,,,,,,,,,,,,,,,,7,,,,,,,,,,,,,,,,,,,,,,,,,,,,,,,,,4,,,,,,,,,,,,,,,,,,,,,,,,,,,,,,,,,2,2.0,2.0,2.0,2.0,2.0,2.0,2.0,2.0,2.0,2.0,2.0,2.0,2.0,2.0,2.0,2.0,2.0,2.0,2.0,2.0,2.0,2.0,2.0,2.0,2.0,2.0,2.0,2.0,2.0,2.0,2.0,3.0,10,,,,,,,,,,,,,,,,,,,,,,,,,,,,,,,,,5,,,,,,,,,,,,,,,,,,,,,,,,,,,,,,,,,12,,,,,,,,,,,,,,,,,,,,,,,,,,,,,,,,,6,,,,,,,,,,,,,,,,,,,,,,,,,,,,,,,,,11,,,,,,,,,,,,,,,,,,,,,,,,,,,,,,,,,,552.02,15.76,,,,5.58,,189.92,,,,,,,,,,,66.95,,,83.1,,,,,,,,,,,,,,,186.93,,,,,,,,,,,,,,,,,,3.78,,APPROVED,Male,21.0,FALSE
249,2022-03-21 15:29:32,19,en,1164008015,2022-03-21 15:23:32,2022-03-21 15:29:32,Y,Y,A2,,,1,4.0,7.0,5.0,6.0,5.0,6.0,5.0,6.0,7.0,5.0,6.0,5.0,6.0,5.0,7.0,6.0,6.0,6.0,5.0,6.0,5.0,6.0,5.0,6.0,5.0,6.0,3.0,7.0,4.0,6.0,6.0,1.0,11,,,,,,,,,,,,,,,,,,,,,,,,,,,,,,,,,9,,,,,,,,,,,,,,,,,,,,,,,,,,,,,,,,,2,6.0,5.0,6.0,7.0,6.0,7.0,4.0,7.0,5.0,7.0,6.0,7.0,7.0,7.0,7.0,6.0,6.0,7.0,6.0,5.0,6.0,6.0,6.0,6.0,5.0,7.0,4.0,6.0,7.0,6.0,6.0,4.0,3,,,,,,,,,,,,,,,,,,,,,,,,,,,,,,,,,8,,,,,,,,,,,,,,,,,,,,,,,,,,,,,,,,,14,,,,,,,,,,,,,,,,,,,,,,,,,,,,,,,,,10,,,,,,,,,,,,,,,,,,,,,,,,,,,,,,,,,6,,,,,,,,,,,,,,,,,,,,,,,,,,,,,,,,,4,,,,,,,,,,,,,,,,,,,,,,,,,,,,,,,,,12,,,,,,,,,,,,,,,,,,,,,,,,,,,,,,,,,13,,,,,,,,,,,,,,,,,,,,,,,,,,,,,,,,,7,,,,,,,,,,,,,,,,,,,,,,,,,,,,,,,,,0,5.0,5.0,5.0,5.0,4.0,6.0,4.0,7.0,7.0,4.0,3.0,6.0,5.0,5.0,5.0,6.0,5.0,5.0,5.0,4.0,5.0,5.0,6.0,4.0,5.0,6.0,5.0,6.0,4.0,5.0,5.0,7.0,5,,,,,,,,,,,,,,,,,,,,,,,,,,,,,,,,,,362.58,13.32,,,,6.48,,73.99,,92.62,,,,,,,,,81.18,,,,,,,,,,,,,,,,,,,,,,,,,,,,,,91.75,,,,,,3.24,,APPROVED,Female,31.0,FALSE
250,2022-03-21 15:45:53,19,en,948150290,2022-03-21 15:23:33,2022-03-21 15:45:53,Y,Y,A1,,,3,,,,,,,,,,,,,,,,,,,,,,,,,,,,,,,,,14,,,,,,,,,,,,,,,,,,,,,,,,,,,,,,,,,13,,,,,,,,,,,,,,,,,,,,,,,,,,,,,,,,,9,,,,,,,,,,,,,,,,,,,,,,,,,,,,,,,,,12,,,,,,,,,,,,,,,,,,,,,,,,,,,,,,,,,5,,,,,,,,,,,,,,,,,,,,,,,,,,,,,,,,,2,1.0,1.0,1.0,1.0,1.0,2.0,6.0,1.0,1.0,1.0,1.0,1.0,2.0,1.0,1.0,1.0,1.0,2.0,1.0,1.0,1.0,1.0,1.0,1.0,1.0,1.0,6.0,1.0,1.0,1.0,1.0,7.0,0,2.0,6.0,4.0,1.0,4.0,2.0,7.0,3.0,5.0,4.0,1.0,4.0,3.0,4.0,4.0,2.0,5.0,4.0,4.0,2.0,2.0,1.0,2.0,2.0,4.0,4.0,2.0,5.0,4.0,2.0,2.0,1.0,4,,,,,,,,,,,,,,,,,,,,,,,,,,,,,,,,,7,,,,,,,,,,,,,,,,,,,,,,,,,,,,,,,,,11,,,,,,,,,,,,,,,,,,,,,,,,,,,,,,,,,8,,,,,,,,,,,,,,,,,,,,,,,,,,,,,,,,,10,,,,,,,,,,,,,,,,,,,,,,,,,,,,,,,,,6,,,,,,,,,,,,,,,,,,,,,,,,,,,,,,,,,1,6.0,6.0,6.0,4.0,6.0,6.0,5.0,6.0,6.0,6.0,6.0,6.0,6.0,6.0,6.0,6.0,6.0,6.0,6.0,6.0,6.0,7.0,4.0,6.0,6.0,4.0,1.0,4.0,6.0,6.0,6.0,1.0,None,1347.63,46.31,,,,12.77,,62.38,,,,,,,,,,,,,,,,,,,,554.84,,,329.87,,,,,,,,,,,,,,,,,,,,,331.77,,,9.69,,APPROVED,Female,34.0,FALSE
251,2022-03-21 15:34:59,19,en,1284099643,2022-03-21 15:23:36,2022-03-21 15:34:59,Y,Y,A1,,,3,,,,,,,,,,,,,,,,,,,,,,,,,,,,,,,,,5,,,,,,,,,,,,,,,,,,,,,,,,,,,,,,,,,1,4.0,6.0,5.0,6.0,6.0,6.0,2.0,6.0,6.0,6.0,6.0,5.0,6.0,6.0,6.0,5.0,6.0,5.0,6.0,5.0,5.0,6.0,5.0,3.0,6.0,6.0,2.0,6.0,3.0,2.0,6.0,3.0,7,,,,,,,,,,,,,,,,,,,,,,,,,,,,,,,,,12,,,,,,,,,,,,,,,,,,,,,,,,,,,,,,,,,6,,,,,,,,,,,,,,,,,,,,,,,,,,,,,,,,,14,,,,,,,,,,,,,,,,,,,,,,,,,,,,,,,,,13,,,,,,,,,,,,,,,,,,,,,,,,,,,,,,,,,10,,,,,,,,,,,,,,,,,,,,,,,,,,,,,,,,,11,,,,,,,,,,,,,,,,,,,,,,,,,,,,,,,,,8,,,,,,,,,,,,,,,,,,,,,,,,,,,,,,,,,2,2.0,5.0,2.0,5.0,2.0,2.0,5.0,6.0,3.0,3.0,3.0,6.0,5.0,5.0,2.0,2.0,5.0,2.0,6.0,2.0,5.0,6.0,3.0,3.0,3.0,5.0,3.0,6.0,6.0,2.0,2.0,5.0,9,,,,,,,,,,,,,,,,,,,,,,,,,,,,,,,,,4,,,,,,,,,,,,,,,,,,,,,,,,,,,,,,,,,1,5.0,6.0,3.0,6.0,2.0,6.0,3.0,5.0,5.0,2.0,6.0,2.0,6.0,2.0,3.0,5.0,5.0,2.0,5.0,2.0,2.0,5.0,6.0,5.0,4.0,6.0,2.0,5.0,3.0,2.0,5.0,1.0,,688.37,81.9,,,,22.59,,60.29,,,,,,,,99.75,,,,,,,,,,,,,,,,,,,,,,,,,,,103.91,,,,,,,,,317.16,,,2.77,,APPROVED,Male,19.0,FALSE
252,2022-03-21 15:33:51,19,en,66873404,2022-03-21 15:23:39,2022-03-21 15:33:51,Y,Y,-oth-,college,,5,,,,,,,,,,,,,,,,,,,,,,,,,,,,,,,,,1,6.0,7.0,7.0,6.0,6.0,6.0,1.0,7.0,7.0,5.0,6.0,6.0,4.0,6.0,7.0,6.0,7.0,7.0,4.0,4.0,6.0,3.0,6.0,4.0,3.0,7.0,6.0,7.0,7.0,6.0,7.0,2.0,6,,,,,,,,,,,,,,,,,,,,,,,,,,,,,,,,,4,,,,,,,,,,,,,,,,,,,,,,,,,,,,,,,,,10,,,,,,,,,,,,,,,,,,,,,,,,,,,,,,,,,12,,,,,,,,,,,,,,,,,,,,,,,,,,,,,,,,,3,,,,,,,,,,,,,,,,,,,,,,,,,,,,,,,,,7,,,,,,,,,,,,,,,,,,,,,,,,,,,,,,,,,13,,,,,,,,,,,,,,,,,,,,,,,,,,,,,,,,,9,,,,,,,,,,,,,,,,,,,,,,,,,,,,,,,,,0,7.0,7.0,6.0,6.0,5.0,3.0,1.0,7.0,7.0,4.0,6.0,3.0,6.0,7.0,6.0,6.0,6.0,5.0,4.0,3.0,7.0,4.0,4.0,6.0,3.0,6.0,5.0,6.0,6.0,4.0,5.0,4.0,2,7.0,7.0,7.0,6.0,4.0,7.0,1.0,7.0,7.0,5.0,7.0,6.0,6.0,6.0,6.0,6.0,7.0,6.0,4.0,4.0,6.0,4.0,6.0,6.0,3.0,7.0,7.0,5.0,5.0,6.0,7.0,5.0,11,,,,,,,,,,,,,,,,,,,,,,,,,,,,,,,,,14,,,,,,,,,,,,,,,,,,,,,,,,,,,,,,,,,8,,,,,,,,,,,,,,,,,,,,,,,,,,,,,,,,,Loved it - thank-you - very stylish,616.63,34.59,,,,16.41,,23.46,,,,,180.07,,,,,,,,,,,,,,,,,,,,,,,,,,,179.06,,,146.7,,,,,,,,,,,,36.34,,APPROVED,Female,65.0,FALSE
253,2022-03-21 15:27:57,19,en,2112303134,2022-03-21 15:23:41,2022-03-21 15:27:57,Y,Y,A3,,,9,,,,,,,,,,,,,,,,,,,,,,,,,,,,,,,,,13,,,,,,,,,,,,,,,,,,,,,,,,,,,,,,,,,7,,,,,,,,,,,,,,,,,,,,,,,,,,,,,,,,,11,,,,,,,,,,,,,,,,,,,,,,,,,,,,,,,,,5,,,,,,,,,,,,,,,,,,,,,,,,,,,,,,,,,14,,,,,,,,,,,,,,,,,,,,,,,,,,,,,,,,,1,5.0,6.0,5.0,4.0,4.0,3.0,4.0,5.0,5.0,4.0,5.0,4.0,5.0,5.0,5.0,4.0,5.0,5.0,5.0,4.0,5.0,5.0,4.0,5.0,5.0,4.0,5.0,4.0,4.0,5.0,5.0,7.0,8,,,,,,,,,,,,,,,,,,,,,,,,,,,,,,,,,0,2.0,2.0,2.0,4.0,1.0,1.0,6.0,1.0,4.0,1.0,1.0,1.0,1.0,2.0,2.0,2.0,4.0,1.0,2.0,1.0,2.0,2.0,4.0,2.0,1.0,4.0,2.0,2.0,2.0,2.0,2.0,2.0,6,,,,,,,,,,,,,,,,,,,,,,,,,,,,,,,,,2,6.0,5.0,5.0,4.0,4.0,4.0,4.0,5.0,5.0,4.0,5.0,6.0,6.0,5.0,5.0,5.0,6.0,6.0,5.0,4.0,4.0,5.0,4.0,5.0,5.0,4.0,5.0,4.0,5.0,6.0,5.0,4.0,4,,,,,,,,,,,,,,,,,,,,,,,,,,,,,,,,,12,,,,,,,,,,,,,,,,,,,,,,,,,,,,,,,,,10,,,,,,,,,,,,,,,,,,,,,,,,,,,,,,,,,3,,,,,,,,,,,,,,,,,,,,,,,,,,,,,,,,,,256.95,23.07,,,,4.06,,22.98,,,,,,,,,,,,,,,,,,,,66.16,,,,,,70.79,,,,,,67.24,,,,,,,,,,,,,,,2.65,,APPROVED,Female,42.0,FALSE
254,2022-03-21 15:30:00,19,en,608148903,2022-03-21 15:23:43,2022-03-21 15:30:00,Y,Y,A1,,,3,,,,,,,,,,,,,,,,,,,,,,,,,,,,,,,,,0,6.0,4.0,5.0,6.0,5.0,5.0,3.0,4.0,5.0,4.0,5.0,5.0,6.0,5.0,5.0,6.0,5.0,5.0,5.0,3.0,4.0,5.0,4.0,5.0,5.0,6.0,1.0,5.0,4.0,5.0,5.0,2.0,12,,,,,,,,,,,,,,,,,,,,,,,,,,,,,,,,,9,,,,,,,,,,,,,,,,,,,,,,,,,,,,,,,,,14,,,,,,,,,,,,,,,,,,,,,,,,,,,,,,,,,2,5.0,6.0,5.0,5.0,5.0,3.0,4.0,6.0,5.0,4.0,4.0,5.0,4.0,5.0,5.0,5.0,4.0,6.0,5.0,5.0,4.0,5.0,5.0,6.0,5.0,4.0,2.0,5.0,5.0,5.0,5.0,6.0,10,,,,,,,,,,,,,,,,,,,,,,,,,,,,,,,,,1,2.0,4.0,3.0,4.0,1.0,2.0,5.0,3.0,4.0,3.0,2.0,4.0,4.0,4.0,5.0,3.0,5.0,3.0,3.0,4.0,3.0,3.0,2.0,2.0,2.0,4.0,1.0,3.0,4.0,2.0,3.0,1.0,13,,,,,,,,,,,,,,,,,,,,,,,,,,,,,,,,,11,,,,,,,,,,,,,,,,,,,,,,,,,,,,,,,,,6,,,,,,,,,,,,,,,,,,,,,,,,,,,,,,,,,5,,,,,,,,,,,,,,,,,,,,,,,,,,,,,,,,,4,,,,,,,,,,,,,,,,,,,,,,,,,,,,,,,,,8,,,,,,,,,,,,,,,,,,,,,,,,,,,,,,,,,7,,,,,,,,,,,,,,,,,,,,,,,,,,,,,,,,,,380.07,11.79,,,,6.28,,44.29,,,,,67.32,,,,,,,,,,,,174.27,,,,,,72.37,,,,,,,,,,,,,,,,,,,,,,,,3.75,,APPROVED,Male,25.0,FALSE
255,2022-03-21 15:27:33,19,en,996075511,2022-03-21 15:23:52,2022-03-21 15:27:33,Y,Y,A1,,,0,5.0,5.0,4.0,5.0,2.0,2.0,3.0,4.0,4.0,4.0,6.0,5.0,4.0,6.0,4.0,5.0,4.0,5.0,2.0,5.0,4.0,4.0,5.0,4.0,6.0,3.0,2.0,2.0,3.0,5.0,5.0,1.0,8,,,,,,,,,,,,,,,,,,,,,,,,,,,,,,,,,7,,,,,,,,,,,,,,,,,,,,,,,,,,,,,,,,,4,,,,,,,,,,,,,,,,,,,,,,,,,,,,,,,,,6,,,,,,,,,,,,,,,,,,,,,,,,,,,,,,,,,11,,,,,,,,,,,,,,,,,,,,,,,,,,,,,,,,,3,,,,,,,,,,,,,,,,,,,,,,,,,,,,,,,,,9,,,,,,,,,,,,,,,,,,,,,,,,,,,,,,,,,14,,,,,,,,,,,,,,,,,,,,,,,,,,,,,,,,,10,,,,,,,,,,,,,,,,,,,,,,,,,,,,,,,,,12,,,,,,,,,,,,,,,,,,,,,,,,,,,,,,,,,2,6.0,5.0,3.0,5.0,5.0,6.0,5.0,6.0,6.0,4.0,5.0,4.0,5.0,4.0,5.0,5.0,6.0,5.0,5.0,5.0,6.0,6.0,5.0,5.0,4.0,5.0,5.0,5.0,6.0,6.0,5.0,5.0,1,5.0,5.0,4.0,4.0,4.0,5.0,5.0,5.0,5.0,4.0,4.0,2.0,5.0,5.0,5.0,5.0,5.0,5.0,4.0,5.0,4.0,4.0,5.0,5.0,4.0,5.0,4.0,4.0,3.0,5.0,4.0,6.0,5,,,,,,,,,,,,,,,,,,,,,,,,,,,,,,,,,13,,,,,,,,,,,,,,,,,,,,,,,,,,,,,,,,,,223.03,38.87,,,,9.16,,52.18,,36.76,,,,,,,,,,,,,,,,,,,,,,,,,,,,,,,,,35.6,,,32.95,,,,,,,,,17.51,,APPROVED,Male,23.0,FALSE
256,2022-03-21 15:38:32,19,en,249483890,2022-03-21 15:23:52,2022-03-21 15:38:32,Y,Y,A1,,,9,,,,,,,,,,,,,,,,,,,,,,,,,,,,,,,,,2,5.0,1.0,5.0,6.0,4.0,6.0,2.0,6.0,4.0,4.0,4.0,5.0,4.0,2.0,2.0,7.0,4.0,5.0,4.0,4.0,4.0,4.0,6.0,5.0,5.0,6.0,2.0,4.0,4.0,6.0,5.0,2.0,13,,,,,,,,,,,,,,,,,,,,,,,,,,,,,,,,,7,,,,,,,,,,,,,,,,,,,,,,,,,,,,,,,,,0,2.0,3.0,2.0,4.0,1.0,2.0,5.0,3.0,5.0,1.0,4.0,1.0,1.0,1.0,1.0,4.0,3.0,2.0,2.0,1.0,2.0,2.0,5.0,2.0,2.0,6.0,2.0,2.0,5.0,4.0,4.0,5.0,8,,,,,,,,,,,,,,,,,,,,,,,,,,,,,,,,,14,,,,,,,,,,,,,,,,,,,,,,,,,,,,,,,,,10,,,,,,,,,,,,,,,,,,,,,,,,,,,,,,,,,12,,,,,,,,,,,,,,,,,,,,,,,,,,,,,,,,,1,1.0,4.0,2.0,3.0,1.0,2.0,6.0,2.0,4.0,1.0,2.0,2.0,1.0,2.0,3.0,3.0,1.0,1.0,1.0,2.0,2.0,2.0,2.0,1.0,1.0,5.0,5.0,1.0,5.0,2.0,4.0,3.0,4,,,,,,,,,,,,,,,,,,,,,,,,,,,,,,,,,5,,,,,,,,,,,,,,,,,,,,,,,,,,,,,,,,,6,,,,,,,,,,,,,,,,,,,,,,,,,,,,,,,,,11,,,,,,,,,,,,,,,,,,,,,,,,,,,,,,,,,3,,,,,,,,,,,,,,,,,,,,,,,,,,,,,,,,,,882.72,106.55,,,,11.98,,81.98,,,,,326.63,,,,,,,,,222.21,,,,,,,,,,,,,,,126.23,,,,,,,,,,,,,,,,,,7.14,,APPROVED,Female,47.0,FALSE
257,2022-03-21 15:31:24,19,en,888573669,2022-03-21 15:23:56,2022-03-21 15:31:24,Y,Y,A1,,,9,,,,,,,,,,,,,,,,,,,,,,,,,,,,,,,,,4,,,,,,,,,,,,,,,,,,,,,,,,,,,,,,,,,13,,,,,,,,,,,,,,,,,,,,,,,,,,,,,,,,,0,6.0,7.0,7.0,7.0,7.0,7.0,2.0,7.0,6.0,6.0,7.0,7.0,5.0,6.0,6.0,7.0,7.0,6.0,6.0,6.0,6.0,5.0,7.0,5.0,6.0,7.0,6.0,6.0,6.0,6.0,7.0,4.0,1,2.0,5.0,2.0,2.0,2.0,1.0,6.0,5.0,5.0,2.0,1.0,4.0,2.0,2.0,4.0,1.0,2.0,2.0,2.0,2.0,3.0,2.0,2.0,2.0,1.0,4.0,5.0,1.0,1.0,3.0,3.0,5.0,6,,,,,,,,,,,,,,,,,,,,,,,,,,,,,,,,,7,,,,,,,,,,,,,,,,,,,,,,,,,,,,,,,,,12,,,,,,,,,,,,,,,,,,,,,,,,,,,,,,,,,11,,,,,,,,,,,,,,,,,,,,,,,,,,,,,,,,,2,3.0,5.0,6.0,2.0,2.0,2.0,5.0,1.0,5.0,2.0,1.0,4.0,2.0,2.0,3.0,2.0,5.0,5.0,2.0,2.0,2.0,2.0,1.0,2.0,4.0,4.0,4.0,2.0,1.0,2.0,4.0,3.0,5,,,,,,,,,,,,,,,,,,,,,,,,,,,,,,,,,10,,,,,,,,,,,,,,,,,,,,,,,,,,,,,,,,,14,,,,,,,,,,,,,,,,,,,,,,,,,,,,,,,,,3,,,,,,,,,,,,,,,,,,,,,,,,,,,,,,,,,8,,,,,,,,,,,,,,,,,,,,,,,,,,,,,,,,,,448.95,71.81,,,,11.19,,36.22,,,,,,,,,,,110.33,,,111.21,,,,,,,,,,,,,,,103.18,,,,,,,,,,,,,,,,,,5.01,,APPROVED,Female,39.0,FALSE
258,2022-03-21 15:29:04,19,en,911142033,2022-03-21 15:23:57,2022-03-21 15:29:04,Y,Y,A1,,,9,,,,,,,,,,,,,,,,,,,,,,,,,,,,,,,,,11,,,,,,,,,,,,,,,,,,,,,,,,,,,,,,,,,10,,,,,,,,,,,,,,,,,,,,,,,,,,,,,,,,,6,,,,,,,,,,,,,,,,,,,,,,,,,,,,,,,,,1,6.0,5.0,5.0,5.0,5.0,5.0,7.0,4.0,5.0,4.0,5.0,5.0,5.0,6.0,6.0,5.0,6.0,4.0,5.0,5.0,5.0,6.0,6.0,6.0,5.0,6.0,5.0,5.0,5.0,5.0,5.0,6.0,4,,,,,,,,,,,,,,,,,,,,,,,,,,,,,,,,,14,,,,,,,,,,,,,,,,,,,,,,,,,,,,,,,,,8,,,,,,,,,,,,,,,,,,,,,,,,,,,,,,,,,0,1.0,1.0,2.0,1.0,1.0,4.0,7.0,1.0,1.0,2.0,1.0,1.0,1.0,2.0,1.0,1.0,1.0,3.0,2.0,1.0,1.0,3.0,1.0,1.0,1.0,1.0,1.0,1.0,1.0,1.0,1.0,2.0,2,1.0,2.0,1.0,1.0,1.0,1.0,7.0,1.0,1.0,2.0,2.0,1.0,2.0,1.0,1.0,1.0,4.0,3.0,2.0,2.0,2.0,2.0,4.0,1.0,2.0,2.0,1.0,3.0,1.0,1.0,1.0,3.0,12,,,,,,,,,,,,,,,,,,,,,,,,,,,,,,,,,5,,,,,,,,,,,,,,,,,,,,,,,,,,,,,,,,,3,,,,,,,,,,,,,,,,,,,,,,,,,,,,,,,,,7,,,,,,,,,,,,,,,,,,,,,,,,,,,,,,,,,13,,,,,,,,,,,,,,,,,,,,,,,,,,,,,,,,,,310.28,12.94,,,,6.66,,5.07,,,,,,,,,,,,,,87.75,,,,,,,,,,,,76.69,,,118.13,,,,,,,,,,,,,,,,,,3.04,,APPROVED,Female,24.0,FALSE
259,2022-03-21 15:28:42,19,en,1331258750,2022-03-21 15:24:09,2022-03-21 15:28:42,Y,Y,A1,,,13,,,,,,,,,,,,,,,,,,,,,,,,,,,,,,,,,7,,,,,,,,,,,,,,,,,,,,,,,,,,,,,,,,,2,4.0,5.0,3.0,2.0,2.0,4.0,6.0,4.0,5.0,3.0,2.0,3.0,4.0,4.0,3.0,2.0,5.0,3.0,3.0,3.0,3.0,2.0,6.0,2.0,2.0,4.0,3.0,2.0,5.0,3.0,4.0,3.0,5,,,,,,,,,,,,,,,,,,,,,,,,,,,,,,,,,4,,,,,,,,,,,,,,,,,,,,,,,,,,,,,,,,,6,,,,,,,,,,,,,,,,,,,,,,,,,,,,,,,,,14,,,,,,,,,,,,,,,,,,,,,,,,,,,,,,,,,3,,,,,,,,,,,,,,,,,,,,,,,,,,,,,,,,,9,,,,,,,,,,,,,,,,,,,,,,,,,,,,,,,,,0,3.0,4.0,1.0,1.0,1.0,1.0,7.0,1.0,3.0,2.0,1.0,1.0,2.0,2.0,4.0,1.0,5.0,1.0,2.0,1.0,1.0,1.0,1.0,2.0,2.0,1.0,1.0,2.0,7.0,1.0,3.0,1.0,8,,,,,,,,,,,,,,,,,,,,,,,,,,,,,,,,,1,1.0,4.0,1.0,2.0,2.0,2.0,3.0,2.0,4.0,2.0,1.0,4.0,1.0,2.0,3.0,2.0,3.0,3.0,2.0,2.0,2.0,2.0,3.0,2.0,1.0,2.0,3.0,2.0,4.0,2.0,3.0,5.0,10,,,,,,,,,,,,,,,,,,,,,,,,,,,,,,,,,12,,,,,,,,,,,,,,,,,,,,,,,,,,,,,,,,,11,,,,,,,,,,,,,,,,,,,,,,,,,,,,,,,,,,277.01,13.75,,,,4.85,,27.73,,,,,,,,77.74,,,,,,,,,,,,,,,,,,,,,75.91,,,,,,71.71,,,,,,,,,,,,5.32,,APPROVED,Male,26.0,FALSE
261,2022-03-21 15:27:54,19,en,374438836,2022-03-21 15:24:10,2022-03-21 15:27:54,Y,Y,A1,,,7,,,,,,,,,,,,,,,,,,,,,,,,,,,,,,,,,13,,,,,,,,,,,,,,,,,,,,,,,,,,,,,,,,,3,,,,,,,,,,,,,,,,,,,,,,,,,,,,,,,,,5,,,,,,,,,,,,,,,,,,,,,,,,,,,,,,,,,9,,,,,,,,,,,,,,,,,,,,,,,,,,,,,,,,,8,,,,,,,,,,,,,,,,,,,,,,,,,,,,,,,,,14,,,,,,,,,,,,,,,,,,,,,,,,,,,,,,,,,11,,,,,,,,,,,,,,,,,,,,,,,,,,,,,,,,,0,7.0,6.0,6.0,3.0,6.0,2.0,4.0,2.0,7.0,7.0,7.0,7.0,5.0,6.0,7.0,4.0,7.0,6.0,6.0,4.0,6.0,6.0,2.0,4.0,6.0,4.0,3.0,6.0,5.0,7.0,3.0,2.0,12,,,,,,,,,,,,,,,,,,,,,,,,,,,,,,,,,2,5.0,7.0,5.0,3.0,4.0,4.0,5.0,6.0,4.0,5.0,5.0,7.0,6.0,5.0,6.0,3.0,7.0,4.0,6.0,5.0,2.0,6.0,2.0,6.0,6.0,3.0,3.0,6.0,3.0,6.0,6.0,4.0,4,,,,,,,,,,,,,,,,,,,,,,,,,,,,,,,,,6,,,,,,,,,,,,,,,,,,,,,,,,,,,,,,,,,10,,,,,,,,,,,,,,,,,,,,,,,,,,,,,,,,,1,7.0,7.0,7.0,7.0,7.0,7.0,6.0,6.0,7.0,7.0,7.0,7.0,7.0,7.0,7.0,7.0,7.0,7.0,7.0,7.0,7.0,7.0,4.0,7.0,7.0,7.0,2.0,7.0,7.0,7.0,7.0,1.0,,226.88,22.56,,,,10.08,,28.51,,,,,,,,,,,,,,,,,,,,,,,,,,61.18,,,,,,62.97,,,,,,,,,,,,36.49,,,5.09,,APPROVED,Female,18.0,FALSE
262,2022-03-21 15:32:48,19,en,1090222972,2022-03-21 15:24:13,2022-03-21 15:32:48,Y,Y,-oth-,diploma,,14,,,,,,,,,,,,,,,,,,,,,,,,,,,,,,,,,2,6.0,6.0,6.0,7.0,7.0,5.0,1.0,5.0,6.0,3.0,5.0,5.0,5.0,3.0,3.0,5.0,6.0,5.0,7.0,5.0,2.0,6.0,6.0,5.0,5.0,7.0,2.0,5.0,5.0,2.0,6.0,2.0,12,,,,,,,,,,,,,,,,,,,,,,,,,,,,,,,,,13,,,,,,,,,,,,,,,,,,,,,,,,,,,,,,,,,1,3.0,5.0,5.0,5.0,3.0,3.0,5.0,3.0,5.0,2.0,2.0,5.0,3.0,3.0,3.0,3.0,5.0,5.0,5.0,2.0,3.0,5.0,5.0,3.0,3.0,5.0,3.0,3.0,5.0,3.0,5.0,5.0,11,,,,,,,,,,,,,,,,,,,,,,,,,,,,,,,,,7,,,,,,,,,,,,,,,,,,,,,,,,,,,,,,,,,0,3.0,1.0,2.0,1.0,1.0,2.0,6.0,1.0,1.0,2.0,1.0,2.0,1.0,1.0,2.0,3.0,3.0,1.0,1.0,2.0,1.0,1.0,3.0,1.0,1.0,2.0,1.0,1.0,1.0,1.0,1.0,1.0,4,,,,,,,,,,,,,,,,,,,,,,,,,,,,,,,,,3,,,,,,,,,,,,,,,,,,,,,,,,,,,,,,,,,6,,,,,,,,,,,,,,,,,,,,,,,,,,,,,,,,,8,,,,,,,,,,,,,,,,,,,,,,,,,,,,,,,,,5,,,,,,,,,,,,,,,,,,,,,,,,,,,,,,,,,10,,,,,,,,,,,,,,,,,,,,,,,,,,,,,,,,,9,,,,,,,,,,,,,,,,,,,,,,,,,,,,,,,,,,517.03,57.05,,,,27.36,,51.1,,,,,132.54,,,,,,,,,125.28,,,,,,,,,115.63,,,,,,,,,,,,,,,,,,,,,,,,8.07,,APPROVED,Female,44.0,FALSE
263,2022-03-21 15:32:02,19,en,193043602,2022-03-21 15:24:21,2022-03-21 15:32:02,Y,Y,A1,,,9,,,,,,,,,,,,,,,,,,,,,,,,,,,,,,,,,7,,,,,,,,,,,,,,,,,,,,,,,,,,,,,,,,,2,2.0,2.0,5.0,4.0,6.0,4.0,4.0,5.0,6.0,6.0,4.0,6.0,3.0,5.0,3.0,3.0,6.0,2.0,4.0,4.0,3.0,2.0,4.0,5.0,3.0,5.0,5.0,4.0,6.0,4.0,3.0,1.0,3,,,,,,,,,,,,,,,,,,,,,,,,,,,,,,,,,13,,,,,,,,,,,,,,,,,,,,,,,,,,,,,,,,,1,5.0,2.0,4.0,3.0,5.0,3.0,3.0,4.0,3.0,2.0,3.0,3.0,5.0,2.0,5.0,5.0,5.0,4.0,3.0,2.0,4.0,4.0,4.0,3.0,5.0,3.0,4.0,2.0,2.0,4.0,4.0,6.0,8,,,,,,,,,,,,,,,,,,,,,,,,,,,,,,,,,11,,,,,,,,,,,,,,,,,,,,,,,,,,,,,,,,,4,,,,,,,,,,,,,,,,,,,,,,,,,,,,,,,,,6,,,,,,,,,,,,,,,,,,,,,,,,,,,,,,,,,10,,,,,,,,,,,,,,,,,,,,,,,,,,,,,,,,,0,5.0,5.0,5.0,4.0,2.0,5.0,3.0,3.0,4.0,3.0,2.0,3.0,5.0,3.0,2.0,3.0,4.0,2.0,4.0,2.0,5.0,4.0,3.0,4.0,1.0,2.0,5.0,3.0,3.0,4.0,2.0,5.0,12,,,,,,,,,,,,,,,,,,,,,,,,,,,,,,,,,14,,,,,,,,,,,,,,,,,,,,,,,,,,,,,,,,,5,,,,,,,,,,,,,,,,,,,,,,,,,,,,,,,,,,463.7,13.54,,,,10.95,,5.26,,,,,,,,43.16,,,,,,,,,336.55,,,,,,,,,,,,,,,,,,51.82,,,,,,,,,,,,2.42,,APPROVED,Male,21.0,FALSE
264,2022-03-21 15:38:25,19,en,973878688,2022-03-21 15:24:30,2022-03-21 15:38:25,Y,Y,A1,,,11,,,,,,,,,,,,,,,,,,,,,,,,,,,,,,,,,13,,,,,,,,,,,,,,,,,,,,,,,,,,,,,,,,,7,,,,,,,,,,,,,,,,,,,,,,,,,,,,,,,,,0,3.0,7.0,7.0,4.0,5.0,5.0,4.0,3.0,7.0,2.0,5.0,3.0,6.0,4.0,6.0,5.0,7.0,2.0,4.0,3.0,2.0,3.0,4.0,1.0,6.0,2.0,7.0,4.0,3.0,4.0,2.0,4.0,4,,,,,,,,,,,,,,,,,,,,,,,,,,,,,,,,,2,4.0,5.0,5.0,6.0,3.0,1.0,7.0,7.0,6.0,4.0,4.0,3.0,2.0,2.0,4.0,5.0,5.0,3.0,3.0,4.0,3.0,5.0,3.0,5.0,6.0,2.0,5.0,1.0,3.0,4.0,5.0,6.0,1,2.0,6.0,3.0,3.0,5.0,1.0,6.0,6.0,5.0,3.0,2.0,6.0,2.0,2.0,5.0,1.0,6.0,3.0,3.0,3.0,1.0,3.0,1.0,2.0,4.0,2.0,2.0,1.0,3.0,4.0,3.0,7.0,6,,,,,,,,,,,,,,,,,,,,,,,,,,,,,,,,,5,,,,,,,,,,,,,,,,,,,,,,,,,,,,,,,,,3,,,,,,,,,,,,,,,,,,,,,,,,,,,,,,,,,9,,,,,,,,,,,,,,,,,,,,,,,,,,,,,,,,,14,,,,,,,,,,,,,,,,,,,,,,,,,,,,,,,,,12,,,,,,,,,,,,,,,,,,,,,,,,,,,,,,,,,10,,,,,,,,,,,,,,,,,,,,,,,,,,,,,,,,,8,,,,,,,,,,,,,,,,,,,,,,,,,,,,,,,,,,838.62,116.34,,,,9.84,,80.67,,,,,,,,,,,203.81,,,,,,181.16,,,239.3,,,,,,,,,,,,,,,,,,,,,,,,,,,7.5,,APPROVED,Female,28.0,FALSE
265,2022-03-21 15:33:09,19,en,500237524,2022-03-21 15:24:34,2022-03-21 15:33:09,Y,Y,A1,,,5,,,,,,,,,,,,,,,,,,,,,,,,,,,,,,,,,12,,,,,,,,,,,,,,,,,,,,,,,,,,,,,,,,,14,,,,,,,,,,,,,,,,,,,,,,,,,,,,,,,,,13,,,,,,,,,,,,,,,,,,,,,,,,,,,,,,,,,3,,,,,,,,,,,,,,,,,,,,,,,,,,,,,,,,,10,,,,,,,,,,,,,,,,,,,,,,,,,,,,,,,,,0,5.0,5.0,5.0,6.0,5.0,6.0,4.0,2.0,6.0,5.0,2.0,6.0,5.0,5.0,6.0,3.0,6.0,5.0,5.0,3.0,6.0,5.0,2.0,5.0,4.0,5.0,3.0,5.0,6.0,2.0,6.0,7.0,1,6.0,5.0,7.0,3.0,5.0,6.0,5.0,2.0,5.0,6.0,3.0,6.0,6.0,7.0,6.0,5.0,6.0,7.0,6.0,5.0,6.0,5.0,7.0,7.0,5.0,6.0,5.0,6.0,6.0,3.0,5.0,1.0,4,,,,,,,,,,,,,,,,,,,,,,,,,,,,,,,,,2,3.0,6.0,3.0,2.0,2.0,3.0,2.0,2.0,5.0,1.0,2.0,2.0,2.0,2.0,3.0,2.0,5.0,2.0,1.0,2.0,2.0,2.0,3.0,2.0,2.0,5.0,5.0,2.0,5.0,1.0,3.0,3.0,8,,,,,,,,,,,,,,,,,,,,,,,,,,,,,,,,,9,,,,,,,,,,,,,,,,,,,,,,,,,,,,,,,,,11,,,,,,,,,,,,,,,,,,,,,,,,,,,,,,,,,7,,,,,,,,,,,,,,,,,,,,,,,,,,,,,,,,,6,,,,,,,,,,,,,,,,,,,,,,,,,,,,,,,,,,518.81,190.81,,,,11.27,,78.06,,,,,,,,,,,,,,,,,,,,83.77,,,74.66,,,,,,77.34,,,,,,,,,,,,,,,,,,2.9,,APPROVED,Male,21.0,FALSE
266,2022-03-21 15:35:14,19,en,1583118457,2022-03-21 15:24:36,2022-03-21 15:35:14,Y,Y,A2,,,10,,,,,,,,,,,,,,,,,,,,,,,,,,,,,,,,,3,,,,,,,,,,,,,,,,,,,,,,,,,,,,,,,,,7,,,,,,,,,,,,,,,,,,,,,,,,,,,,,,,,,11,,,,,,,,,,,,,,,,,,,,,,,,,,,,,,,,,5,,,,,,,,,,,,,,,,,,,,,,,,,,,,,,,,,13,,,,,,,,,,,,,,,,,,,,,,,,,,,,,,,,,1,4.0,4.0,4.0,4.0,5.0,5.0,5.0,3.0,5.0,4.0,5.0,3.0,4.0,4.0,4.0,5.0,5.0,3.0,4.0,4.0,3.0,4.0,4.0,3.0,3.0,4.0,3.0,4.0,4.0,3.0,4.0,7.0,12,,,,,,,,,,,,,,,,,,,,,,,,,,,,,,,,,6,,,,,,,,,,,,,,,,,,,,,,,,,,,,,,,,,2,3.0,5.0,3.0,2.0,4.0,5.0,6.0,4.0,5.0,2.0,2.0,2.0,2.0,2.0,3.0,3.0,4.0,2.0,3.0,2.0,3.0,2.0,4.0,2.0,3.0,2.0,2.0,2.0,3.0,3.0,3.0,3.0,0,5.0,6.0,5.0,6.0,5.0,6.0,4.0,4.0,5.0,4.0,5.0,5.0,4.0,5.0,5.0,6.0,6.0,5.0,5.0,5.0,5.0,5.0,6.0,5.0,5.0,5.0,4.0,5.0,5.0,5.0,6.0,4.0,14,,,,,,,,,,,,,,,,,,,,,,,,,,,,,,,,,4,,,,,,,,,,,,,,,,,,,,,,,,,,,,,,,,,9,,,,,,,,,,,,,,,,,,,,,,,,,,,,,,,,,8,,,,,,,,,,,,,,,,,,,,,,,,,,,,,,,,,,641.08,30.44,,,,57.44,,35.65,,,,,,,,,,,,,,,,,,,,96.16,,,,,,,,,85.86,,,317.37,,,,,,,,,,,,,,,18.16,,APPROVED,Female,26.0,FALSE
267,2022-03-21 15:31:29,19,en,1394165961,2022-03-21 15:24:36,2022-03-21 15:31:29,Y,Y,A1,,,13,,,,,,,,,,,,,,,,,,,,,,,,,,,,,,,,,5,,,,,,,,,,,,,,,,,,,,,,,,,,,,,,,,,14,,,,,,,,,,,,,,,,,,,,,,,,,,,,,,,,,6,,,,,,,,,,,,,,,,,,,,,,,,,,,,,,,,,4,,,,,,,,,,,,,,,,,,,,,,,,,,,,,,,,,7,,,,,,,,,,,,,,,,,,,,,,,,,,,,,,,,,2,6.0,6.0,6.0,6.0,6.0,6.0,3.0,6.0,6.0,6.0,6.0,6.0,6.0,6.0,6.0,6.0,6.0,6.0,6.0,6.0,6.0,6.0,5.0,6.0,6.0,6.0,2.0,6.0,6.0,6.0,6.0,7.0,0,5.0,5.0,4.0,4.0,6.0,3.0,5.0,4.0,4.0,4.0,4.0,5.0,5.0,4.0,4.0,5.0,6.0,3.0,5.0,4.0,4.0,5.0,3.0,5.0,5.0,4.0,2.0,4.0,3.0,4.0,5.0,1.0,3,,,,,,,,,,,,,,,,,,,,,,,,,,,,,,,,,10,,,,,,,,,,,,,,,,,,,,,,,,,,,,,,,,,8,,,,,,,,,,,,,,,,,,,,,,,,,,,,,,,,,11,,,,,,,,,,,,,,,,,,,,,,,,,,,,,,,,,9,,,,,,,,,,,,,,,,,,,,,,,,,,,,,,,,,12,,,,,,,,,,,,,,,,,,,,,,,,,,,,,,,,,1,7.0,7.0,6.0,6.0,7.0,6.0,5.0,6.0,6.0,6.0,7.0,6.0,6.0,6.0,6.0,6.0,6.0,6.0,6.0,6.0,6.0,6.0,3.0,6.0,6.0,6.0,5.0,7.0,6.0,6.0,6.0,1.0,,417.76,19.63,,,,16.36,,40.31,,,,,,,,,,,,,,,,,,,,90.46,,,161.41,,,,,,,,,,,,,,,,,,,,,85.86,,,3.73,,APPROVED,Female,20.0,FALSE
268,2022-03-21 15:31:09,19,en,1045972515,2022-03-21 15:24:39,2022-03-21 15:31:09,Y,Y,A1,,,6,,,,,,,,,,,,,,,,,,,,,,,,,,,,,,,,,8,,,,,,,,,,,,,,,,,,,,,,,,,,,,,,,,,11,,,,,,,,,,,,,,,,,,,,,,,,,,,,,,,,,10,,,,,,,,,,,,,,,,,,,,,,,,,,,,,,,,,14,,,,,,,,,,,,,,,,,,,,,,,,,,,,,,,,,9,,,,,,,,,,,,,,,,,,,,,,,,,,,,,,,,,7,,,,,,,,,,,,,,,,,,,,,,,,,,,,,,,,,4,,,,,,,,,,,,,,,,,,,,,,,,,,,,,,,,,2,2.0,1.0,2.0,2.0,2.0,2.0,7.0,2.0,5.0,2.0,1.0,4.0,1.0,2.0,3.0,1.0,5.0,2.0,2.0,2.0,2.0,2.0,3.0,2.0,2.0,4.0,3.0,2.0,1.0,4.0,1.0,2.0,2,6.0,6.0,5.0,4.0,6.0,2.0,7.0,4.0,6.0,5.0,5.0,5.0,4.0,5.0,5.0,5.0,6.0,4.0,5.0,2.0,3.0,6.0,6.0,5.0,5.0,5.0,5.0,3.0,3.0,5.0,4.0,3.0,3,,,,,,,,,,,,,,,,,,,,,,,,,,,,,,,,,13,,,,,,,,,,,,,,,,,,,,,,,,,,,,,,,,,12,,,,,,,,,,,,,,,,,,,,,,,,,,,,,,,,,2,3.0,5.0,3.0,4.0,3.0,6.0,2.0,2.0,3.0,3.0,3.0,6.0,4.0,4.0,6.0,3.0,6.0,1.0,5.0,2.0,5.0,5.0,6.0,4.0,2.0,7.0,4.0,2.0,5.0,5.0,7.0,7.0,5,,,,,,,,,,,,,,,,,,,,,,,,,,,,,,,,,,397.0,12.27,,,,4.26,,49.61,,,,,,,,,,,,,,,,,,,,,,,,,,112.55,,,100.76,,,,,,,,,,,,114.69,,,,,,2.86,,APPROVED,Male,24.0,FALSE
270,2022-03-21 15:34:27,19,en,1572863764,2022-03-21 15:24:42,2022-03-21 15:34:27,Y,Y,A2,,,4,,,,,,,,,,,,,,,,,,,,,,,,,,,,,,,,,3,,,,,,,,,,,,,,,,,,,,,,,,,,,,,,,,,10,,,,,,,,,,,,,,,,,,,,,,,,,,,,,,,,,5,,,,,,,,,,,,,,,,,,,,,,,,,,,,,,,,,13,,,,,,,,,,,,,,,,,,,,,,,,,,,,,,,,,6,,,,,,,,,,,,,,,,,,,,,,,,,,,,,,,,,1,5.0,3.0,4.0,6.0,4.0,6.0,2.0,5.0,2.0,2.0,4.0,5.0,4.0,2.0,2.0,5.0,4.0,4.0,6.0,4.0,3.0,4.0,5.0,5.0,4.0,6.0,1.0,4.0,5.0,5.0,4.0,7.0,8,,,,,,,,,,,,,,,,,,,,,,,,,,,,,,,,,14,,,,,,,,,,,,,,,,,,,,,,,,,,,,,,,,,2,5.0,5.0,3.0,3.0,5.0,1.0,7.0,4.0,6.0,2.0,2.0,6.0,5.0,5.0,7.0,2.0,7.0,2.0,3.0,4.0,2.0,4.0,1.0,5.0,5.0,2.0,6.0,5.0,2.0,3.0,2.0,3.0,0,5.0,6.0,3.0,3.0,4.0,2.0,5.0,6.0,6.0,5.0,2.0,6.0,5.0,5.0,3.0,2.0,7.0,5.0,4.0,5.0,4.0,5.0,1.0,6.0,5.0,1.0,4.0,5.0,3.0,5.0,2.0,4.0,9,,,,,,,,,,,,,,,,,,,,,,,,,,,,,,,,,11,,,,,,,,,,,,,,,,,,,,,,,,,,,,,,,,,7,,,,,,,,,,,,,,,,,,,,,,,,,,,,,,,,,12,,,,,,,,,,,,,,,,,,,,,,,,,,,,,,,,,,588.57,46.48,,,,32.88,,96.93,,,,,,,,,,,,,,,,,,,,119.54,,,,,,,,,103.59,,,115.48,,,,,,,,,,,,,,,73.67,,APPROVED,Male,27.0,FALSE
271,2022-03-21 15:43:16,19,en,1157352412,2022-03-21 15:24:44,2022-03-21 15:43:16,Y,Y,A1,,,6,,,,,,,,,,,,,,,,,,,,,,,,,,,,,,,,,3,,,,,,,,,,,,,,,,,,,,,,,,,,,,,,,,,4,,,,,,,,,,,,,,,,,,,,,,,,,,,,,,,,,2,2.0,2.0,2.0,2.0,2.0,5.0,7.0,2.0,2.0,2.0,2.0,2.0,2.0,2.0,2.0,2.0,5.0,7.0,2.0,2.0,2.0,2.0,2.0,2.0,2.0,5.0,2.0,2.0,2.0,2.0,2.0,4.0,12,,,,,,,,,,,,,,,,,,,,,,,,,,,,,,,,,5,,,,,,,,,,,,,,,,,,,,,,,,,,,,,,,,,14,,,,,,,,,,,,,,,,,,,,,,,,,,,,,,,,,0,1.0,1.0,2.0,2.0,4.0,6.0,7.0,4.0,1.0,2.0,6.0,2.0,2.0,1.0,2.0,4.0,1.0,1.0,3.0,2.0,1.0,3.0,4.0,2.0,4.0,7.0,3.0,2.0,2.0,2.0,7.0,1.0,7,,,,,,,,,,,,,,,,,,,,,,,,,,,,,,,,,9,,,,,,,,,,,,,,,,,,,,,,,,,,,,,,,,,10,,,,,,,,,,,,,,,,,,,,,,,,,,,,,,,,,11,,,,,,,,,,,,,,,,,,,,,,,,,,,,,,,,,13,,,,,,,,,,,,,,,,,,,,,,,,,,,,,,,,,1,2.0,5.0,2.0,2.0,2.0,6.0,2.0,2.0,4.0,2.0,2.0,6.0,2.0,2.0,2.0,3.0,5.0,6.0,2.0,2.0,2.0,2.0,1.0,2.0,2.0,3.0,5.0,2.0,4.0,2.0,4.0,1.0,8,,,,,,,,,,,,,,,,,,,,,,,,,,,,,,,,,,1113.49,25.89,,,,11.29,,28.96,,,,,,,,,,,188.34,,,,,,,,,,,,237.24,,,,,,,,,,,,,,,,,,613.28,,,,,,8.49,,APPROVED,Female,26.0,FALSE
272,2022-03-21 15:29:55,19,en,1574546807,2022-03-21 15:24:47,2022-03-21 15:29:55,Y,Y,A1,,,5,,,,,,,,,,,,,,,,,,,,,,,,,,,,,,,,,8,,,,,,,,,,,,,,,,,,,,,,,,,,,,,,,,,12,,,,,,,,,,,,,,,,,,,,,,,,,,,,,,,,,1,5.0,5.0,3.0,4.0,3.0,3.0,4.0,4.0,5.0,3.0,5.0,3.0,5.0,4.0,5.0,3.0,5.0,3.0,4.0,3.0,4.0,5.0,3.0,4.0,5.0,2.0,5.0,5.0,3.0,3.0,3.0,4.0,10,,,,,,,,,,,,,,,,,,,,,,,,,,,,,,,,,9,,,,,,,,,,,,,,,,,,,,,,,,,,,,,,,,,11,,,,,,,,,,,,,,,,,,,,,,,,,,,,,,,,,2,2.0,3.0,2.0,2.0,2.0,2.0,3.0,5.0,2.0,2.0,2.0,1.0,2.0,2.0,2.0,1.0,4.0,1.0,3.0,2.0,1.0,1.0,2.0,2.0,1.0,1.0,2.0,2.0,1.0,3.0,1.0,1.0,3,,,,,,,,,,,,,,,,,,,,,,,,,,,,,,,,,13,,,,,,,,,,,,,,,,,,,,,,,,,,,,,,,,,6,,,,,,,,,,,,,,,,,,,,,,,,,,,,,,,,,0,2.0,2.0,2.0,3.0,2.0,2.0,5.0,3.0,3.0,2.0,1.0,2.0,2.0,2.0,2.0,2.0,2.0,2.0,3.0,2.0,3.0,2.0,2.0,2.0,2.0,1.0,5.0,2.0,2.0,2.0,2.0,5.0,7,,,,,,,,,,,,,,,,,,,,,,,,,,,,,,,,,14,,,,,,,,,,,,,,,,,,,,,,,,,,,,,,,,,4,,,,,,,,,,,,,,,,,,,,,,,,,,,,,,,,,,311.71,28.18,,,,6.9,,56.87,,,,,,,,,,,64.24,,,,,,,,,,,,61.81,,,,,,,,,,,,90.84,,,,,,,,,,,,2.87,,APPROVED,Male,22.0,FALSE
273,2022-03-21 15:30:47,19,en,74448196,2022-03-21 15:24:48,2022-03-21 15:30:47,Y,Y,A1,,,3,,,,,,,,,,,,,,,,,,,,,,,,,,,,,,,,,9,,,,,,,,,,,,,,,,,,,,,,,,,,,,,,,,,2,7.0,7.0,6.0,6.0,6.0,5.0,6.0,6.0,7.0,6.0,7.0,6.0,6.0,4.0,6.0,3.0,6.0,7.0,6.0,6.0,6.0,5.0,5.0,7.0,6.0,5.0,4.0,7.0,6.0,3.0,6.0,3.0,0,7.0,7.0,7.0,5.0,5.0,3.0,6.0,7.0,7.0,5.0,5.0,7.0,6.0,7.0,7.0,6.0,7.0,5.0,6.0,6.0,7.0,6.0,4.0,7.0,7.0,3.0,7.0,7.0,7.0,4.0,7.0,4.0,5,,,,,,,,,,,,,,,,,,,,,,,,,,,,,,,,,6,,,,,,,,,,,,,,,,,,,,,,,,,,,,,,,,,4,,,,,,,,,,,,,,,,,,,,,,,,,,,,,,,,,7,,,,,,,,,,,,,,,,,,,,,,,,,,,,,,,,,12,,,,,,,,,,,,,,,,,,,,,,,,,,,,,,,,,8,,,,,,,,,,,,,,,,,,,,,,,,,,,,,,,,,13,,,,,,,,,,,,,,,,,,,,,,,,,,,,,,,,,14,,,,,,,,,,,,,,,,,,,,,,,,,,,,,,,,,1,2.0,5.0,2.0,3.0,5.0,1.0,4.0,2.0,7.0,3.0,6.0,4.0,4.0,4.0,5.0,2.0,5.0,1.0,2.0,2.0,3.0,2.0,2.0,3.0,3.0,5.0,5.0,2.0,6.0,3.0,2.0,6.0,11,,,,,,,,,,,,,,,,,,,,,,,,,,,,,,,,,10,,,,,,,,,,,,,,,,,,,,,,,,,,,,,,,,,,362.35,64.66,,,,8.34,,51.51,,,,,,,,96.1,,,69.95,,,,,,,,,,,,,,,,,,,,,,,,,,,67.85,,,,,,,,,3.94,,APPROVED,Female,20.0,FALSE
274,2022-03-21 15:29:27,19,en,1027284373,2022-03-21 15:24:52,2022-03-21 15:29:27,Y,Y,A1,,,13,,,,,,,,,,,,,,,,,,,,,,,,,,,,,,,,,8,,,,,,,,,,,,,,,,,,,,,,,,,,,,,,,,,10,,,,,,,,,,,,,,,,,,,,,,,,,,,,,,,,,11,,,,,,,,,,,,,,,,,,,,,,,,,,,,,,,,,12,,,,,,,,,,,,,,,,,,,,,,,,,,,,,,,,,0,4.0,5.0,2.0,2.0,3.0,2.0,5.0,5.0,7.0,3.0,3.0,2.0,3.0,4.0,5.0,1.0,5.0,3.0,3.0,3.0,3.0,2.0,1.0,3.0,4.0,4.0,5.0,2.0,4.0,3.0,2.0,6.0,9,,,,,,,,,,,,,,,,,,,,,,,,,,,,,,,,,14,,,,,,,,,,,,,,,,,,,,,,,,,,,,,,,,,4,,,,,,,,,,,,,,,,,,,,,,,,,,,,,,,,,3,,,,,,,,,,,,,,,,,,,,,,,,,,,,,,,,,1,4.0,6.0,4.0,5.0,6.0,5.0,6.0,6.0,6.0,3.0,4.0,5.0,3.0,4.0,3.0,3.0,5.0,4.0,3.0,4.0,2.0,5.0,5.0,5.0,5.0,3.0,3.0,5.0,4.0,5.0,2.0,4.0,7,,,,,,,,,,,,,,,,,,,,,,,,,,,,,,,,,2,5.0,4.0,5.0,6.0,5.0,6.0,3.0,7.0,3.0,6.0,6.0,5.0,6.0,5.0,4.0,6.0,6.0,5.0,5.0,5.0,5.0,5.0,5.0,5.0,5.0,7.0,4.0,7.0,6.0,5.0,7.0,6.0,5,,,,,,,,,,,,,,,,,,,,,,,,,,,,,,,,,6,,,,,,,,,,,,,,,,,,,,,,,,,,,,,,,,,,277.23,23.78,,,,11.02,,18.42,,,,,,,,,,,,,,,,,80.75,,,,,,,,,,,,,,,72.34,,,,,,66.76,,,,,,,,,4.16,,APPROVED,Male,22.0,FALSE
275,2022-03-21 15:30:20,19,en,445395349,2022-03-21 15:24:54,2022-03-21 15:30:20,Y,Y,A1,,,11,,,,,,,,,,,,,,,,,,,,,,,,,,,,,,,,,8,,,,,,,,,,,,,,,,,,,,,,,,,,,,,,,,,0,6.0,7.0,6.0,6.0,6.0,6.0,2.0,6.0,6.0,5.0,6.0,5.0,6.0,4.0,5.0,6.0,5.0,6.0,6.0,3.0,5.0,6.0,6.0,6.0,6.0,2.0,6.0,6.0,4.0,6.0,6.0,3.0,4,,,,,,,,,,,,,,,,,,,,,,,,,,,,,,,,,10,,,,,,,,,,,,,,,,,,,,,,,,,,,,,,,,,9,,,,,,,,,,,,,,,,,,,,,,,,,,,,,,,,,13,,,,,,,,,,,,,,,,,,,,,,,,,,,,,,,,,7,,,,,,,,,,,,,,,,,,,,,,,,,,,,,,,,,6,,,,,,,,,,,,,,,,,,,,,,,,,,,,,,,,,2,2.0,5.0,2.0,1.0,2.0,1.0,7.0,6.0,6.0,2.0,1.0,2.0,2.0,2.0,5.0,2.0,5.0,1.0,2.0,2.0,2.0,4.0,2.0,2.0,2.0,2.0,4.0,2.0,2.0,2.0,2.0,3.0,1,2.0,7.0,2.0,2.0,3.0,2.0,7.0,5.0,7.0,2.0,3.0,5.0,2.0,5.0,5.0,2.0,6.0,2.0,2.0,3.0,2.0,2.0,2.0,2.0,4.0,2.0,6.0,2.0,3.0,2.0,2.0,4.0,12,,,,,,,,,,,,,,,,,,,,,,,,,,,,,,,,,14,,,,,,,,,,,,,,,,,,,,,,,,,,,,,,,,,5,,,,,,,,,,,,,,,,,,,,,,,,,,,,,,,,,3,,,,,,,,,,,,,,,,,,,,,,,,,,,,,,,,,,328.72,12.44,,,,6.4,,39.84,,,,,,,,99.18,,,,,,,,,,,,,,,,,,,,,73.02,,,94.77,,,,,,,,,,,,,,,3.07,,APPROVED,Female,26.0,FALSE
276,2022-03-21 15:34:07,19,en,986406366,2022-03-21 15:24:55,2022-03-21 15:34:07,Y,Y,-oth-,no academic degree,,12,,,,,,,,,,,,,,,,,,,,,,,,,,,,,,,,,4,,,,,,,,,,,,,,,,,,,,,,,,,,,,,,,,,11,,,,,,,,,,,,,,,,,,,,,,,,,,,,,,,,,10,,,,,,,,,,,,,,,,,,,,,,,,,,,,,,,,,8,,,,,,,,,,,,,,,,,,,,,,,,,,,,,,,,,2,6.0,5.0,6.0,6.0,5.0,6.0,3.0,7.0,6.0,5.0,4.0,6.0,7.0,4.0,4.0,7.0,7.0,7.0,6.0,5.0,4.0,7.0,7.0,7.0,5.0,7.0,5.0,7.0,5.0,7.0,7.0,6.0,5,,,,,,,,,,,,,,,,,,,,,,,,,,,,,,,,,6,,,,,,,,,,,,,,,,,,,,,,,,,,,,,,,,,14,,,,,,,,,,,,,,,,,,,,,,,,,,,,,,,,,7,,,,,,,,,,,,,,,,,,,,,,,,,,,,,,,,,3,,,,,,,,,,,,,,,,,,,,,,,,,,,,,,,,,0,4.0,6.0,5.0,2.0,6.0,3.0,6.0,6.0,7.0,4.0,5.0,5.0,3.0,5.0,5.0,3.0,5.0,3.0,4.0,4.0,3.0,4.0,2.0,3.0,6.0,1.0,6.0,2.0,3.0,3.0,3.0,3.0,13,,,,,,,,,,,,,,,,,,,,,,,,,,,,,,,,,9,,,,,,,,,,,,,,,,,,,,,,,,,,,,,,,,,1,6.0,6.0,6.0,5.0,6.0,6.0,3.0,6.0,5.0,6.0,6.0,6.0,6.0,6.0,7.0,7.0,7.0,5.0,6.0,6.0,2.0,5.0,5.0,6.0,6.0,5.0,4.0,5.0,3.0,6.0,6.0,1.0,,554.33,52.38,,,,40.41,,31.37,,,,,,,,,,,,,,,,,90.29,,,,,,,,,,,,,,,,,,211.12,,,,,,,,,125.54,,,3.22,,APPROVED,Male,45.0,FALSE
277,2022-03-21 15:36:07,19,en,1560712279,2022-03-21 15:24:56,2022-03-21 15:36:07,Y,Y,A1,,,9,,,,,,,,,,,,,,,,,,,,,,,,,,,,,,,,,12,,,,,,,,,,,,,,,,,,,,,,,,,,,,,,,,,1,2.0,2.0,2.0,4.0,2.0,2.0,6.0,4.0,2.0,2.0,2.0,2.0,2.0,2.0,2.0,2.0,2.0,2.0,2.0,2.0,2.0,2.0,2.0,2.0,2.0,2.0,4.0,2.0,2.0,2.0,2.0,3.0,8,,,,,,,,,,,,,,,,,,,,,,,,,,,,,,,,,2,2.0,2.0,2.0,4.0,2.0,2.0,6.0,4.0,4.0,2.0,2.0,2.0,2.0,2.0,2.0,2.0,2.0,2.0,2.0,2.0,2.0,2.0,2.0,2.0,2.0,4.0,4.0,2.0,5.0,2.0,2.0,5.0,3,,,,,,,,,,,,,,,,,,,,,,,,,,,,,,,,,14,,,,,,,,,,,,,,,,,,,,,,,,,,,,,,,,,4,,,,,,,,,,,,,,,,,,,,,,,,,,,,,,,,,10,,,,,,,,,,,,,,,,,,,,,,,,,,,,,,,,,11,,,,,,,,,,,,,,,,,,,,,,,,,,,,,,,,,7,,,,,,,,,,,,,,,,,,,,,,,,,,,,,,,,,6,,,,,,,,,,,,,,,,,,,,,,,,,,,,,,,,,5,,,,,,,,,,,,,,,,,,,,,,,,,,,,,,,,,0,1.0,6.0,1.0,4.0,1.0,5.0,2.0,4.0,6.0,1.0,4.0,6.0,2.0,1.0,6.0,1.0,6.0,2.0,2.0,1.0,1.0,6.0,6.0,2.0,1.0,6.0,4.0,2.0,6.0,1.0,6.0,7.0,13,,,,,,,,,,,,,,,,,,,,,,,,,,,,,,,,,,674.23,39.88,,,,14.31,,87.33,,,,,,,,140.75,,,,,,137.4,,,,,,,,,,,,,,,,,,,,,,,,,,,248.48,,,,,,6.08,,APPROVED,Male,23.0,FALSE
278,2022-03-21 15:41:07,19,en,383539707,2022-03-21 15:24:57,2022-03-21 15:41:07,Y,Y,-oth-,National Diploma,,8,,,,,,,,,,,,,,,,,,,,,,,,,,,,,,,,,3,,,,,,,,,,,,,,,,,,,,,,,,,,,,,,,,,10,,,,,,,,,,,,,,,,,,,,,,,,,,,,,,,,,6,,,,,,,,,,,,,,,,,,,,,,,,,,,,,,,,,5,,,,,,,,,,,,,,,,,,,,,,,,,,,,,,,,,0,6.0,6.0,6.0,2.0,6.0,1.0,7.0,5.0,6.0,6.0,5.0,6.0,5.0,7.0,6.0,4.0,6.0,4.0,5.0,6.0,3.0,5.0,1.0,5.0,7.0,1.0,4.0,7.0,2.0,4.0,5.0,6.0,14,,,,,,,,,,,,,,,,,,,,,,,,,,,,,,,,,7,,,,,,,,,,,,,,,,,,,,,,,,,,,,,,,,,2,3.0,1.0,2.0,2.0,2.0,2.0,6.0,4.0,4.0,3.0,2.0,3.0,2.0,2.0,3.0,3.0,3.0,2.0,4.0,2.0,3.0,2.0,2.0,2.0,2.0,1.0,3.0,2.0,3.0,2.0,1.0,2.0,13,,,,,,,,,,,,,,,,,,,,,,,,,,,,,,,,,12,,,,,,,,,,,,,,,,,,,,,,,,,,,,,,,,,4,,,,,,,,,,,,,,,,,,,,,,,,,,,,,,,,,11,,,,,,,,,,,,,,,,,,,,,,,,,,,,,,,,,9,,,,,,,,,,,,,,,,,,,,,,,,,,,,,,,,,1,5.0,6.0,6.0,1.0,5.0,2.0,7.0,4.0,7.0,5.0,6.0,6.0,6.0,4.0,6.0,5.0,6.0,4.0,4.0,5.0,3.0,5.0,1.0,5.0,7.0,1.0,5.0,6.0,3.0,5.0,3.0,1.0,,972.99,45.07,,,,121.55,,23.74,,,,,,,,,,,,,,,,,289.67,,,,,,,,,270.34,,,,,,,,,,,,,,,,,,208.17,,,14.45,,APPROVED,Male,22.0,FALSE
279,2022-03-21 15:28:48,19,en,1538034194,2022-03-21 15:25:02,2022-03-21 15:28:48,Y,Y,A1,,,7,,,,,,,,,,,,,,,,,,,,,,,,,,,,,,,,,3,,,,,,,,,,,,,,,,,,,,,,,,,,,,,,,,,4,,,,,,,,,,,,,,,,,,,,,,,,,,,,,,,,,9,,,,,,,,,,,,,,,,,,,,,,,,,,,,,,,,,0,2.0,6.0,2.0,1.0,2.0,1.0,7.0,3.0,6.0,4.0,1.0,2.0,2.0,3.0,5.0,3.0,5.0,2.0,1.0,2.0,2.0,3.0,2.0,1.0,1.0,4.0,2.0,1.0,7.0,3.0,2.0,5.0,13,,,,,,,,,,,,,,,,,,,,,,,,,,,,,,,,,12,,,,,,,,,,,,,,,,,,,,,,,,,,,,,,,,,8,,,,,,,,,,,,,,,,,,,,,,,,,,,,,,,,,10,,,,,,,,,,,,,,,,,,,,,,,,,,,,,,,,,2,1.0,5.0,1.0,1.0,1.0,1.0,7.0,1.0,6.0,2.0,2.0,4.0,1.0,2.0,3.0,1.0,7.0,1.0,1.0,1.0,1.0,2.0,1.0,1.0,1.0,1.0,2.0,1.0,1.0,1.0,1.0,3.0,5,,,,,,,,,,,,,,,,,,,,,,,,,,,,,,,,,1,1.0,5.0,1.0,1.0,2.0,1.0,5.0,6.0,5.0,1.0,1.0,6.0,1.0,1.0,6.0,1.0,5.0,1.0,1.0,1.0,1.0,1.0,1.0,1.0,1.0,1.0,6.0,1.0,1.0,1.0,2.0,5.0,11,,,,,,,,,,,,,,,,,,,,,,,,,,,,,,,,,6,,,,,,,,,,,,,,,,,,,,,,,,,,,,,,,,,14,,,,,,,,,,,,,,,,,,,,,,,,,,,,,,,,,,229.4,19.39,,,,11.67,,14.82,,,,,,,,,,,,,,60.0,,,,,,,,,,,,,,,44.39,,,,,,75.74,,,,,,,,,,,,3.39,,APPROVED,Female,19.0,FALSE
280,2022-03-21 15:34:53,19,en,1749411362,2022-03-21 15:25:04,2022-03-21 15:34:53,Y,Y,A1,,,14,,,,,,,,,,,,,,,,,,,,,,,,,,,,,,,,,9,,,,,,,,,,,,,,,,,,,,,,,,,,,,,,,,,3,,,,,,,,,,,,,,,,,,,,,,,,,,,,,,,,,10,,,,,,,,,,,,,,,,,,,,,,,,,,,,,,,,,6,,,,,,,,,,,,,,,,,,,,,,,,,,,,,,,,,7,,,,,,,,,,,,,,,,,,,,,,,,,,,,,,,,,8,,,,,,,,,,,,,,,,,,,,,,,,,,,,,,,,,12,,,,,,,,,,,,,,,,,,,,,,,,,,,,,,,,,4,,,,,,,,,,,,,,,,,,,,,,,,,,,,,,,,,5,,,,,,,,,,,,,,,,,,,,,,,,,,,,,,,,,13,,,,,,,,,,,,,,,,,,,,,,,,,,,,,,,,,1,5.0,6.0,4.0,2.0,5.0,3.0,6.0,7.0,7.0,4.0,7.0,4.0,6.0,5.0,6.0,2.0,5.0,4.0,5.0,2.0,5.0,5.0,3.0,5.0,5.0,7.0,3.0,6.0,6.0,4.0,2.0,5.0,0,4.0,7.0,4.0,2.0,2.0,2.0,6.0,7.0,7.0,4.0,6.0,7.0,6.0,3.0,6.0,3.0,6.0,5.0,5.0,5.0,3.0,4.0,2.0,5.0,5.0,2.0,4.0,4.0,4.0,4.0,2.0,6.0,11,,,,,,,,,,,,,,,,,,,,,,,,,,,,,,,,,2,2.0,7.0,3.0,1.0,4.0,1.0,7.0,1.0,6.0,4.0,5.0,2.0,3.0,2.0,6.0,1.0,5.0,2.0,5.0,3.0,2.0,5.0,1.0,2.0,2.0,6.0,4.0,4.0,4.0,3.0,4.0,1.0,,593.15,131.63,,,,26.45,,68.6,,,,,,,,,,,,,,,,,,,,,,,,,,,,,,,,,,,114.74,,,142.16,,,,,,98.85,,,10.72,,APPROVED,Female,25.0,FALSE
281,2022-03-21 15:34:16,19,en,978915398,2022-03-21 15:25:07,2022-03-21 15:34:16,Y,Y,A1,,,13,,,,,,,,,,,,,,,,,,,,,,,,,,,,,,,,,2,7.0,6.0,7.0,7.0,7.0,7.0,6.0,7.0,6.0,7.0,6.0,6.0,6.0,7.0,6.0,6.0,6.0,7.0,7.0,7.0,7.0,6.0,7.0,6.0,6.0,7.0,1.0,6.0,6.0,6.0,7.0,2.0,3,,,,,,,,,,,,,,,,,,,,,,,,,,,,,,,,,12,,,,,,,,,,,,,,,,,,,,,,,,,,,,,,,,,4,,,,,,,,,,,,,,,,,,,,,,,,,,,,,,,,,8,,,,,,,,,,,,,,,,,,,,,,,,,,,,,,,,,7,,,,,,,,,,,,,,,,,,,,,,,,,,,,,,,,,6,,,,,,,,,,,,,,,,,,,,,,,,,,,,,,,,,5,,,,,,,,,,,,,,,,,,,,,,,,,,,,,,,,,9,,,,,,,,,,,,,,,,,,,,,,,,,,,,,,,,,11,,,,,,,,,,,,,,,,,,,,,,,,,,,,,,,,,0,5.0,6.0,7.0,5.0,5.0,6.0,6.0,7.0,5.0,5.0,5.0,5.0,6.0,5.0,5.0,4.0,5.0,5.0,7.0,6.0,4.0,6.0,6.0,6.0,6.0,7.0,3.0,6.0,6.0,4.0,7.0,5.0,1,6.0,6.0,6.0,6.0,6.0,5.0,7.0,5.0,5.0,5.0,6.0,5.0,5.0,5.0,5.0,6.0,6.0,6.0,6.0,6.0,5.0,6.0,6.0,5.0,7.0,7.0,2.0,5.0,6.0,4.0,7.0,6.0,10,,,,,,,,,,,,,,,,,,,,,,,,,,,,,,,,,14,,,,,,,,,,,,,,,,,,,,,,,,,,,,,,,,,none,551.75,109.38,,,,21.61,,87.82,,,,,97.42,,,,,,,,,,,,,,,,,,,,,,,,,,,,,,131.22,,,82.25,,,,,,,,,22.05,,APPROVED,Male,24.0,FALSE
282,2022-03-21 15:31:19,19,en,714360099,2022-03-21 15:25:08,2022-03-21 15:31:19,Y,Y,-oth-,,,2,1.0,5.0,1.0,2.0,2.0,2.0,1.0,1.0,5.0,2.0,2.0,2.0,5.0,1.0,1.0,2.0,5.0,1.0,2.0,2.0,2.0,2.0,2.0,2.0,2.0,1.0,2.0,5.0,2.0,2.0,2.0,1.0,6,,,,,,,,,,,,,,,,,,,,,,,,,,,,,,,,,0,4.0,4.0,2.0,3.0,3.0,2.0,4.0,5.0,3.0,5.0,2.0,4.0,3.0,2.0,4.0,3.0,2.0,2.0,2.0,2.0,1.0,3.0,1.0,3.0,3.0,2.0,4.0,3.0,4.0,3.0,3.0,5.0,8,,,,,,,,,,,,,,,,,,,,,,,,,,,,,,,,,3,,,,,,,,,,,,,,,,,,,,,,,,,,,,,,,,,12,,,,,,,,,,,,,,,,,,,,,,,,,,,,,,,,,5,,,,,,,,,,,,,,,,,,,,,,,,,,,,,,,,,1,2.0,1.0,2.0,1.0,1.0,1.0,2.0,1.0,1.0,2.0,1.0,1.0,2.0,2.0,2.0,1.0,1.0,1.0,1.0,1.0,2.0,2.0,1.0,2.0,2.0,1.0,3.0,2.0,1.0,1.0,1.0,1.0,11,,,,,,,,,,,,,,,,,,,,,,,,,,,,,,,,,9,,,,,,,,,,,,,,,,,,,,,,,,,,,,,,,,,13,,,,,,,,,,,,,,,,,,,,,,,,,,,,,,,,,14,,,,,,,,,,,,,,,,,,,,,,,,,,,,,,,,,10,,,,,,,,,,,,,,,,,,,,,,,,,,,,,,,,,7,,,,,,,,,,,,,,,,,,,,,,,,,,,,,,,,,4,,,,,,,,,,,,,,,,,,,,,,,,,,,,,,,,,,374.05,64.77,,,,20.22,,52.37,,57.95,,,,,,117.4,,,,,,,,,,,,,,,55.83,,,,,,,,,,,,,,,,,,,,,,,,5.51,,APPROVED,Male,20.0,FALSE
283,2022-03-21 15:36:15,19,en,34537690,2022-03-21 15:25:11,2022-03-21 15:36:15,Y,Y,-oth-,Degree,,4,,,,,,,,,,,,,,,,,,,,,,,,,,,,,,,,,9,,,,,,,,,,,,,,,,,,,,,,,,,,,,,,,,,12,,,,,,,,,,,,,,,,,,,,,,,,,,,,,,,,,3,,,,,,,,,,,,,,,,,,,,,,,,,,,,,,,,,6,,,,,,,,,,,,,,,,,,,,,,,,,,,,,,,,,0,6.0,4.0,6.0,4.0,7.0,6.0,7.0,6.0,6.0,4.0,6.0,4.0,3.0,6.0,6.0,4.0,3.0,6.0,4.0,3.0,3.0,6.0,2.0,4.0,6.0,4.0,4.0,3.0,5.0,4.0,4.0,6.0,10,,,,,,,,,,,,,,,,,,,,,,,,,,,,,,,,,1,2.0,4.0,1.0,1.0,2.0,6.0,7.0,2.0,2.0,2.0,2.0,2.0,2.0,2.0,4.0,2.0,2.0,2.0,2.0,2.0,2.0,3.0,2.0,2.0,2.0,3.0,5.0,2.0,1.0,2.0,4.0,1.0,14,,,,,,,,,,,,,,,,,,,,,,,,,,,,,,,,,5,,,,,,,,,,,,,,,,,,,,,,,,,,,,,,,,,11,,,,,,,,,,,,,,,,,,,,,,,,,,,,,,,,,2,5.0,6.0,6.0,6.0,6.0,6.0,2.0,7.0,6.0,7.0,6.0,6.0,7.0,6.0,6.0,4.0,6.0,6.0,7.0,6.0,6.0,6.0,7.0,6.0,6.0,6.0,4.0,6.0,6.0,6.0,6.0,5.0,7,,,,,,,,,,,,,,,,,,,,,,,,,,,,,,,,,13,,,,,,,,,,,,,,,,,,,,,,,,,,,,,,,,,8,,,,,,,,,,,,,,,,,,,,,,,,,,,,,,,,,"It was an interesting study, really enjoyed it.",667.01,103.77,,,,20.92,,121.06,,,,,,,,,,,,,,,,,179.31,,,,,,103.11,,,,,,,,,,,,86.85,,,,,,,,,,,,51.99,,APPROVED,Female,27.0,FALSE
284,2022-03-21 15:29:10,19,en,1000237048,2022-03-21 15:25:11,2022-03-21 15:29:10,Y,Y,A2,,,5,,,,,,,,,,,,,,,,,,,,,,,,,,,,,,,,,3,,,,,,,,,,,,,,,,,,,,,,,,,,,,,,,,,10,,,,,,,,,,,,,,,,,,,,,,,,,,,,,,,,,13,,,,,,,,,,,,,,,,,,,,,,,,,,,,,,,,,1,3.0,2.0,3.0,2.0,2.0,2.0,5.0,4.0,3.0,1.0,2.0,3.0,3.0,3.0,2.0,2.0,4.0,2.0,2.0,2.0,2.0,2.0,3.0,2.0,2.0,4.0,5.0,2.0,5.0,2.0,2.0,5.0,14,,,,,,,,,,,,,,,,,,,,,,,,,,,,,,,,,7,,,,,,,,,,,,,,,,,,,,,,,,,,,,,,,,,4,,,,,,,,,,,,,,,,,,,,,,,,,,,,,,,,,12,,,,,,,,,,,,,,,,,,,,,,,,,,,,,,,,,8,,,,,,,,,,,,,,,,,,,,,,,,,,,,,,,,,6,,,,,,,,,,,,,,,,,,,,,,,,,,,,,,,,,11,,,,,,,,,,,,,,,,,,,,,,,,,,,,,,,,,0,5.0,5.0,6.0,6.0,1.0,4.0,5.0,2.0,6.0,4.0,3.0,5.0,5.0,5.0,5.0,4.0,5.0,4.0,5.0,3.0,2.0,3.0,5.0,5.0,4.0,2.0,6.0,3.0,3.0,3.0,3.0,6.0,9,,,,,,,,,,,,,,,,,,,,,,,,,,,,,,,,,2,5.0,5.0,5.0,6.0,4.0,6.0,2.0,6.0,4.0,5.0,6.0,3.0,6.0,3.0,5.0,6.0,6.0,5.0,5.0,5.0,3.0,6.0,6.0,5.0,5.0,5.0,3.0,6.0,6.0,6.0,5.0,1.0,,241.33,10.58,,,,4.38,,21.35,,,,,,,,,,,,,,65.04,,,,,,,,,,,,,,,,,,,,,,,,71.45,,,,,,65.44,,,3.09,,APPROVED,Female,25.0,FALSE
285,2022-03-21 15:48:19,19,en,1153281680,2022-03-21 15:25:17,2022-03-21 15:48:19,Y,Y,A1,,,13,,,,,,,,,,,,,,,,,,,,,,,,,,,,,,,,,0,7.0,6.0,7.0,7.0,7.0,7.0,5.0,7.0,7.0,7.0,6.0,6.0,6.0,7.0,7.0,7.0,7.0,6.0,7.0,7.0,7.0,7.0,6.0,7.0,7.0,7.0,1.0,7.0,7.0,6.0,7.0,2.0,11,,,,,,,,,,,,,,,,,,,,,,,,,,,,,,,,,14,,,,,,,,,,,,,,,,,,,,,,,,,,,,,,,,,4,,,,,,,,,,,,,,,,,,,,,,,,,,,,,,,,,9,,,,,,,,,,,,,,,,,,,,,,,,,,,,,,,,,7,,,,,,,,,,,,,,,,,,,,,,,,,,,,,,,,,5,,,,,,,,,,,,,,,,,,,,,,,,,,,,,,,,,1,2.0,2.0,4.0,3.0,4.0,6.0,3.0,2.0,5.0,2.0,1.0,2.0,3.0,2.0,2.0,2.0,1.0,1.0,1.0,2.0,1.0,2.0,2.0,4.0,2.0,7.0,1.0,5.0,1.0,2.0,5.0,2.0,10,,,,,,,,,,,,,,,,,,,,,,,,,,,,,,,,,2,7.0,7.0,7.0,7.0,7.0,7.0,6.0,6.0,7.0,7.0,7.0,6.0,7.0,7.0,7.0,6.0,7.0,7.0,5.0,7.0,6.0,7.0,7.0,7.0,5.0,7.0,2.0,7.0,7.0,7.0,7.0,4.0,3,,,,,,,,,,,,,,,,,,,,,,,,,,,,,,,,,8,,,,,,,,,,,,,,,,,,,,,,,,,,,,,,,,,12,,,,,,,,,,,,,,,,,,,,,,,,,,,,,,,,,6,,,,,,,,,,,,,,,,,,,,,,,,,,,,,,,,,None,1385.85,93.37,,,,14.45,,76.94,,,,,520.89,,,,,,,,,,,,,,,,,,,,,496.55,,,,,,169.18,,,,,,,,,,,,,,,14.47,,APPROVED,Female,31.0,FALSE
286,2022-03-21 15:32:52,19,en,390975814,2022-03-21 15:25:18,2022-03-21 15:32:52,Y,Y,A1,,,7,,,,,,,,,,,,,,,,,,,,,,,,,,,,,,,,,12,,,,,,,,,,,,,,,,,,,,,,,,,,,,,,,,,2,6.0,4.0,5.0,5.0,5.0,5.0,3.0,6.0,4.0,5.0,5.0,6.0,6.0,4.0,5.0,6.0,5.0,5.0,6.0,6.0,5.0,6.0,5.0,5.0,6.0,5.0,3.0,6.0,5.0,5.0,5.0,1.0,6,,,,,,,,,,,,,,,,,,,,,,,,,,,,,,,,,13,,,,,,,,,,,,,,,,,,,,,,,,,,,,,,,,,10,,,,,,,,,,,,,,,,,,,,,,,,,,,,,,,,,8,,,,,,,,,,,,,,,,,,,,,,,,,,,,,,,,,4,,,,,,,,,,,,,,,,,,,,,,,,,,,,,,,,,11,,,,,,,,,,,,,,,,,,,,,,,,,,,,,,,,,5,,,,,,,,,,,,,,,,,,,,,,,,,,,,,,,,,14,,,,,,,,,,,,,,,,,,,,,,,,,,,,,,,,,0,5.0,4.0,5.0,4.0,4.0,4.0,4.0,5.0,4.0,4.0,4.0,5.0,5.0,3.0,3.0,4.0,5.0,3.0,3.0,4.0,3.0,4.0,5.0,3.0,5.0,4.0,3.0,4.0,3.0,4.0,5.0,5.0,9,,,,,,,,,,,,,,,,,,,,,,,,,,,,,,,,,3,,,,,,,,,,,,,,,,,,,,,,,,,,,,,,,,,1,2.0,3.0,2.0,4.0,2.0,4.0,4.0,3.0,3.0,3.0,2.0,3.0,4.0,3.0,3.0,4.0,3.0,2.0,2.0,2.0,2.0,3.0,4.0,3.0,3.0,4.0,4.0,4.0,3.0,3.0,2.0,1.0,,457.14,47.14,,,,8.21,,36.4,,,,,,,,87.61,,,,,,,,,,,,,,,,,,,,,,,,,,,142.09,,,,,,,,,131.17,,,4.52,,APPROVED,Female,30.0,FALSE
287,2022-03-21 15:39:59,19,en,1115933723,2022-03-21 15:25:18,2022-03-21 15:39:59,Y,Y,-oth-,National Senior Certificate,,8,,,,,,,,,,,,,,,,,,,,,,,,,,,,,,,,,0,7.0,7.0,7.0,5.0,7.0,7.0,4.0,5.0,6.0,6.0,5.0,7.0,5.0,4.0,7.0,6.0,6.0,6.0,6.0,6.0,6.0,6.0,5.0,7.0,7.0,6.0,2.0,6.0,5.0,5.0,7.0,2.0,2,6.0,7.0,6.0,6.0,6.0,7.0,1.0,7.0,5.0,6.0,6.0,6.0,6.0,5.0,7.0,7.0,6.0,6.0,6.0,6.0,5.0,6.0,7.0,6.0,6.0,6.0,1.0,7.0,5.0,6.0,7.0,3.0,4,,,,,,,,,,,,,,,,,,,,,,,,,,,,,,,,,12,,,,,,,,,,,,,,,,,,,,,,,,,,,,,,,,,10,,,,,,,,,,,,,,,,,,,,,,,,,,,,,,,,,7,,,,,,,,,,,,,,,,,,,,,,,,,,,,,,,,,5,,,,,,,,,,,,,,,,,,,,,,,,,,,,,,,,,6,,,,,,,,,,,,,,,,,,,,,,,,,,,,,,,,,1,4.0,6.0,2.0,4.0,4.0,2.0,5.0,6.0,6.0,2.0,2.0,3.0,2.0,2.0,5.0,5.0,6.0,2.0,3.0,2.0,2.0,2.0,3.0,2.0,4.0,2.0,5.0,4.0,2.0,2.0,5.0,3.0,3,,,,,,,,,,,,,,,,,,,,,,,,,,,,,,,,,14,,,,,,,,,,,,,,,,,,,,,,,,,,,,,,,,,9,,,,,,,,,,,,,,,,,,,,,,,,,,,,,,,,,11,,,,,,,,,,,,,,,,,,,,,,,,,,,,,,,,,13,,,,,,,,,,,,,,,,,,,,,,,,,,,,,,,,,,883.26,107.24,,,,127.35,,115.06,,,,,174.75,,,141.46,,,,,,,,,,,,,,,,,,,,,209.51,,,,,,,,,,,,,,,,,,7.89,,APPROVED,Female,20.0,FALSE
288,2022-03-21 15:44:24,19,en,1961573577,2022-03-21 15:25:19,2022-03-21 15:44:24,Y,Y,-oth-,matric,,8,,,,,,,,,,,,,,,,,,,,,,,,,,,,,,,,,4,,,,,,,,,,,,,,,,,,,,,,,,,,,,,,,,,10,,,,,,,,,,,,,,,,,,,,,,,,,,,,,,,,,3,,,,,,,,,,,,,,,,,,,,,,,,,,,,,,,,,12,,,,,,,,,,,,,,,,,,,,,,,,,,,,,,,,,11,,,,,,,,,,,,,,,,,,,,,,,,,,,,,,,,,0,5.0,6.0,5.0,4.0,5.0,6.0,5.0,5.0,6.0,5.0,6.0,5.0,4.0,5.0,4.0,7.0,5.0,6.0,6.0,5.0,6.0,5.0,5.0,6.0,5.0,6.0,4.0,5.0,5.0,7.0,4.0,7.0,1,3.0,2.0,3.0,3.0,3.0,3.0,4.0,3.0,4.0,2.0,3.0,2.0,2.0,3.0,3.0,2.0,3.0,2.0,2.0,1.0,3.0,5.0,4.0,2.0,4.0,4.0,3.0,4.0,2.0,2.0,4.0,1.0,13,,,,,,,,,,,,,,,,,,,,,,,,,,,,,,,,,9,,,,,,,,,,,,,,,,,,,,,,,,,,,,,,,,,2,5.0,6.0,6.0,6.0,7.0,7.0,4.0,6.0,4.0,6.0,6.0,6.0,5.0,5.0,5.0,6.0,4.0,5.0,6.0,6.0,6.0,5.0,5.0,5.0,6.0,6.0,5.0,5.0,5.0,5.0,6.0,4.0,6,,,,,,,,,,,,,,,,,,,,,,,,,,,,,,,,,5,,,,,,,,,,,,,,,,,,,,,,,,,,,,,,,,,14,,,,,,,,,,,,,,,,,,,,,,,,,,,,,,,,,7,,,,,,,,,,,,,,,,,,,,,,,,,,,,,,,,,no comments,1147.4,99.27,,,,22.48,,597.98,,,,,,,,,,,,,,,,,,,,108.52,,,210.3,,,,,,,,,88.35,,,,,,,,,,,,,,,20.5,,APPROVED,Male,21.0,FALSE
289,2022-03-21 15:32:09,19,en,530641396,2022-03-21 15:25:21,2022-03-21 15:32:09,Y,Y,A1,,,10,,,,,,,,,,,,,,,,,,,,,,,,,,,,,,,,,2,7.0,5.0,7.0,6.0,5.0,5.0,1.0,7.0,4.0,6.0,5.0,5.0,6.0,5.0,5.0,6.0,7.0,6.0,7.0,5.0,6.0,6.0,6.0,6.0,5.0,5.0,1.0,6.0,5.0,7.0,4.0,2.0,0,6.0,7.0,6.0,7.0,7.0,6.0,1.0,7.0,7.0,6.0,6.0,5.0,6.0,5.0,6.0,6.0,7.0,7.0,7.0,7.0,5.0,6.0,6.0,7.0,7.0,3.0,5.0,5.0,5.0,7.0,5.0,3.0,7,,,,,,,,,,,,,,,,,,,,,,,,,,,,,,,,,5,,,,,,,,,,,,,,,,,,,,,,,,,,,,,,,,,14,,,,,,,,,,,,,,,,,,,,,,,,,,,,,,,,,9,,,,,,,,,,,,,,,,,,,,,,,,,,,,,,,,,8,,,,,,,,,,,,,,,,,,,,,,,,,,,,,,,,,11,,,,,,,,,,,,,,,,,,,,,,,,,,,,,,,,,1,1.0,2.0,1.0,1.0,3.0,1.0,7.0,1.0,2.0,1.0,1.0,2.0,1.0,1.0,7.0,1.0,7.0,1.0,1.0,1.0,2.0,1.0,1.0,2.0,2.0,1.0,3.0,1.0,1.0,1.0,1.0,3.0,12,,,,,,,,,,,,,,,,,,,,,,,,,,,,,,,,,13,,,,,,,,,,,,,,,,,,,,,,,,,,,,,,,,,3,,,,,,,,,,,,,,,,,,,,,,,,,,,,,,,,,4,,,,,,,,,,,,,,,,,,,,,,,,,,,,,,,,,6,,,,,,,,,,,,,,,,,,,,,,,,,,,,,,,,,,410.61,23.06,,,,5.33,,35.22,,,,,121.65,,,122.33,,,,,,,,,,,,,,,,,,,,,98.53,,,,,,,,,,,,,,,,,,4.49,,APPROVED,Female,29.0,FALSE
290,2022-03-21 15:37:44,19,en,90321376,2022-03-21 15:25:26,2022-03-21 15:37:44,Y,Y,-oth-,Matric,,14,,,,,,,,,,,,,,,,,,,,,,,,,,,,,,,,,10,,,,,,,,,,,,,,,,,,,,,,,,,,,,,,,,,1,4.0,4.0,4.0,4.0,4.0,4.0,5.0,5.0,5.0,4.0,3.0,4.0,4.0,3.0,4.0,4.0,4.0,4.0,4.0,4.0,4.0,5.0,5.0,4.0,4.0,4.0,4.0,4.0,4.0,4.0,4.0,3.0,4,,,,,,,,,,,,,,,,,,,,,,,,,,,,,,,,,3,,,,,,,,,,,,,,,,,,,,,,,,,,,,,,,,,13,,,,,,,,,,,,,,,,,,,,,,,,,,,,,,,,,8,,,,,,,,,,,,,,,,,,,,,,,,,,,,,,,,,11,,,,,,,,,,,,,,,,,,,,,,,,,,,,,,,,,6,,,,,,,,,,,,,,,,,,,,,,,,,,,,,,,,,5,,,,,,,,,,,,,,,,,,,,,,,,,,,,,,,,,12,,,,,,,,,,,,,,,,,,,,,,,,,,,,,,,,,2,5.0,6.0,4.0,4.0,4.0,4.0,3.0,4.0,5.0,4.0,4.0,5.0,4.0,4.0,5.0,4.0,6.0,5.0,4.0,4.0,3.0,5.0,3.0,4.0,4.0,4.0,5.0,4.0,3.0,4.0,4.0,5.0,7,,,,,,,,,,,,,,,,,,,,,,,,,,,,,,,,,0,5.0,5.0,3.0,4.0,3.0,4.0,4.0,5.0,4.0,4.0,3.0,4.0,3.0,4.0,5.0,3.0,5.0,5.0,4.0,4.0,3.0,4.0,4.0,4.0,4.0,4.0,4.0,4.0,3.0,3.0,5.0,7.0,9,,,,,,,,,,,,,,,,,,,,,,,,,,,,,,,,,,742.63,84.98,,,,39.61,,43.54,,,,,,,,145.79,,,,,,,,,,,,,,,,,,,,,,,,,,,171.91,,,,,,244.88,,,,,,11.92,,APPROVED,Female,30.0,FALSE
291,2022-03-21 15:30:24,19,en,1004912721,2022-03-21 15:25:26,2022-03-21 15:30:24,Y,Y,A1,,,9,,,,,,,,,,,,,,,,,,,,,,,,,,,,,,,,,5,,,,,,,,,,,,,,,,,,,,,,,,,,,,,,,,,2,7.0,7.0,6.0,2.0,7.0,7.0,5.0,7.0,7.0,7.0,7.0,5.0,7.0,7.0,7.0,7.0,7.0,5.0,7.0,7.0,5.0,6.0,2.0,7.0,6.0,1.0,5.0,7.0,7.0,7.0,2.0,3.0,1,7.0,7.0,7.0,6.0,6.0,6.0,5.0,7.0,6.0,7.0,7.0,7.0,5.0,7.0,7.0,7.0,6.0,7.0,7.0,4.0,7.0,6.0,4.0,7.0,6.0,6.0,7.0,7.0,6.0,7.0,7.0,4.0,0,6.0,1.0,5.0,2.0,3.0,1.0,7.0,1.0,2.0,2.0,3.0,7.0,5.0,7.0,7.0,3.0,7.0,5.0,6.0,1.0,6.0,6.0,1.0,4.0,2.0,6.0,7.0,6.0,2.0,2.0,3.0,5.0,3,,,,,,,,,,,,,,,,,,,,,,,,,,,,,,,,,8,,,,,,,,,,,,,,,,,,,,,,,,,,,,,,,,,14,,,,,,,,,,,,,,,,,,,,,,,,,,,,,,,,,11,,,,,,,,,,,,,,,,,,,,,,,,,,,,,,,,,13,,,,,,,,,,,,,,,,,,,,,,,,,,,,,,,,,4,,,,,,,,,,,,,,,,,,,,,,,,,,,,,,,,,7,,,,,,,,,,,,,,,,,,,,,,,,,,,,,,,,,6,,,,,,,,,,,,,,,,,,,,,,,,,,,,,,,,,10,,,,,,,,,,,,,,,,,,,,,,,,,,,,,,,,,12,,,,,,,,,,,,,,,,,,,,,,,,,,,,,,,,,,301.93,23.3,,,,5.98,,31.64,,,,,,,,87.39,,,69.82,,,80.56,,,,,,,,,,,,,,,,,,,,,,,,,,,,,,,,,3.24,,APPROVED,Male,24.0,FALSE
292,2022-03-21 15:31:31,19,en,386694,2022-03-21 15:25:29,2022-03-21 15:31:31,Y,Y,A1,,,11,,,,,,,,,,,,,,,,,,,,,,,,,,,,,,,,,7,,,,,,,,,,,,,,,,,,,,,,,,,,,,,,,,,14,,,,,,,,,,,,,,,,,,,,,,,,,,,,,,,,,2,4.0,6.0,4.0,3.0,4.0,4.0,3.0,6.0,5.0,3.0,4.0,5.0,4.0,4.0,3.0,4.0,5.0,4.0,3.0,3.0,3.0,4.0,6.0,4.0,3.0,5.0,3.0,4.0,1.0,3.0,4.0,4.0,0,4.0,5.0,2.0,5.0,3.0,3.0,6.0,6.0,6.0,3.0,3.0,5.0,4.0,4.0,5.0,3.0,5.0,2.0,3.0,2.0,2.0,3.0,3.0,3.0,2.0,3.0,2.0,3.0,2.0,3.0,3.0,5.0,4,,,,,,,,,,,,,,,,,,,,,,,,,,,,,,,,,1,5.0,6.0,3.0,4.0,5.0,3.0,4.0,4.0,6.0,3.0,3.0,3.0,3.0,4.0,6.0,3.0,5.0,3.0,5.0,2.0,3.0,4.0,3.0,4.0,5.0,3.0,4.0,4.0,3.0,4.0,3.0,7.0,10,,,,,,,,,,,,,,,,,,,,,,,,,,,,,,,,,12,,,,,,,,,,,,,,,,,,,,,,,,,,,,,,,,,3,,,,,,,,,,,,,,,,,,,,,,,,,,,,,,,,,6,,,,,,,,,,,,,,,,,,,,,,,,,,,,,,,,,9,,,,,,,,,,,,,,,,,,,,,,,,,,,,,,,,,8,,,,,,,,,,,,,,,,,,,,,,,,,,,,,,,,,13,,,,,,,,,,,,,,,,,,,,,,,,,,,,,,,,,5,,,,,,,,,,,,,,,,,,,,,,,,,,,,,,,,,,364.89,29.5,,,,10.8,,14.8,,,,,,,,,,,85.21,,,109.51,,,,,,101.02,,,,,,,,,,,,,,,,,,,,,,,,,,,14.05,,APPROVED,Female,21.0,FALSE
293,2022-03-21 15:35:30,19,en,2088738994,2022-03-21 15:25:40,2022-03-21 15:35:30,Y,Y,-oth-,high school,,7,,,,,,,,,,,,,,,,,,,,,,,,,,,,,,,,,9,,,,,,,,,,,,,,,,,,,,,,,,,,,,,,,,,14,,,,,,,,,,,,,,,,,,,,,,,,,,,,,,,,,3,,,,,,,,,,,,,,,,,,,,,,,,,,,,,,,,,5,,,,,,,,,,,,,,,,,,,,,,,,,,,,,,,,,6,,,,,,,,,,,,,,,,,,,,,,,,,,,,,,,,,1,5.0,5.0,4.0,6.0,4.0,6.0,3.0,5.0,4.0,3.0,4.0,5.0,4.0,3.0,4.0,5.0,4.0,4.0,5.0,4.0,5.0,5.0,4.0,5.0,4.0,5.0,3.0,4.0,6.0,4.0,5.0,7.0,2,2.0,5.0,4.0,2.0,4.0,1.0,6.0,2.0,5.0,3.0,2.0,4.0,2.0,3.0,2.0,1.0,3.0,3.0,4.0,2.0,3.0,2.0,2.0,2.0,3.0,1.0,6.0,3.0,2.0,3.0,1.0,1.0,13,,,,,,,,,,,,,,,,,,,,,,,,,,,,,,,,,12,,,,,,,,,,,,,,,,,,,,,,,,,,,,,,,,,8,,,,,,,,,,,,,,,,,,,,,,,,,,,,,,,,,4,,,,,,,,,,,,,,,,,,,,,,,,,,,,,,,,,11,,,,,,,,,,,,,,,,,,,,,,,,,,,,,,,,,10,,,,,,,,,,,,,,,,,,,,,,,,,,,,,,,,,0,5.0,6.0,3.0,4.0,4.0,3.0,6.0,5.0,6.0,3.0,2.0,2.0,3.0,4.0,6.0,3.0,6.0,3.0,3.0,4.0,2.0,3.0,3.0,2.0,3.0,3.0,6.0,5.0,3.0,3.0,4.0,1.0,,592.2,15.57,,,,13.46,,111.98,,,,,,,,,,,,,,,,,,,,144.76,,,144.48,,,,,,,,,,,,,,,,,,,,,157.81,,,4.14,,APPROVED,Female,19.0,FALSE
294,2022-03-21 15:32:00,19,en,453295742,2022-03-21 15:25:40,2022-03-21 15:32:00,Y,Y,A1,,,10,,,,,,,,,,,,,,,,,,,,,,,,,,,,,,,,,1,6.0,3.0,6.0,6.0,4.0,6.0,4.0,7.0,3.0,4.0,5.0,6.0,6.0,7.0,6.0,6.0,7.0,6.0,6.0,4.0,6.0,5.0,5.0,5.0,4.0,7.0,5.0,4.0,5.0,5.0,5.0,2.0,0,6.0,6.0,6.0,6.0,6.0,6.0,2.0,7.0,5.0,5.0,6.0,6.0,7.0,5.0,5.0,6.0,6.0,5.0,6.0,6.0,4.0,6.0,6.0,6.0,5.0,5.0,4.0,6.0,5.0,6.0,6.0,3.0,12,,,,,,,,,,,,,,,,,,,,,,,,,,,,,,,,,3,,,,,,,,,,,,,,,,,,,,,,,,,,,,,,,,,11,,,,,,,,,,,,,,,,,,,,,,,,,,,,,,,,,9,,,,,,,,,,,,,,,,,,,,,,,,,,,,,,,,,7,,,,,,,,,,,,,,,,,,,,,,,,,,,,,,,,,13,,,,,,,,,,,,,,,,,,,,,,,,,,,,,,,,,6,,,,,,,,,,,,,,,,,,,,,,,,,,,,,,,,,8,,,,,,,,,,,,,,,,,,,,,,,,,,,,,,,,,2,3.0,6.0,5.0,5.0,4.0,4.0,4.0,5.0,7.0,3.0,4.0,3.0,3.0,4.0,4.0,5.0,5.0,3.0,3.0,3.0,3.0,3.0,2.0,3.0,3.0,5.0,5.0,4.0,4.0,4.0,3.0,5.0,14,,,,,,,,,,,,,,,,,,,,,,,,,,,,,,,,,4,,,,,,,,,,,,,,,,,,,,,,,,,,,,,,,,,5,,,,,,,,,,,,,,,,,,,,,,,,,,,,,,,,,,382.28,18.52,,,,5.66,,28.91,,,,,102.79,,,105.2,,,,,,,,,,,,,,,,,,,,,,,,,,,116.67,,,,,,,,,,,,4.53,,APPROVED,Female,30.0,FALSE
295,2022-03-21 15:49:19,19,en,1779293400,2022-03-21 15:42:49,2022-03-21 15:49:19,Y,Y,-oth-,GDE,,10,,,,,,,,,,,,,,,,,,,,,,,,,,,,,,,,,7,,,,,,,,,,,,,,,,,,,,,,,,,,,,,,,,,14,,,,,,,,,,,,,,,,,,,,,,,,,,,,,,,,,12,,,,,,,,,,,,,,,,,,,,,,,,,,,,,,,,,9,,,,,,,,,,,,,,,,,,,,,,,,,,,,,,,,,1,7.0,7.0,7.0,6.0,7.0,5.0,3.0,7.0,7.0,7.0,7.0,7.0,6.0,7.0,7.0,7.0,7.0,7.0,7.0,5.0,7.0,6.0,5.0,7.0,7.0,6.0,4.0,7.0,7.0,6.0,7.0,6.0,11,,,,,,,,,,,,,,,,,,,,,,,,,,,,,,,,,13,,,,,,,,,,,,,,,,,,,,,,,,,,,,,,,,,3,,,,,,,,,,,,,,,,,,,,,,,,,,,,,,,,,2,2.0,1.0,1.0,2.0,1.0,1.0,7.0,1.0,4.0,2.0,2.0,1.0,1.0,1.0,2.0,2.0,5.0,1.0,1.0,1.0,1.0,2.0,2.0,1.0,1.0,3.0,5.0,1.0,7.0,3.0,4.0,3.0,6,,,,,,,,,,,,,,,,,,,,,,,,,,,,,,,,,5,,,,,,,,,,,,,,,,,,,,,,,,,,,,,,,,,0,5.0,2.0,5.0,4.0,2.0,4.0,7.0,4.0,6.0,3.0,4.0,6.0,5.0,5.0,3.0,5.0,6.0,5.0,5.0,3.0,4.0,5.0,6.0,4.0,3.0,6.0,4.0,5.0,6.0,4.0,5.0,6.0,8,,,,,,,,,,,,,,,,,,,,,,,,,,,,,,,,,4,,,,,,,,,,,,,,,,,,,,,,,,,,,,,,,,,,392.06,17.63,,,,56.4,,40.05,,,,,,,,,,,,,,,,,90.98,,,,,,,,,,,,90.23,,,,,,,,,93.58,,,,,,,,,3.19,,APPROVED,Male,31.0,FALSE
296,2022-03-21 16:06:04,19,en,501707771,2022-03-21 15:58:18,2022-03-21 16:06:04,Y,Y,A1,,,8,,,,,,,,,,,,,,,,,,,,,,,,,,,,,,,,,13,,,,,,,,,,,,,,,,,,,,,,,,,,,,,,,,,5,,,,,,,,,,,,,,,,,,,,,,,,,,,,,,,,,6,,,,,,,,,,,,,,,,,,,,,,,,,,,,,,,,,0,4.0,3.0,3.0,4.0,5.0,2.0,4.0,6.0,5.0,4.0,5.0,4.0,4.0,3.0,4.0,5.0,3.0,4.0,5.0,3.0,4.0,4.0,6.0,4.0,5.0,6.0,3.0,5.0,6.0,4.0,5.0,5.0,3,,,,,,,,,,,,,,,,,,,,,,,,,,,,,,,,,11,,,,,,,,,,,,,,,,,,,,,,,,,,,,,,,,,14,,,,,,,,,,,,,,,,,,,,,,,,,,,,,,,,,10,,,,,,,,,,,,,,,,,,,,,,,,,,,,,,,,,12,,,,,,,,,,,,,,,,,,,,,,,,,,,,,,,,,1,3.0,5.0,4.0,2.0,3.0,2.0,4.0,5.0,4.0,4.0,2.0,3.0,3.0,2.0,3.0,3.0,5.0,3.0,4.0,3.0,3.0,4.0,3.0,3.0,3.0,2.0,3.0,3.0,5.0,5.0,3.0,4.0,4,,,,,,,,,,,,,,,,,,,,,,,,,,,,,,,,,9,,,,,,,,,,,,,,,,,,,,,,,,,,,,,,,,,2,6.0,6.0,6.0,7.0,6.0,7.0,1.0,6.0,6.0,6.0,5.0,5.0,6.0,7.0,7.0,7.0,6.0,6.0,6.0,5.0,5.0,7.0,6.0,5.0,6.0,7.0,6.0,6.0,7.0,5.0,6.0,7.0,7,,,,,,,,,,,,,,,,,,,,,,,,,,,,,,,,,None,470.64,97.35,,,,7.81,,64.54,,,,,,,,,,,,,,101.91,,,,,,,,,,,,,,,,,,106.91,,,,,,,,,83.31,,,,,,8.81,,APPROVED,Male,25.0,FALSE
297,2022-03-21 16:16:29,19,en,1981696327,2022-03-21 16:04:15,2022-03-21 16:16:29,Y,Y,A3,,,9,,,,,,,,,,,,,,,,,,,,,,,,,,,,,,,,,2,7.0,4.0,7.0,6.0,6.0,7.0,1.0,7.0,5.0,6.0,6.0,6.0,7.0,7.0,6.0,7.0,7.0,7.0,7.0,7.0,7.0,7.0,6.0,7.0,7.0,7.0,6.0,7.0,6.0,7.0,7.0,2.0,10,,,,,,,,,,,,,,,,,,,,,,,,,,,,,,,,,5,,,,,,,,,,,,,,,,,,,,,,,,,,,,,,,,,1,6.0,5.0,6.0,4.0,6.0,5.0,1.0,6.0,6.0,5.0,3.0,6.0,6.0,6.0,5.0,6.0,6.0,6.0,6.0,6.0,6.0,6.0,5.0,6.0,6.0,6.0,6.0,4.0,6.0,5.0,6.0,5.0,13,,,,,,,,,,,,,,,,,,,,,,,,,,,,,,,,,12,,,,,,,,,,,,,,,,,,,,,,,,,,,,,,,,,0,2.0,4.0,1.0,2.0,2.0,5.0,4.0,2.0,4.0,2.0,2.0,2.0,2.0,2.0,2.0,3.0,5.0,2.0,2.0,2.0,2.0,2.0,5.0,2.0,1.0,3.0,4.0,3.0,2.0,2.0,1.0,1.0,3,,,,,,,,,,,,,,,,,,,,,,,,,,,,,,,,,7,,,,,,,,,,,,,,,,,,,,,,,,,,,,,,,,,6,,,,,,,,,,,,,,,,,,,,,,,,,,,,,,,,,14,,,,,,,,,,,,,,,,,,,,,,,,,,,,,,,,,4,,,,,,,,,,,,,,,,,,,,,,,,,,,,,,,,,8,,,,,,,,,,,,,,,,,,,,,,,,,,,,,,,,,11,,,,,,,,,,,,,,,,,,,,,,,,,,,,,,,,,,737.05,101.78,,,,6.55,,73.99,,,,,160.14,,,,,,,,,143.33,,,,,,,,,244.83,,,,,,,,,,,,,,,,,,,,,,,,6.43,,APPROVED,Female,35.0,FALSE
298,2022-03-21 16:17:15,19,en,1035902304,2022-03-21 16:05:44,2022-03-21 16:17:15,Y,Y,A2,,,14,,,,,,,,,,,,,,,,,,,,,,,,,,,,,,,,,9,,,,,,,,,,,,,,,,,,,,,,,,,,,,,,,,,13,,,,,,,,,,,,,,,,,,,,,,,,,,,,,,,,,0,5.0,5.0,5.0,4.0,6.0,5.0,5.0,5.0,5.0,4.0,5.0,5.0,5.0,5.0,6.0,4.0,6.0,4.0,5.0,5.0,4.0,6.0,4.0,6.0,5.0,6.0,6.0,5.0,6.0,5.0,4.0,4.0,10,,,,,,,,,,,,,,,,,,,,,,,,,,,,,,,,,11,,,,,,,,,,,,,,,,,,,,,,,,,,,,,,,,,6,,,,,,,,,,,,,,,,,,,,,,,,,,,,,,,,,3,,,,,,,,,,,,,,,,,,,,,,,,,,,,,,,,,7,,,,,,,,,,,,,,,,,,,,,,,,,,,,,,,,,5,,,,,,,,,,,,,,,,,,,,,,,,,,,,,,,,,12,,,,,,,,,,,,,,,,,,,,,,,,,,,,,,,,,1,5.0,4.0,4.0,6.0,5.0,6.0,4.0,5.0,4.0,4.0,5.0,5.0,4.0,4.0,4.0,4.0,4.0,5.0,4.0,5.0,5.0,4.0,5.0,5.0,5.0,5.0,4.0,4.0,5.0,4.0,4.0,5.0,4,,,,,,,,,,,,,,,,,,,,,,,,,,,,,,,,,2,5.0,4.0,5.0,6.0,5.0,5.0,4.0,6.0,5.0,5.0,5.0,5.0,5.0,6.0,5.0,6.0,5.0,5.0,5.0,5.0,4.0,5.0,6.0,5.0,5.0,5.0,6.0,6.0,5.0,5.0,5.0,7.0,8,,,,,,,,,,,,,,,,,,,,,,,,,,,,,,,,,,694.35,95.3,,,,4.66,,176.34,,,,,,,,,,,157.88,,,,,,,,,,,,,,,,,,,,,,,,121.41,,,,,,131.73,,,,,,7.03,,APPROVED,Male,38.0,FALSE
300,2022-03-21 22:07:26,19,en,675818166,2022-03-21 19:45:53,2022-03-21 22:07:26,Y,Y,A2,,,5,,,,,,,,,,,,,,,,,,,,,,,,,,,,,,,,,12,,,,,,,,,,,,,,,,,,,,,,,,,,,,,,,,,10,,,,,,,,,,,,,,,,,,,,,,,,,,,,,,,,,2,4.0,4.0,4.0,4.0,4.0,4.0,4.0,5.0,4.0,4.0,4.0,4.0,4.0,4.0,4.0,4.0,4.0,4.0,4.0,4.0,4.0,4.0,4.0,4.0,4.0,5.0,4.0,4.0,4.0,4.0,4.0,4.0,1,4.0,4.0,4.0,4.0,4.0,4.0,4.0,4.0,4.0,4.0,4.0,4.0,4.0,4.0,4.0,4.0,4.0,4.0,4.0,4.0,4.0,4.0,5.0,4.0,4.0,5.0,4.0,4.0,4.0,4.0,5.0,5.0,8,,,,,,,,,,,,,,,,,,,,,,,,,,,,,,,,,11,,,,,,,,,,,,,,,,,,,,,,,,,,,,,,,,,7,,,,,,,,,,,,,,,,,,,,,,,,,,,,,,,,,6,,,,,,,,,,,,,,,,,,,,,,,,,,,,,,,,,14,,,,,,,,,,,,,,,,,,,,,,,,,,,,,,,,,9,,,,,,,,,,,,,,,,,,,,,,,,,,,,,,,,,3,,,,,,,,,,,,,,,,,,,,,,,,,,,,,,,,,4,,,,,,,,,,,,,,,,,,,,,,,,,,,,,,,,,0,4.0,4.0,4.0,4.0,4.0,4.0,4.0,4.0,4.0,2.0,4.0,4.0,4.0,2.0,4.0,2.0,5.0,4.0,4.0,4.0,4.0,4.0,5.0,4.0,4.0,5.0,4.0,2.0,2.0,4.0,5.0,7.0,13,,,,,,,,,,,,,,,,,,,,,,,,,,,,,,,,,,482.27,179.75,,,,9.29,,21.51,,,,,,,,,,,90.38,,,74.44,,,,,,,,,,,,,,,,,,,,,,,,,,,98.23,,,,,,8.67,,RETURNED,CONSENT REVOKED,46.0,FALSE
305,2022-03-21 23:51:23,19,en,121037843,2022-03-21 23:38:57,2022-03-21 23:51:23,Y,Y,A2,,,9,,,,,,,,,,,,,,,,,,,,,,,,,,,,,,,,,1,2.0,2.0,3.0,5.0,3.0,6.0,4.0,6.0,2.0,4.0,4.0,4.0,2.0,3.0,3.0,4.0,2.0,2.0,2.0,3.0,2.0,4.0,6.0,4.0,4.0,6.0,2.0,4.0,1.0,2.0,2.0,2.0,7,,,,,,,,,,,,,,,,,,,,,,,,,,,,,,,,,0,6.0,6.0,7.0,5.0,6.0,7.0,7.0,4.0,7.0,4.0,5.0,6.0,7.0,6.0,5.0,5.0,7.0,6.0,7.0,4.0,6.0,6.0,6.0,6.0,7.0,7.0,2.0,7.0,7.0,5.0,7.0,4.0,4,,,,,,,,,,,,,,,,,,,,,,,,,,,,,,,,,8,,,,,,,,,,,,,,,,,,,,,,,,,,,,,,,,,5,,,,,,,,,,,,,,,,,,,,,,,,,,,,,,,,,3,,,,,,,,,,,,,,,,,,,,,,,,,,,,,,,,,14,,,,,,,,,,,,,,,,,,,,,,,,,,,,,,,,,10,,,,,,,,,,,,,,,,,,,,,,,,,,,,,,,,,11,,,,,,,,,,,,,,,,,,,,,,,,,,,,,,,,,12,,,,,,,,,,,,,,,,,,,,,,,,,,,,,,,,,2,5.0,6.0,6.0,2.0,6.0,2.0,6.0,4.0,6.0,4.0,5.0,5.0,5.0,5.0,5.0,4.0,6.0,6.0,5.0,6.0,5.0,6.0,3.0,5.0,6.0,4.0,5.0,5.0,6.0,4.0,2.0,6.0,6,,,,,,,,,,,,,,,,,,,,,,,,,,,,,,,,,13,,,,,,,,,,,,,,,,,,,,,,,,,,,,,,,,,,750.05,33.67,,,,6.07,,83.77,,,,,142.93,,,,,,310.34,,,,,,,,,,,,,,,,,,,,,,,,,,,168.89,,,,,,,,,4.38,,APPROVED,Female,32.0,FALSE
306,2022-03-21 23:47:30,19,en,1989861576,2022-03-21 23:39:09,2022-03-21 23:47:30,Y,Y,A1,,,10,,,,,,,,,,,,,,,,,,,,,,,,,,,,,,,,,0,5.0,3.0,6.0,6.0,2.0,6.0,5.0,6.0,5.0,2.0,5.0,5.0,4.0,2.0,2.0,6.0,5.0,5.0,5.0,6.0,3.0,6.0,6.0,6.0,4.0,6.0,2.0,6.0,2.0,7.0,5.0,2.0,5,,,,,,,,,,,,,,,,,,,,,,,,,,,,,,,,,3,,,,,,,,,,,,,,,,,,,,,,,,,,,,,,,,,6,,,,,,,,,,,,,,,,,,,,,,,,,,,,,,,,,13,,,,,,,,,,,,,,,,,,,,,,,,,,,,,,,,,12,,,,,,,,,,,,,,,,,,,,,,,,,,,,,,,,,1,1.0,1.0,1.0,4.0,1.0,2.0,7.0,1.0,1.0,1.0,1.0,1.0,1.0,1.0,1.0,1.0,2.0,1.0,1.0,1.0,1.0,1.0,4.0,1.0,1.0,2.0,3.0,1.0,1.0,3.0,1.0,1.0,9,,,,,,,,,,,,,,,,,,,,,,,,,,,,,,,,,11,,,,,,,,,,,,,,,,,,,,,,,,,,,,,,,,,14,,,,,,,,,,,,,,,,,,,,,,,,,,,,,,,,,2,6.0,5.0,6.0,4.0,6.0,3.0,1.0,6.0,6.0,5.0,5.0,6.0,6.0,5.0,6.0,6.0,7.0,6.0,6.0,5.0,5.0,6.0,5.0,7.0,6.0,5.0,5.0,6.0,6.0,6.0,4.0,5.0,7,,,,,,,,,,,,,,,,,,,,,,,,,,,,,,,,,8,,,,,,,,,,,,,,,,,,,,,,,,,,,,,,,,,4,,,,,,,,,,,,,,,,,,,,,,,,,,,,,,,,,,502.81,17.58,,,,10.16,,28.71,,,,,184.77,,,,,,,,,,,,,,,,,,126.86,,,,,,,,,,,,131.55,,,,,,,,,,,,3.18,,APPROVED,Female,40.0,FALSE
307,2022-03-21 23:48:25,19,en,1577045435,2022-03-21 23:39:16,2022-03-21 23:48:24,Y,Y,A1,,,10,,,,,,,,,,,,,,,,,,,,,,,,,,,,,,,,,2,5.0,2.0,3.0,4.0,4.0,6.0,2.0,5.0,3.0,3.0,4.0,4.0,4.0,3.0,3.0,5.0,5.0,4.0,5.0,3.0,4.0,5.0,6.0,5.0,4.0,6.0,2.0,4.0,2.0,4.0,6.0,2.0,4,,,,,,,,,,,,,,,,,,,,,,,,,,,,,,,,,12,,,,,,,,,,,,,,,,,,,,,,,,,,,,,,,,,13,,,,,,,,,,,,,,,,,,,,,,,,,,,,,,,,,9,,,,,,,,,,,,,,,,,,,,,,,,,,,,,,,,,3,,,,,,,,,,,,,,,,,,,,,,,,,,,,,,,,,0,5.0,5.0,4.0,4.0,4.0,2.0,6.0,3.0,2.0,3.0,2.0,6.0,3.0,4.0,6.0,2.0,6.0,2.0,5.0,4.0,5.0,3.0,2.0,2.0,4.0,1.0,5.0,5.0,2.0,2.0,2.0,1.0,8,,,,,,,,,,,,,,,,,,,,,,,,,,,,,,,,,5,,,,,,,,,,,,,,,,,,,,,,,,,,,,,,,,,1,6.0,6.0,6.0,6.0,6.0,6.0,2.0,6.0,6.0,6.0,6.0,6.0,6.0,6.0,6.0,6.0,6.0,6.0,6.0,6.0,6.0,6.0,6.0,6.0,6.0,6.0,2.0,6.0,6.0,6.0,6.0,4.0,6,,,,,,,,,,,,,,,,,,,,,,,,,,,,,,,,,14,,,,,,,,,,,,,,,,,,,,,,,,,,,,,,,,,11,,,,,,,,,,,,,,,,,,,,,,,,,,,,,,,,,7,,,,,,,,,,,,,,,,,,,,,,,,,,,,,,,,,,439.28,17.37,,,,44.4,,53.16,,,,,136.82,,,,,,,,,,,,,,,,,,127.46,,,,,,,,,53.07,,,,,,,,,,,,,,,7.0,,APPROVED,Male,20.0,FALSE
309,2022-03-21 23:43:38,19,en,285079971,2022-03-21 23:39:20,2022-03-21 23:43:37,Y,Y,A2,,,5,,,,,,,,,,,,,,,,,,,,,,,,,,,,,,,,,0,5.0,3.0,6.0,6.0,5.0,6.0,2.0,5.0,4.0,6.0,5.0,5.0,5.0,3.0,5.0,6.0,5.0,4.0,4.0,4.0,4.0,6.0,6.0,6.0,6.0,6.0,2.0,5.0,6.0,4.0,5.0,2.0,8,,,,,,,,,,,,,,,,,,,,,,,,,,,,,,,,,11,,,,,,,,,,,,,,,,,,,,,,,,,,,,,,,,,3,,,,,,,,,,,,,,,,,,,,,,,,,,,,,,,,,13,,,,,,,,,,,,,,,,,,,,,,,,,,,,,,,,,7,,,,,,,,,,,,,,,,,,,,,,,,,,,,,,,,,1,1.0,1.0,1.0,1.0,1.0,1.0,6.0,2.0,1.0,1.0,1.0,1.0,1.0,1.0,1.0,1.0,1.0,1.0,1.0,1.0,1.0,1.0,1.0,1.0,1.0,1.0,4.0,1.0,1.0,1.0,1.0,1.0,14,,,,,,,,,,,,,,,,,,,,,,,,,,,,,,,,,2,2.0,3.0,2.0,2.0,2.0,2.0,7.0,1.0,2.0,2.0,1.0,2.0,2.0,1.0,2.0,2.0,2.0,2.0,2.0,1.0,1.0,1.0,2.0,1.0,1.0,2.0,1.0,2.0,2.0,2.0,1.0,3.0,6,,,,,,,,,,,,,,,,,,,,,,,,,,,,,,,,,12,,,,,,,,,,,,,,,,,,,,,,,,,,,,,,,,,9,,,,,,,,,,,,,,,,,,,,,,,,,,,,,,,,,10,,,,,,,,,,,,,,,,,,,,,,,,,,,,,,,,,4,,,,,,,,,,,,,,,,,,,,,,,,,,,,,,,,,,259.02,30.25,,,,7.02,,27.24,,,,,80.29,,,,,,,,,,,,,,,,,,45.26,,,,,,62.11,,,,,,,,,,,,,,,,,,6.85,,RETURNED,CONSENT REVOKED,24.0,FALSE
311,2022-03-21 23:49:34,19,en,1670514793,2022-03-21 23:39:27,2022-03-21 23:49:33,Y,Y,A2,,,4,,,,,,,,,,,,,,,,,,,,,,,,,,,,,,,,,5,,,,,,,,,,,,,,,,,,,,,,,,,,,,,,,,,7,,,,,,,,,,,,,,,,,,,,,,,,,,,,,,,,,10,,,,,,,,,,,,,,,,,,,,,,,,,,,,,,,,,14,,,,,,,,,,,,,,,,,,,,,,,,,,,,,,,,,12,,,,,,,,,,,,,,,,,,,,,,,,,,,,,,,,,2,2.0,3.0,1.0,4.0,2.0,2.0,5.0,6.0,3.0,3.0,1.0,5.0,2.0,5.0,3.0,2.0,5.0,3.0,2.0,2.0,2.0,3.0,5.0,2.0,1.0,5.0,5.0,3.0,2.0,2.0,5.0,7.0,3,,,,,,,,,,,,,,,,,,,,,,,,,,,,,,,,,8,,,,,,,,,,,,,,,,,,,,,,,,,,,,,,,,,9,,,,,,,,,,,,,,,,,,,,,,,,,,,,,,,,,11,,,,,,,,,,,,,,,,,,,,,,,,,,,,,,,,,6,,,,,,,,,,,,,,,,,,,,,,,,,,,,,,,,,1,6.0,6.0,6.0,5.0,6.0,6.0,3.0,3.0,6.0,5.0,5.0,4.0,7.0,6.0,6.0,6.0,6.0,5.0,6.0,5.0,4.0,6.0,6.0,6.0,5.0,6.0,4.0,6.0,6.0,5.0,6.0,6.0,13,,,,,,,,,,,,,,,,,,,,,,,,,,,,,,,,,0,3.0,5.0,2.0,3.0,6.0,5.0,6.0,5.0,4.0,2.0,6.0,3.0,3.0,3.0,3.0,2.0,5.0,5.0,3.0,1.0,3.0,3.0,3.0,3.0,5.0,5.0,5.0,3.0,6.0,4.0,6.0,1.0,,607.98,24.39,,,,9.34,,87.6,,,,,,,,,,,,,,,,,,,,154.41,,,,,,,,,,,,,,,,,,110.94,,,,,,217.3,,,4.0,,APPROVED,Male,24.0,FALSE
312,2022-03-21 23:46:03,19,en,1556571049,2022-03-21 23:39:30,2022-03-21 23:46:03,Y,Y,A2,,,4,,,,,,,,,,,,,,,,,,,,,,,,,,,,,,,,,14,,,,,,,,,,,,,,,,,,,,,,,,,,,,,,,,,5,,,,,,,,,,,,,,,,,,,,,,,,,,,,,,,,,13,,,,,,,,,,,,,,,,,,,,,,,,,,,,,,,,,6,,,,,,,,,,,,,,,,,,,,,,,,,,,,,,,,,1,4.0,5.0,5.0,5.0,4.0,3.0,5.0,5.0,4.0,4.0,5.0,4.0,5.0,4.0,5.0,5.0,3.0,5.0,5.0,4.0,5.0,5.0,4.0,4.0,5.0,5.0,3.0,4.0,5.0,5.0,4.0,6.0,12,,,,,,,,,,,,,,,,,,,,,,,,,,,,,,,,,11,,,,,,,,,,,,,,,,,,,,,,,,,,,,,,,,,8,,,,,,,,,,,,,,,,,,,,,,,,,,,,,,,,,9,,,,,,,,,,,,,,,,,,,,,,,,,,,,,,,,,10,,,,,,,,,,,,,,,,,,,,,,,,,,,,,,,,,2,6.0,6.0,6.0,6.0,6.0,5.0,2.0,6.0,5.0,6.0,6.0,6.0,6.0,6.0,6.0,6.0,6.0,6.0,6.0,6.0,6.0,6.0,6.0,6.0,6.0,6.0,4.0,6.0,6.0,6.0,6.0,5.0,0,5.0,6.0,5.0,4.0,5.0,3.0,6.0,3.0,6.0,4.0,5.0,4.0,5.0,5.0,5.0,5.0,6.0,3.0,4.0,5.0,4.0,5.0,2.0,5.0,5.0,3.0,4.0,5.0,6.0,5.0,4.0,6.0,3,,,,,,,,,,,,,,,,,,,,,,,,,,,,,,,,,7,,,,,,,,,,,,,,,,,,,,,,,,,,,,,,,,,,393.32,16.0,,,,3.1,,167.97,,,,,,,,,,,,,,,,,60.05,,,,,,,,,,,,,,,,,,58.18,,,85.22,,,,,,,,,2.8,,APPROVED,Male,23.0,FALSE
313,2022-03-21 23:41:58,19,en,535165182,2022-03-21 23:39:36,2022-03-21 23:41:58,Y,Y,A1,,,12,,,,,,,,,,,,,,,,,,,,,,,,,,,,,,,,,1,4.0,3.0,5.0,3.0,4.0,4.0,3.0,4.0,3.0,5.0,5.0,5.0,5.0,5.0,4.0,5.0,3.0,4.0,4.0,3.0,5.0,4.0,5.0,5.0,4.0,4.0,5.0,4.0,5.0,4.0,5.0,2.0,6,,,,,,,,,,,,,,,,,,,,,,,,,,,,,,,,,5,,,,,,,,,,,,,,,,,,,,,,,,,,,,,,,,,0,2.0,4.0,2.0,3.0,2.0,2.0,2.0,3.0,3.0,2.0,3.0,2.0,2.0,2.0,2.0,1.0,2.0,1.0,2.0,2.0,3.0,2.0,2.0,2.0,2.0,1.0,4.0,2.0,3.0,3.0,2.0,5.0,9,,,,,,,,,,,,,,,,,,,,,,,,,,,,,,,,,7,,,,,,,,,,,,,,,,,,,,,,,,,,,,,,,,,2,3.0,3.0,2.0,2.0,3.0,2.0,3.0,3.0,2.0,3.0,3.0,3.0,3.0,2.0,3.0,2.0,3.0,2.0,3.0,3.0,3.0,3.0,2.0,3.0,3.0,3.0,2.0,2.0,2.0,3.0,1.0,1.0,14,,,,,,,,,,,,,,,,,,,,,,,,,,,,,,,,,10,,,,,,,,,,,,,,,,,,,,,,,,,,,,,,,,,8,,,,,,,,,,,,,,,,,,,,,,,,,,,,,,,,,4,,,,,,,,,,,,,,,,,,,,,,,,,,,,,,,,,11,,,,,,,,,,,,,,,,,,,,,,,,,,,,,,,,,13,,,,,,,,,,,,,,,,,,,,,,,,,,,,,,,,,3,,,,,,,,,,,,,,,,,,,,,,,,,,,,,,,,,nope,144.38,17.04,,,,6.89,,16.67,,,,,33.32,,,,,,,,,41.65,,,,,,,,,24.24,,,,,,,,,,,,,,,,,,,,,,,,4.57,,APPROVED,Male,21.0,FALSE
314,2022-03-21 23:47:35,19,en,989907548,2022-03-21 23:39:37,2022-03-21 23:47:35,Y,Y,A2,,,7,,,,,,,,,,,,,,,,,,,,,,,,,,,,,,,,,9,,,,,,,,,,,,,,,,,,,,,,,,,,,,,,,,,13,,,,,,,,,,,,,,,,,,,,,,,,,,,,,,,,,10,,,,,,,,,,,,,,,,,,,,,,,,,,,,,,,,,2,4.0,3.0,6.0,6.0,2.0,3.0,6.0,7.0,5.0,3.0,4.0,5.0,6.0,6.0,3.0,5.0,6.0,2.0,4.0,4.0,1.0,7.0,5.0,2.0,4.0,3.0,1.0,3.0,3.0,2.0,3.0,5.0,12,,,,,,,,,,,,,,,,,,,,,,,,,,,,,,,,,3,,,,,,,,,,,,,,,,,,,,,,,,,,,,,,,,,6,,,,,,,,,,,,,,,,,,,,,,,,,,,,,,,,,1,1.0,6.0,2.0,5.0,1.0,6.0,6.0,1.0,6.0,3.0,3.0,1.0,1.0,1.0,2.0,1.0,5.0,2.0,2.0,2.0,1.0,4.0,5.0,5.0,4.0,3.0,1.0,2.0,3.0,2.0,2.0,2.0,5,,,,,,,,,,,,,,,,,,,,,,,,,,,,,,,,,4,,,,,,,,,,,,,,,,,,,,,,,,,,,,,,,,,8,,,,,,,,,,,,,,,,,,,,,,,,,,,,,,,,,11,,,,,,,,,,,,,,,,,,,,,,,,,,,,,,,,,0,5.0,6.0,1.0,5.0,1.0,5.0,6.0,4.0,2.0,3.0,2.0,3.0,2.0,2.0,3.0,3.0,5.0,3.0,5.0,2.0,2.0,5.0,6.0,2.0,2.0,2.0,1.0,3.0,2.0,1.0,6.0,7.0,14,,,,,,,,,,,,,,,,,,,,,,,,,,,,,,,,,,351.82,32.19,,,,6.22,,32.4,,,,,,,,,,,,,,77.98,,,,,,,,,,,,86.97,,,,,,,,,,,,,,,112.73,,,,,,3.33,,APPROVED,Female,24.0,FALSE
316,2022-03-21 23:47:04,19,en,1377855958,2022-03-21 23:39:40,2022-03-21 23:47:04,Y,Y,A3,,,7,,,,,,,,,,,,,,,,,,,,,,,,,,,,,,,,,4,,,,,,,,,,,,,,,,,,,,,,,,,,,,,,,,,9,,,,,,,,,,,,,,,,,,,,,,,,,,,,,,,,,12,,,,,,,,,,,,,,,,,,,,,,,,,,,,,,,,,2,6.0,5.0,5.0,4.0,4.0,3.0,4.0,6.0,5.0,5.0,5.0,5.0,6.0,6.0,6.0,5.0,6.0,4.0,5.0,5.0,5.0,6.0,6.0,5.0,4.0,6.0,3.0,4.0,7.0,5.0,6.0,5.0,11,,,,,,,,,,,,,,,,,,,,,,,,,,,,,,,,,1,5.0,6.0,4.0,6.0,3.0,5.0,4.0,4.0,6.0,5.0,5.0,3.0,4.0,4.0,5.0,5.0,5.0,4.0,5.0,4.0,3.0,5.0,5.0,3.0,5.0,5.0,2.0,4.0,6.0,3.0,4.0,7.0,13,,,,,,,,,,,,,,,,,,,,,,,,,,,,,,,,,6,,,,,,,,,,,,,,,,,,,,,,,,,,,,,,,,,0,4.0,6.0,3.0,2.0,2.0,1.0,7.0,1.0,6.0,3.0,2.0,3.0,2.0,3.0,4.0,2.0,4.0,2.0,4.0,2.0,2.0,3.0,3.0,4.0,3.0,4.0,5.0,2.0,6.0,2.0,3.0,3.0,3,,,,,,,,,,,,,,,,,,,,,,,,,,,,,,,,,10,,,,,,,,,,,,,,,,,,,,,,,,,,,,,,,,,8,,,,,,,,,,,,,,,,,,,,,,,,,,,,,,,,,14,,,,,,,,,,,,,,,,,,,,,,,,,,,,,,,,,5,,,,,,,,,,,,,,,,,,,,,,,,,,,,,,,,,,446.32,13.61,,,,12.19,,27.39,,,,,,,,,,,,,,177.63,,,,,,66.0,,,,,,,,,78.11,,,,,,,,,,,,,,,,,,71.39,,APPROVED,Male,22.0,FALSE
318,2022-03-21 23:48:58,19,en,1671367214,2022-03-21 23:39:52,2022-03-21 23:48:58,Y,Y,-oth-,high school,,13,,,,,,,,,,,,,,,,,,,,,,,,,,,,,,,,,9,,,,,,,,,,,,,,,,,,,,,,,,,,,,,,,,,4,,,,,,,,,,,,,,,,,,,,,,,,,,,,,,,,,6,,,,,,,,,,,,,,,,,,,,,,,,,,,,,,,,,10,,,,,,,,,,,,,,,,,,,,,,,,,,,,,,,,,1,5.0,5.0,2.0,4.0,3.0,3.0,6.0,6.0,5.0,3.0,3.0,5.0,5.0,4.0,4.0,4.0,6.0,3.0,4.0,3.0,4.0,3.0,4.0,3.0,2.0,6.0,1.0,4.0,6.0,4.0,4.0,6.0,3,,,,,,,,,,,,,,,,,,,,,,,,,,,,,,,,,5,,,,,,,,,,,,,,,,,,,,,,,,,,,,,,,,,7,,,,,,,,,,,,,,,,,,,,,,,,,,,,,,,,,12,,,,,,,,,,,,,,,,,,,,,,,,,,,,,,,,,8,,,,,,,,,,,,,,,,,,,,,,,,,,,,,,,,,2,7.0,7.0,7.0,5.0,6.0,5.0,3.0,3.0,6.0,7.0,6.0,5.0,7.0,7.0,7.0,5.0,7.0,7.0,7.0,7.0,6.0,7.0,5.0,6.0,7.0,5.0,2.0,7.0,5.0,4.0,7.0,5.0,14,,,,,,,,,,,,,,,,,,,,,,,,,,,,,,,,,11,,,,,,,,,,,,,,,,,,,,,,,,,,,,,,,,,0,3.0,5.0,2.0,4.0,3.0,4.0,5.0,4.0,5.0,2.0,3.0,4.0,4.0,3.0,5.0,3.0,6.0,4.0,4.0,3.0,2.0,2.0,3.0,3.0,3.0,4.0,4.0,5.0,7.0,3.0,4.0,1.0,,549.23,8.78,,,,42.3,,77.24,,,,,,,,,,,,,,,,,270.2,,,,,,,,,,,,,,,,,,62.87,,,,,,,,,81.18,,,6.66,,APPROVED,Male,22.0,FALSE
321,2022-03-21 23:45:30,19,en,1417374879,2022-03-21 23:40:08,2022-03-21 23:45:30,Y,Y,A1,,,8,,,,,,,,,,,,,,,,,,,,,,,,,,,,,,,,,3,,,,,,,,,,,,,,,,,,,,,,,,,,,,,,,,,11,,,,,,,,,,,,,,,,,,,,,,,,,,,,,,,,,5,,,,,,,,,,,,,,,,,,,,,,,,,,,,,,,,,7,,,,,,,,,,,,,,,,,,,,,,,,,,,,,,,,,0,5.0,5.0,5.0,5.0,5.0,3.0,5.0,6.0,5.0,5.0,5.0,5.0,6.0,5.0,5.0,6.0,5.0,5.0,5.0,6.0,5.0,6.0,5.0,5.0,6.0,6.0,5.0,6.0,5.0,5.0,7.0,6.0,10,,,,,,,,,,,,,,,,,,,,,,,,,,,,,,,,,13,,,,,,,,,,,,,,,,,,,,,,,,,,,,,,,,,4,,,,,,,,,,,,,,,,,,,,,,,,,,,,,,,,,2,2.0,5.0,2.0,4.0,2.0,3.0,3.0,6.0,5.0,5.0,4.0,2.0,2.0,2.0,3.0,2.0,3.0,2.0,3.0,2.0,2.0,3.0,5.0,3.0,5.0,6.0,3.0,4.0,2.0,2.0,5.0,3.0,14,,,,,,,,,,,,,,,,,,,,,,,,,,,,,,,,,1,5.0,6.0,2.0,3.0,2.0,4.0,3.0,6.0,4.0,5.0,3.0,4.0,3.0,4.0,2.0,4.0,5.0,2.0,5.0,2.0,5.0,2.0,4.0,4.0,3.0,7.0,4.0,3.0,4.0,5.0,4.0,5.0,12,,,,,,,,,,,,,,,,,,,,,,,,,,,,,,,,,9,,,,,,,,,,,,,,,,,,,,,,,,,,,,,,,,,6,,,,,,,,,,,,,,,,,,,,,,,,,,,,,,,,,,324.95,16.77,,,,12.58,,71.17,,,,,,,,,,,,,,,,,65.48,,,,,,,,,,,,101.47,,,,,,54.88,,,,,,,,,,,,2.6,,APPROVED,Male,20.0,FALSE
322,2022-03-21 23:45:44,19,en,798441524,2022-03-21 23:40:09,2022-03-21 23:45:44,Y,Y,-oth-,Some college,,3,,,,,,,,,,,,,,,,,,,,,,,,,,,,,,,,,2,6.0,6.0,6.0,6.0,5.0,6.0,5.0,7.0,6.0,6.0,6.0,5.0,5.0,5.0,6.0,6.0,5.0,6.0,6.0,4.0,6.0,5.0,6.0,5.0,5.0,6.0,4.0,6.0,6.0,2.0,7.0,2.0,4,,,,,,,,,,,,,,,,,,,,,,,,,,,,,,,,,7,,,,,,,,,,,,,,,,,,,,,,,,,,,,,,,,,11,,,,,,,,,,,,,,,,,,,,,,,,,,,,,,,,,6,,,,,,,,,,,,,,,,,,,,,,,,,,,,,,,,,5,,,,,,,,,,,,,,,,,,,,,,,,,,,,,,,,,9,,,,,,,,,,,,,,,,,,,,,,,,,,,,,,,,,2,1.0,5.0,1.0,1.0,1.0,1.0,1.0,1.0,1.0,1.0,1.0,4.0,1.0,1.0,1.0,1.0,1.0,1.0,1.0,1.0,1.0,1.0,4.0,1.0,1.0,1.0,3.0,1.0,2.0,1.0,1.0,2.0,14,,,,,,,,,,,,,,,,,,,,,,,,,,,,,,,,,13,,,,,,,,,,,,,,,,,,,,,,,,,,,,,,,,,0,6.0,7.0,4.0,5.0,5.0,5.0,4.0,5.0,6.0,5.0,6.0,5.0,4.0,5.0,6.0,5.0,6.0,5.0,6.0,5.0,6.0,6.0,4.0,5.0,4.0,5.0,6.0,6.0,5.0,4.0,6.0,5.0,8,,,,,,,,,,,,,,,,,,,,,,,,,,,,,,,,,12,,,,,,,,,,,,,,,,,,,,,,,,,,,,,,,,,10,,,,,,,,,,,,,,,,,,,,,,,,,,,,,,,,,,394.51,55.04,,,,19.41,,28.91,,,,,148.58,,,,,,,,,,,,,,,,,,,,,54.72,,,,,,,,,83.12,,,,,,,,,,,,4.73,,APPROVED,Male,22.0,FALSE
324,2022-03-21 23:46:07,19,en,633291226,2022-03-21 23:40:15,2022-03-21 23:46:07,Y,Y,A1,,,2,2.0,1.0,1.0,1.0,1.0,1.0,7.0,1.0,2.0,1.0,1.0,1.0,1.0,1.0,1.0,1.0,1.0,1.0,1.0,1.0,1.0,1.0,1.0,1.0,1.0,1.0,1.0,1.0,1.0,1.0,1.0,1.0,14,,,,,,,,,,,,,,,,,,,,,,,,,,,,,,,,,7,,,,,,,,,,,,,,,,,,,,,,,,,,,,,,,,,10,,,,,,,,,,,,,,,,,,,,,,,,,,,,,,,,,0,1.0,1.0,1.0,1.0,1.0,1.0,6.0,1.0,1.0,1.0,1.0,1.0,1.0,1.0,5.0,1.0,3.0,2.0,1.0,1.0,1.0,1.0,1.0,1.0,1.0,4.0,1.0,1.0,1.0,1.0,1.0,5.0,13,,,,,,,,,,,,,,,,,,,,,,,,,,,,,,,,,9,,,,,,,,,,,,,,,,,,,,,,,,,,,,,,,,,11,,,,,,,,,,,,,,,,,,,,,,,,,,,,,,,,,8,,,,,,,,,,,,,,,,,,,,,,,,,,,,,,,,,5,,,,,,,,,,,,,,,,,,,,,,,,,,,,,,,,,1,1.0,2.0,1.0,1.0,1.0,1.0,7.0,1.0,1.0,1.0,1.0,1.0,1.0,1.0,1.0,1.0,1.0,1.0,1.0,1.0,1.0,1.0,1.0,1.0,1.0,1.0,1.0,1.0,1.0,1.0,1.0,4.0,6,,,,,,,,,,,,,,,,,,,,,,,,,,,,,,,,,3,,,,,,,,,,,,,,,,,,,,,,,,,,,,,,,,,12,,,,,,,,,,,,,,,,,,,,,,,,,,,,,,,,,4,,,,,,,,,,,,,,,,,,,,,,,,,,,,,,,,,thank you for letting me participate,249.67,21.81,,,,7.62,,38.9,,53.2,,,,,,,,,,,,66.17,,,,,,,,,,,,,,,,,,49.2,,,,,,,,,,,,,,,12.77,,APPROVED,Female,25.0,FALSE
325,2022-03-21 23:56:16,19,en,2092575622,2022-03-21 23:40:19,2022-03-21 23:56:16,Y,Y,A1,,,3,,,,,,,,,,,,,,,,,,,,,,,,,,,,,,,,,10,,,,,,,,,,,,,,,,,,,,,,,,,,,,,,,,,14,,,,,,,,,,,,,,,,,,,,,,,,,,,,,,,,,5,,,,,,,,,,,,,,,,,,,,,,,,,,,,,,,,,4,,,,,,,,,,,,,,,,,,,,,,,,,,,,,,,,,13,,,,,,,,,,,,,,,,,,,,,,,,,,,,,,,,,7,,,,,,,,,,,,,,,,,,,,,,,,,,,,,,,,,1,6.0,7.0,5.0,5.0,5.0,5.0,5.0,7.0,6.0,5.0,2.0,5.0,6.0,6.0,6.0,5.0,6.0,5.0,6.0,5.0,6.0,6.0,5.0,6.0,5.0,2.0,5.0,6.0,3.0,3.0,3.0,1.0,0,1.0,3.0,1.0,1.0,1.0,1.0,7.0,4.0,2.0,1.0,2.0,1.0,1.0,1.0,1.0,1.0,1.0,1.0,1.0,1.0,1.0,1.0,1.0,1.0,1.0,1.0,2.0,1.0,1.0,1.0,1.0,2.0,12,,,,,,,,,,,,,,,,,,,,,,,,,,,,,,,,,8,,,,,,,,,,,,,,,,,,,,,,,,,,,,,,,,,9,,,,,,,,,,,,,,,,,,,,,,,,,,,,,,,,,2,6.0,6.0,7.0,3.0,6.0,2.0,5.0,7.0,7.0,6.0,7.0,7.0,7.0,7.0,7.0,3.0,7.0,6.0,7.0,6.0,6.0,7.0,3.0,7.0,6.0,7.0,5.0,6.0,7.0,6.0,7.0,6.0,6,,,,,,,,,,,,,,,,,,,,,,,,,,,,,,,,,11,,,,,,,,,,,,,,,,,,,,,,,,,,,,,,,,,,961.06,36.86,,,,9.4,,57.5,,,,,,,,,,,,,,,,,,,,,,,262.54,,,289.58,,,,,,,,,,,,259.3,,,,,,,,,45.88,,APPROVED,Female,43.0,FALSE
326,2022-03-21 23:49:49,19,en,295710607,2022-03-21 23:40:23,2022-03-21 23:49:49,Y,Y,-oth-,Secundary School,,4,,,,,,,,,,,,,,,,,,,,,,,,,,,,,,,,,9,,,,,,,,,,,,,,,,,,,,,,,,,,,,,,,,,11,,,,,,,,,,,,,,,,,,,,,,,,,,,,,,,,,0,7.0,7.0,7.0,7.0,7.0,6.0,6.0,7.0,7.0,6.0,7.0,7.0,7.0,7.0,7.0,7.0,7.0,7.0,7.0,7.0,7.0,7.0,7.0,7.0,7.0,7.0,7.0,7.0,7.0,4.0,7.0,4.0,7,,,,,,,,,,,,,,,,,,,,,,,,,,,,,,,,,1,6.0,7.0,7.0,7.0,6.0,6.0,6.0,7.0,7.0,7.0,7.0,7.0,7.0,7.0,7.0,7.0,7.0,7.0,6.0,7.0,7.0,7.0,7.0,6.0,7.0,7.0,7.0,7.0,7.0,6.0,7.0,6.0,13,,,,,,,,,,,,,,,,,,,,,,,,,,,,,,,,,3,,,,,,,,,,,,,,,,,,,,,,,,,,,,,,,,,10,,,,,,,,,,,,,,,,,,,,,,,,,,,,,,,,,5,,,,,,,,,,,,,,,,,,,,,,,,,,,,,,,,,2,5.0,6.0,6.0,5.0,4.0,6.0,6.0,6.0,6.0,5.0,5.0,6.0,6.0,5.0,5.0,5.0,6.0,6.0,5.0,6.0,5.0,6.0,6.0,5.0,5.0,5.0,5.0,5.0,5.0,5.0,6.0,4.0,14,,,,,,,,,,,,,,,,,,,,,,,,,,,,,,,,,12,,,,,,,,,,,,,,,,,,,,,,,,,,,,,,,,,8,,,,,,,,,,,,,,,,,,,,,,,,,,,,,,,,,6,,,,,,,,,,,,,,,,,,,,,,,,,,,,,,,,,,568.14,20.53,,,,28.55,,367.3,,,,,,,,,,,55.46,,,,,,42.99,,,,,,,,,,,,,,,49.06,,,,,,,,,,,,,,,4.25,,APPROVED,Female,19.0,FALSE
327,2022-03-21 23:47:29,19,en,64169756,2022-03-21 23:40:28,2022-03-21 23:47:29,Y,Y,A1,,,3,,,,,,,,,,,,,,,,,,,,,,,,,,,,,,,,,8,,,,,,,,,,,,,,,,,,,,,,,,,,,,,,,,,2,7.0,7.0,7.0,7.0,7.0,7.0,4.0,7.0,6.0,7.0,7.0,7.0,7.0,7.0,7.0,7.0,7.0,7.0,7.0,6.0,7.0,7.0,7.0,7.0,7.0,7.0,6.0,7.0,7.0,6.0,7.0,3.0,6,,,,,,,,,,,,,,,,,,,,,,,,,,,,,,,,,14,,,,,,,,,,,,,,,,,,,,,,,,,,,,,,,,,13,,,,,,,,,,,,,,,,,,,,,,,,,,,,,,,,,0,1.0,4.0,1.0,1.0,1.0,2.0,4.0,1.0,4.0,1.0,1.0,4.0,1.0,2.0,1.0,1.0,4.0,2.0,1.0,1.0,1.0,1.0,4.0,2.0,1.0,1.0,3.0,1.0,1.0,1.0,4.0,7.0,11,,,,,,,,,,,,,,,,,,,,,,,,,,,,,,,,,4,,,,,,,,,,,,,,,,,,,,,,,,,,,,,,,,,12,,,,,,,,,,,,,,,,,,,,,,,,,,,,,,,,,7,,,,,,,,,,,,,,,,,,,,,,,,,,,,,,,,,1,6.0,6.0,5.0,6.0,5.0,4.0,4.0,6.0,7.0,5.0,4.0,5.0,5.0,6.0,7.0,5.0,6.0,5.0,5.0,5.0,5.0,6.0,4.0,6.0,5.0,4.0,4.0,6.0,5.0,5.0,6.0,5.0,9,,,,,,,,,,,,,,,,,,,,,,,,,,,,,,,,,10,,,,,,,,,,,,,,,,,,,,,,,,,,,,,,,,,5,,,,,,,,,,,,,,,,,,,,,,,,,,,,,,,,,i really enjoyed the third visualisation.,420.93,129.53,,,,6.78,,50.16,,,,,,,,64.12,,,,,,,,,,,,84.62,,,,,,,,,,,,,,,63.97,,,,,,,,,,,,21.75,,APPROVED,Female,53.0,FALSE
331,2022-03-21 23:46:35,19,en,577653033,2022-03-21 23:40:41,2022-03-21 23:46:35,Y,Y,A1,,,4,,,,,,,,,,,,,,,,,,,,,,,,,,,,,,,,,7,,,,,,,,,,,,,,,,,,,,,,,,,,,,,,,,,5,,,,,,,,,,,,,,,,,,,,,,,,,,,,,,,,,13,,,,,,,,,,,,,,,,,,,,,,,,,,,,,,,,,10,,,,,,,,,,,,,,,,,,,,,,,,,,,,,,,,,8,,,,,,,,,,,,,,,,,,,,,,,,,,,,,,,,,11,,,,,,,,,,,,,,,,,,,,,,,,,,,,,,,,,9,,,,,,,,,,,,,,,,,,,,,,,,,,,,,,,,,1,4.0,1.0,3.0,3.0,3.0,3.0,4.0,1.0,1.0,4.0,1.0,3.0,3.0,3.0,4.0,2.0,2.0,4.0,3.0,3.0,2.0,4.0,3.0,4.0,4.0,7.0,1.0,4.0,3.0,4.0,5.0,2.0,6,,,,,,,,,,,,,,,,,,,,,,,,,,,,,,,,,0,1.0,4.0,1.0,1.0,1.0,1.0,1.0,6.0,2.0,1.0,1.0,1.0,1.0,1.0,1.0,1.0,1.0,1.0,1.0,1.0,1.0,1.0,1.0,1.0,1.0,6.0,1.0,1.0,1.0,1.0,1.0,4.0,12,,,,,,,,,,,,,,,,,,,,,,,,,,,,,,,,,2,4.0,4.0,4.0,5.0,4.0,4.0,3.0,3.0,5.0,4.0,4.0,3.0,4.0,3.0,4.0,3.0,3.0,4.0,4.0,4.0,3.0,3.0,4.0,4.0,4.0,5.0,4.0,3.0,3.0,3.0,5.0,6.0,14,,,,,,,,,,,,,,,,,,,,,,,,,,,,,,,,,3,,,,,,,,,,,,,,,,,,,,,,,,,,,,,,,,,,400.67,11.8,,,,12.92,,208.34,,,,,,,,,,,,,,,,,,,,,,,,,,65.41,,,,,,48.25,,,,,,50.48,,,,,,,,,3.47,,APPROVED,Male,20.0,FALSE
334,2022-03-21 23:48:38,19,en,1467316953,2022-03-21 23:41:05,2022-03-21 23:48:38,Y,Y,-oth-,High school,,12,,,,,,,,,,,,,,,,,,,,,,,,,,,,,,,,,0,7.0,5.0,7.0,7.0,6.0,7.0,1.0,7.0,4.0,7.0,7.0,7.0,7.0,6.0,7.0,7.0,6.0,7.0,7.0,6.0,7.0,7.0,7.0,7.0,6.0,7.0,5.0,7.0,6.0,7.0,7.0,2.0,5,,,,,,,,,,,,,,,,,,,,,,,,,,,,,,,,,2,6.0,6.0,7.0,6.0,7.0,7.0,4.0,7.0,7.0,7.0,7.0,6.0,7.0,7.0,7.0,7.0,7.0,6.0,6.0,6.0,7.0,7.0,7.0,7.0,7.0,7.0,6.0,6.0,7.0,7.0,7.0,4.0,6,,,,,,,,,,,,,,,,,,,,,,,,,,,,,,,,,10,,,,,,,,,,,,,,,,,,,,,,,,,,,,,,,,,8,,,,,,,,,,,,,,,,,,,,,,,,,,,,,,,,,13,,,,,,,,,,,,,,,,,,,,,,,,,,,,,,,,,11,,,,,,,,,,,,,,,,,,,,,,,,,,,,,,,,,14,,,,,,,,,,,,,,,,,,,,,,,,,,,,,,,,,4,,,,,,,,,,,,,,,,,,,,,,,,,,,,,,,,,9,,,,,,,,,,,,,,,,,,,,,,,,,,,,,,,,,7,,,,,,,,,,,,,,,,,,,,,,,,,,,,,,,,,1,6.0,4.0,3.0,4.0,2.0,3.0,2.0,7.0,5.0,3.0,5.0,4.0,3.0,3.0,4.0,3.0,5.0,4.0,4.0,5.0,6.0,6.0,6.0,4.0,4.0,5.0,4.0,6.0,3.0,4.0,3.0,7.0,3,,,,,,,,,,,,,,,,,,,,,,,,,,,,,,,,,,321.8,8.45,,,,24.45,,32.69,,,,,73.44,,,,,,67.4,,,,,,,,,,,,,,,,,,,,,,,,,,,,,,112.71,,,,,,2.66,,APPROVED,Male,20.0,FALSE
335,2022-03-21 23:48:43,19,en,1330947443,2022-03-21 23:41:09,2022-03-21 23:48:43,Y,Y,A1,,,2,2.0,6.0,3.0,2.0,3.0,3.0,7.0,5.0,5.0,3.0,4.0,2.0,2.0,4.0,4.0,4.0,4.0,2.0,2.0,1.0,2.0,2.0,1.0,3.0,3.0,1.0,5.0,4.0,5.0,2.0,2.0,1.0,9,,,,,,,,,,,,,,,,,,,,,,,,,,,,,,,,,11,,,,,,,,,,,,,,,,,,,,,,,,,,,,,,,,,1,4.0,5.0,4.0,4.0,5.0,3.0,7.0,6.0,6.0,5.0,5.0,5.0,4.0,4.0,5.0,5.0,4.0,4.0,4.0,4.0,4.0,5.0,4.0,5.0,6.0,4.0,4.0,6.0,4.0,5.0,3.0,4.0,13,,,,,,,,,,,,,,,,,,,,,,,,,,,,,,,,,1,3.0,4.0,2.0,2.0,2.0,2.0,6.0,3.0,3.0,2.0,2.0,3.0,3.0,4.0,3.0,2.0,2.0,2.0,3.0,2.0,2.0,2.0,2.0,2.0,2.0,2.0,5.0,2.0,5.0,2.0,3.0,6.0,3,,,,,,,,,,,,,,,,,,,,,,,,,,,,,,,,,12,,,,,,,,,,,,,,,,,,,,,,,,,,,,,,,,,10,,,,,,,,,,,,,,,,,,,,,,,,,,,,,,,,,6,,,,,,,,,,,,,,,,,,,,,,,,,,,,,,,,,7,,,,,,,,,,,,,,,,,,,,,,,,,,,,,,,,,8,,,,,,,,,,,,,,,,,,,,,,,,,,,,,,,,,4,,,,,,,,,,,,,,,,,,,,,,,,,,,,,,,,,14,,,,,,,,,,,,,,,,,,,,,,,,,,,,,,,,,5,,,,,,,,,,,,,,,,,,,,,,,,,,,,,,,,,,446.57,18.57,,,,6.68,,20.25,,122.13,,,,,,,,,93.77,,,,,,183.01,,,,,,,,,,,,,,,,,,,,,,,,,,,,,,2.16,,APPROVED,Male,21.0,FALSE
337,2022-03-21 23:51:36,19,en,569079354,2022-03-21 23:41:20,2022-03-21 23:51:36,Y,Y,A1,,,12,,,,,,,,,,,,,,,,,,,,,,,,,,,,,,,,,0,5.0,5.0,6.0,6.0,6.0,5.0,5.0,6.0,6.0,5.0,5.0,6.0,6.0,6.0,6.0,6.0,6.0,6.0,6.0,6.0,6.0,6.0,6.0,6.0,5.0,5.0,5.0,3.0,5.0,6.0,4.0,2.0,9,,,,,,,,,,,,,,,,,,,,,,,,,,,,,,,,,4,,,,,,,,,,,,,,,,,,,,,,,,,,,,,,,,,8,,,,,,,,,,,,,,,,,,,,,,,,,,,,,,,,,7,,,,,,,,,,,,,,,,,,,,,,,,,,,,,,,,,1,6.0,6.0,6.0,5.0,5.0,6.0,5.0,6.0,5.0,6.0,5.0,5.0,6.0,5.0,4.0,6.0,6.0,4.0,5.0,5.0,6.0,6.0,5.0,5.0,6.0,4.0,6.0,5.0,6.0,6.0,5.0,7.0,14,,,,,,,,,,,,,,,,,,,,,,,,,,,,,,,,,13,,,,,,,,,,,,,,,,,,,,,,,,,,,,,,,,,11,,,,,,,,,,,,,,,,,,,,,,,,,,,,,,,,,2,5.0,6.0,6.0,5.0,6.0,5.0,6.0,5.0,6.0,6.0,6.0,6.0,4.0,4.0,6.0,6.0,4.0,5.0,6.0,5.0,4.0,5.0,6.0,6.0,4.0,6.0,5.0,5.0,6.0,6.0,5.0,4.0,10,,,,,,,,,,,,,,,,,,,,,,,,,,,,,,,,,3,,,,,,,,,,,,,,,,,,,,,,,,,,,,,,,,,5,,,,,,,,,,,,,,,,,,,,,,,,,,,,,,,,,6,,,,,,,,,,,,,,,,,,,,,,,,,,,,,,,,,,428.71,17.9,,,,15.78,,38.06,,,,,117.87,,,,,,,,,,,,,,,154.83,,,,,,,,,,,,79.18,,,,,,,,,,,,,,,5.09,,APPROVED,Male,39.0,FALSE
340,2022-03-21 23:51:08,19,en,1211363298,2022-03-21 23:41:31,2022-03-21 23:51:08,Y,Y,-oth-,In progress of achieving bachelor degree,,3,,,,,,,,,,,,,,,,,,,,,,,,,,,,,,,,,5,,,,,,,,,,,,,,,,,,,,,,,,,,,,,,,,,2,7.0,6.0,7.0,6.0,7.0,7.0,2.0,7.0,5.0,7.0,5.0,6.0,6.0,6.0,5.0,6.0,7.0,6.0,7.0,7.0,6.0,6.0,7.0,7.0,7.0,6.0,3.0,7.0,5.0,7.0,6.0,3.0,10,,,,,,,,,,,,,,,,,,,,,,,,,,,,,,,,,11,,,,,,,,,,,,,,,,,,,,,,,,,,,,,,,,,13,,,,,,,,,,,,,,,,,,,,,,,,,,,,,,,,,12,,,,,,,,,,,,,,,,,,,,,,,,,,,,,,,,,1,5.0,3.0,3.0,1.0,2.0,1.0,7.0,5.0,2.0,2.0,1.0,5.0,5.0,3.0,3.0,2.0,3.0,3.0,4.0,2.0,3.0,2.0,6.0,3.0,3.0,2.0,1.0,5.0,1.0,3.0,3.0,1.0,6,,,,,,,,,,,,,,,,,,,,,,,,,,,,,,,,,7,,,,,,,,,,,,,,,,,,,,,,,,,,,,,,,,,14,,,,,,,,,,,,,,,,,,,,,,,,,,,,,,,,,0,7.0,6.0,6.0,3.0,6.0,5.0,3.0,7.0,5.0,7.0,5.0,6.0,6.0,5.0,5.0,5.0,6.0,5.0,6.0,6.0,3.0,6.0,3.0,6.0,6.0,3.0,5.0,6.0,3.0,5.0,3.0,5.0,4,,,,,,,,,,,,,,,,,,,,,,,,,,,,,,,,,8,,,,,,,,,,,,,,,,,,,,,,,,,,,,,,,,,9,,,,,,,,,,,,,,,,,,,,,,,,,,,,,,,,,,420.7,52.88,,,,55.07,,54.03,,,,,,,,69.03,,,,,,,,,,,,,,,92.84,,,,,,,,,,,,93.3,,,,,,,,,,,,3.55,,APPROVED,Female,23.0,FALSE
342,2022-03-21 23:49:45,19,en,594120968,2022-03-21 23:41:35,2022-03-21 23:49:45,Y,Y,A1,,,7,,,,,,,,,,,,,,,,,,,,,,,,,,,,,,,,,1,6.0,6.0,6.0,6.0,6.0,7.0,2.0,7.0,3.0,5.0,6.0,3.0,3.0,3.0,3.0,7.0,3.0,6.0,6.0,5.0,5.0,6.0,7.0,5.0,6.0,7.0,5.0,6.0,6.0,6.0,6.0,2.0,10,,,,,,,,,,,,,,,,,,,,,,,,,,,,,,,,,12,,,,,,,,,,,,,,,,,,,,,,,,,,,,,,,,,8,,,,,,,,,,,,,,,,,,,,,,,,,,,,,,,,,11,,,,,,,,,,,,,,,,,,,,,,,,,,,,,,,,,13,,,,,,,,,,,,,,,,,,,,,,,,,,,,,,,,,9,,,,,,,,,,,,,,,,,,,,,,,,,,,,,,,,,1,5.0,7.0,6.0,5.0,5.0,2.0,6.0,6.0,7.0,3.0,2.0,6.0,5.0,5.0,7.0,2.0,6.0,3.0,5.0,2.0,3.0,6.0,3.0,3.0,6.0,4.0,6.0,6.0,4.0,3.0,5.0,2.0,4,,,,,,,,,,,,,,,,,,,,,,,,,,,,,,,,,3,,,,,,,,,,,,,,,,,,,,,,,,,,,,,,,,,2,6.0,7.0,7.0,6.0,6.0,6.0,3.0,7.0,6.0,5.0,5.0,6.0,5.0,6.0,7.0,6.0,5.0,3.0,5.0,4.0,5.0,6.0,6.0,6.0,7.0,6.0,6.0,6.0,4.0,6.0,7.0,5.0,5,,,,,,,,,,,,,,,,,,,,,,,,,,,,,,,,,6,,,,,,,,,,,,,,,,,,,,,,,,,,,,,,,,,14,,,,,,,,,,,,,,,,,,,,,,,,,,,,,,,,,,491.73,65.5,,,,17.43,,41.58,,,,,112.57,,,,,,,,,,,,,,,,,,,,,157.22,,,,,,,,,94.19,,,,,,,,,,,,3.24,,APPROVED,Female,23.0,FALSE
345,2022-03-21 23:52:31,19,en,1615886179,2022-03-21 23:41:43,2022-03-21 23:52:31,Y,Y,A1,,,11,,,,,,,,,,,,,,,,,,,,,,,,,,,,,,,,,12,,,,,,,,,,,,,,,,,,,,,,,,,,,,,,,,,1,5.0,4.0,4.0,5.0,5.0,6.0,5.0,3.0,5.0,4.0,4.0,6.0,6.0,5.0,3.0,4.0,3.0,4.0,5.0,3.0,5.0,5.0,5.0,5.0,5.0,3.0,3.0,4.0,3.0,3.0,5.0,3.0,0,5.0,5.0,6.0,7.0,7.0,7.0,6.0,6.0,7.0,7.0,7.0,6.0,7.0,5.0,6.0,6.0,6.0,6.0,7.0,5.0,7.0,5.0,6.0,5.0,6.0,7.0,1.0,6.0,5.0,5.0,6.0,4.0,13,,,,,,,,,,,,,,,,,,,,,,,,,,,,,,,,,3,,,,,,,,,,,,,,,,,,,,,,,,,,,,,,,,,2,5.0,6.0,5.0,5.0,3.0,3.0,5.0,5.0,4.0,3.0,3.0,5.0,5.0,5.0,4.0,3.0,6.0,5.0,6.0,3.0,4.0,5.0,3.0,4.0,5.0,5.0,3.0,5.0,5.0,4.0,6.0,7.0,14,,,,,,,,,,,,,,,,,,,,,,,,,,,,,,,,,4,,,,,,,,,,,,,,,,,,,,,,,,,,,,,,,,,7,,,,,,,,,,,,,,,,,,,,,,,,,,,,,,,,,9,,,,,,,,,,,,,,,,,,,,,,,,,,,,,,,,,5,,,,,,,,,,,,,,,,,,,,,,,,,,,,,,,,,6,,,,,,,,,,,,,,,,,,,,,,,,,,,,,,,,,10,,,,,,,,,,,,,,,,,,,,,,,,,,,,,,,,,8,,,,,,,,,,,,,,,,,,,,,,,,,,,,,,,,,,650.24,19.92,,,,7.09,,186.29,,,,,,,,94.75,,,233.8,,,,,,,,,105.46,,,,,,,,,,,,,,,,,,,,,,,,,,,2.93,,APPROVED,Male,21.0,FALSE
346,2022-03-21 23:47:36,19,en,1279909063,2022-03-21 23:41:51,2022-03-21 23:47:36,Y,Y,A1,,,6,,,,,,,,,,,,,,,,,,,,,,,,,,,,,,,,,14,,,,,,,,,,,,,,,,,,,,,,,,,,,,,,,,,1,5.0,5.0,6.0,4.0,6.0,4.0,5.0,7.0,6.0,5.0,5.0,4.0,5.0,5.0,5.0,6.0,5.0,5.0,5.0,5.0,3.0,5.0,3.0,5.0,5.0,4.0,3.0,5.0,3.0,4.0,3.0,2.0,7,,,,,,,,,,,,,,,,,,,,,,,,,,,,,,,,,12,,,,,,,,,,,,,,,,,,,,,,,,,,,,,,,,,4,,,,,,,,,,,,,,,,,,,,,,,,,,,,,,,,,3,,,,,,,,,,,,,,,,,,,,,,,,,,,,,,,,,2,4.0,2.0,3.0,5.0,3.0,3.0,6.0,4.0,3.0,4.0,3.0,5.0,5.0,4.0,5.0,4.0,6.0,4.0,4.0,3.0,4.0,4.0,5.0,3.0,3.0,2.0,5.0,4.0,3.0,3.0,4.0,1.0,13,,,,,,,,,,,,,,,,,,,,,,,,,,,,,,,,,5,,,,,,,,,,,,,,,,,,,,,,,,,,,,,,,,,8,,,,,,,,,,,,,,,,,,,,,,,,,,,,,,,,,0,6.0,5.0,6.0,5.0,5.0,6.0,2.0,3.0,3.0,4.0,5.0,5.0,4.0,3.0,4.0,6.0,6.0,4.0,5.0,4.0,4.0,5.0,4.0,5.0,5.0,6.0,3.0,5.0,3.0,5.0,5.0,5.0,10,,,,,,,,,,,,,,,,,,,,,,,,,,,,,,,,,11,,,,,,,,,,,,,,,,,,,,,,,,,,,,,,,,,9,,,,,,,,,,,,,,,,,,,,,,,,,,,,,,,,,,347.31,22.15,,,,5.28,,34.52,,,,,,,,70.11,,,,,,,,,,,,,,,73.82,,,,,,,,,,,,138.24,,,,,,,,,,,,3.19,,APPROVED,Male,30.0,FALSE
348,2022-03-21 23:48:03,19,en,1431032959,2022-03-21 23:41:59,2022-03-21 23:48:03,Y,Y,A1,,,7,,,,,,,,,,,,,,,,,,,,,,,,,,,,,,,,,4,,,,,,,,,,,,,,,,,,,,,,,,,,,,,,,,,2,2.0,6.0,6.0,6.0,5.0,3.0,1.0,3.0,6.0,5.0,4.0,2.0,5.0,5.0,5.0,5.0,6.0,5.0,4.0,1.0,1.0,6.0,2.0,5.0,3.0,6.0,5.0,3.0,4.0,1.0,6.0,3.0,1,7.0,7.0,6.0,1.0,7.0,2.0,1.0,6.0,6.0,5.0,7.0,7.0,6.0,6.0,7.0,2.0,7.0,6.0,7.0,4.0,1.0,7.0,6.0,6.0,6.0,7.0,5.0,7.0,7.0,1.0,7.0,4.0,9,,,,,,,,,,,,,,,,,,,,,,,,,,,,,,,,,12,,,,,,,,,,,,,,,,,,,,,,,,,,,,,,,,,14,,,,,,,,,,,,,,,,,,,,,,,,,,,,,,,,,11,,,,,,,,,,,,,,,,,,,,,,,,,,,,,,,,,8,,,,,,,,,,,,,,,,,,,,,,,,,,,,,,,,,6,,,,,,,,,,,,,,,,,,,,,,,,,,,,,,,,,0,1.0,6.0,3.0,1.0,3.0,1.0,2.0,6.0,6.0,1.0,3.0,5.0,5.0,2.0,1.0,1.0,5.0,1.0,4.0,2.0,1.0,4.0,1.0,3.0,4.0,2.0,1.0,3.0,1.0,1.0,4.0,4.0,13,,,,,,,,,,,,,,,,,,,,,,,,,,,,,,,,,10,,,,,,,,,,,,,,,,,,,,,,,,,,,,,,,,,3,,,,,,,,,,,,,,,,,,,,,,,,,,,,,,,,,5,,,,,,,,,,,,,,,,,,,,,,,,,,,,,,,,,,364.46,17.0,,,,9.24,,40.0,,,,,,,,113.55,,,79.0,,,,,,,,,,,,,,,,,,,,,94.43,,,,,,,,,,,,,,,11.24,,APPROVED,Male,23.0,FALSE
349,2022-03-21 23:54:36,19,en,505091836,2022-03-21 23:42:04,2022-03-21 23:54:36,Y,Y,-oth-,Secundary school,,11,,,,,,,,,,,,,,,,,,,,,,,,,,,,,,,,,3,,,,,,,,,,,,,,,,,,,,,,,,,,,,,,,,,10,,,,,,,,,,,,,,,,,,,,,,,,,,,,,,,,,6,,,,,,,,,,,,,,,,,,,,,,,,,,,,,,,,,7,,,,,,,,,,,,,,,,,,,,,,,,,,,,,,,,,9,,,,,,,,,,,,,,,,,,,,,,,,,,,,,,,,,5,,,,,,,,,,,,,,,,,,,,,,,,,,,,,,,,,4,,,,,,,,,,,,,,,,,,,,,,,,,,,,,,,,,0,1.0,5.0,1.0,1.0,1.0,1.0,7.0,1.0,6.0,1.0,3.0,1.0,2.0,1.0,1.0,1.0,3.0,2.0,1.0,1.0,1.0,3.0,1.0,1.0,1.0,4.0,5.0,2.0,2.0,1.0,4.0,2.0,2,5.0,7.0,5.0,5.0,1.0,2.0,7.0,1.0,6.0,5.0,4.0,2.0,4.0,3.0,6.0,2.0,5.0,5.0,4.0,1.0,2.0,5.0,1.0,2.0,1.0,6.0,5.0,5.0,3.0,1.0,6.0,3.0,13,,,,,,,,,,,,,,,,,,,,,,,,,,,,,,,,,8,,,,,,,,,,,,,,,,,,,,,,,,,,,,,,,,,14,,,,,,,,,,,,,,,,,,,,,,,,,,,,,,,,,1,5.0,3.0,3.0,4.0,1.0,5.0,2.0,6.0,6.0,2.0,1.0,2.0,4.0,3.0,5.0,3.0,5.0,2.0,3.0,1.0,1.0,6.0,5.0,2.0,1.0,6.0,5.0,3.0,1.0,1.0,7.0,7.0,12,,,,,,,,,,,,,,,,,,,,,,,,,,,,,,,,,It was a nice study.,669.13,54.22,,,,17.47,,52.85,,,,,,,,,,,,,,,,,,,,,,,,,,185.91,,,143.14,,,,,,,,,,,,202.85,,,,,,12.69,,APPROVED,Female,21.0,FALSE
350,2022-03-21 23:47:03,19,en,581219224,2022-03-21 23:42:07,2022-03-21 23:47:03,Y,Y,A1,,,12,,,,,,,,,,,,,,,,,,,,,,,,,,,,,,,,,1,5.0,4.0,6.0,6.0,6.0,6.0,2.0,6.0,4.0,4.0,6.0,6.0,6.0,4.0,6.0,6.0,5.0,6.0,6.0,6.0,4.0,6.0,6.0,6.0,6.0,6.0,3.0,5.0,4.0,4.0,6.0,2.0,2,4.0,6.0,4.0,6.0,4.0,5.0,6.0,6.0,5.0,4.0,5.0,4.0,4.0,4.0,5.0,5.0,4.0,3.0,5.0,3.0,3.0,4.0,5.0,4.0,4.0,5.0,4.0,5.0,5.0,4.0,4.0,3.0,0,2.0,4.0,3.0,2.0,2.0,2.0,6.0,5.0,2.0,3.0,2.0,2.0,2.0,3.0,2.0,3.0,2.0,2.0,2.0,2.0,2.0,2.0,2.0,2.0,2.0,4.0,2.0,2.0,5.0,2.0,2.0,4.0,3,,,,,,,,,,,,,,,,,,,,,,,,,,,,,,,,,13,,,,,,,,,,,,,,,,,,,,,,,,,,,,,,,,,5,,,,,,,,,,,,,,,,,,,,,,,,,,,,,,,,,10,,,,,,,,,,,,,,,,,,,,,,,,,,,,,,,,,14,,,,,,,,,,,,,,,,,,,,,,,,,,,,,,,,,8,,,,,,,,,,,,,,,,,,,,,,,,,,,,,,,,,9,,,,,,,,,,,,,,,,,,,,,,,,,,,,,,,,,6,,,,,,,,,,,,,,,,,,,,,,,,,,,,,,,,,11,,,,,,,,,,,,,,,,,,,,,,,,,,,,,,,,,7,,,,,,,,,,,,,,,,,,,,,,,,,,,,,,,,,4,,,,,,,,,,,,,,,,,,,,,,,,,,,,,,,,,,298.68,13.48,,,,33.64,,21.1,,,,,59.43,,,72.49,,,94.57,,,,,,,,,,,,,,,,,,,,,,,,,,,,,,,,,,,,3.97,,APPROVED,Male,25.0,FALSE
351,2022-03-21 23:46:38,19,en,1032450649,2022-03-21 23:42:09,2022-03-21 23:46:38,Y,Y,A2,,,9,,,,,,,,,,,,,,,,,,,,,,,,,,,,,,,,,11,,,,,,,,,,,,,,,,,,,,,,,,,,,,,,,,,5,,,,,,,,,,,,,,,,,,,,,,,,,,,,,,,,,12,,,,,,,,,,,,,,,,,,,,,,,,,,,,,,,,,3,,,,,,,,,,,,,,,,,,,,,,,,,,,,,,,,,0,4.0,6.0,1.0,4.0,4.0,1.0,4.0,4.0,4.0,4.0,1.0,2.0,1.0,4.0,1.0,1.0,1.0,1.0,4.0,4.0,1.0,1.0,1.0,1.0,1.0,4.0,4.0,4.0,4.0,1.0,1.0,6.0,13,,,,,,,,,,,,,,,,,,,,,,,,,,,,,,,,,7,,,,,,,,,,,,,,,,,,,,,,,,,,,,,,,,,6,,,,,,,,,,,,,,,,,,,,,,,,,,,,,,,,,2,4.0,4.0,4.0,4.0,4.0,4.0,4.0,4.0,4.0,4.0,5.0,4.0,4.0,4.0,4.0,5.0,4.0,4.0,5.0,4.0,4.0,4.0,4.0,4.0,4.0,4.0,1.0,4.0,5.0,4.0,4.0,3.0,10,,,,,,,,,,,,,,,,,,,,,,,,,,,,,,,,,8,,,,,,,,,,,,,,,,,,,,,,,,,,,,,,,,,14,,,,,,,,,,,,,,,,,,,,,,,,,,,,,,,,,1,1.0,1.0,1.0,4.0,1.0,4.0,4.0,4.0,4.0,1.0,3.0,1.0,1.0,1.0,4.0,4.0,4.0,1.0,3.0,1.0,1.0,1.0,6.0,1.0,1.0,4.0,4.0,4.0,4.0,1.0,1.0,7.0,4,,,,,,,,,,,,,,,,,,,,,,,,,,,,,,,,,,271.91,33.02,,,,5.88,,11.59,,,,,,,,,,,,,,,,,85.75,,,,,,,,,,,,71.86,,,,,,,,,,,,59.99,,,,,,3.82,,APPROVED,Male,29.0,FALSE
352,2022-03-21 23:56:18,19,en,1618758969,2022-03-21 23:42:09,2022-03-21 23:56:18,Y,Y,-oth-,High school,,14,,,,,,,,,,,,,,,,,,,,,,,,,,,,,,,,,0,6.0,2.0,6.0,6.0,5.0,7.0,1.0,6.0,5.0,6.0,6.0,6.0,6.0,5.0,6.0,6.0,6.0,5.0,6.0,5.0,6.0,6.0,6.0,6.0,5.0,6.0,4.0,6.0,6.0,6.0,6.0,2.0,5,,,,,,,,,,,,,,,,,,,,,,,,,,,,,,,,,4,,,,,,,,,,,,,,,,,,,,,,,,,,,,,,,,,2,1.0,1.0,1.0,1.0,1.0,1.0,7.0,1.0,1.0,1.0,1.0,1.0,1.0,1.0,1.0,1.0,1.0,1.0,1.0,1.0,1.0,1.0,1.0,1.0,1.0,1.0,1.0,1.0,1.0,1.0,1.0,5.0,9,,,,,,,,,,,,,,,,,,,,,,,,,,,,,,,,,10,,,,,,,,,,,,,,,,,,,,,,,,,,,,,,,,,13,,,,,,,,,,,,,,,,,,,,,,,,,,,,,,,,,12,,,,,,,,,,,,,,,,,,,,,,,,,,,,,,,,,3,,,,,,,,,,,,,,,,,,,,,,,,,,,,,,,,,1,5.0,5.0,6.0,3.0,5.0,3.0,6.0,4.0,5.0,5.0,3.0,6.0,5.0,3.0,5.0,3.0,6.0,3.0,5.0,5.0,4.0,6.0,1.0,3.0,5.0,2.0,6.0,2.0,2.0,3.0,3.0,4.0,11,,,,,,,,,,,,,,,,,,,,,,,,,,,,,,,,,6,,,,,,,,,,,,,,,,,,,,,,,,,,,,,,,,,7,,,,,,,,,,,,,,,,,,,,,,,,,,,,,,,,,8,,,,,,,,,,,,,,,,,,,,,,,,,,,,,,,,,,852.67,497.05,,,,18.24,,40.1,,,,,145.52,,,,,,,,,42.06,,,,,,,,,,,,,,,,,,102.93,,,,,,,,,,,,,,,6.77,,APPROVED,Male,26.0,FALSE
353,2022-03-22 00:03:24,19,en,2023066363,2022-03-21 23:42:11,2022-03-22 00:03:24,Y,Y,A1,,,11,,,,,,,,,,,,,,,,,,,,,,,,,,,,,,,,,10,,,,,,,,,,,,,,,,,,,,,,,,,,,,,,,,,8,,,,,,,,,,,,,,,,,,,,,,,,,,,,,,,,,4,,,,,,,,,,,,,,,,,,,,,,,,,,,,,,,,,5,,,,,,,,,,,,,,,,,,,,,,,,,,,,,,,,,1,6.0,6.0,6.0,3.0,6.0,2.0,5.0,6.0,6.0,6.0,2.0,6.0,6.0,5.0,6.0,5.0,5.0,5.0,6.0,6.0,4.0,6.0,1.0,6.0,5.0,3.0,4.0,7.0,5.0,6.0,5.0,6.0,6,,,,,,,,,,,,,,,,,,,,,,,,,,,,,,,,,2,3.0,5.0,4.0,5.0,6.0,4.0,6.0,3.0,4.0,3.0,4.0,6.0,4.0,5.0,5.0,4.0,6.0,3.0,3.0,5.0,6.0,6.0,6.0,6.0,5.0,7.0,4.0,4.0,6.0,4.0,6.0,3.0,13,,,,,,,,,,,,,,,,,,,,,,,,,,,,,,,,,3,,,,,,,,,,,,,,,,,,,,,,,,,,,,,,,,,12,,,,,,,,,,,,,,,,,,,,,,,,,,,,,,,,,0,6.0,6.0,5.0,3.0,6.0,3.0,4.0,6.0,6.0,6.0,6.0,3.0,6.0,6.0,6.0,6.0,5.0,4.0,6.0,6.0,4.0,6.0,3.0,6.0,5.0,3.0,2.0,6.0,5.0,2.0,4.0,5.0,7,,,,,,,,,,,,,,,,,,,,,,,,,,,,,,,,,9,,,,,,,,,,,,,,,,,,,,,,,,,,,,,,,,,14,,,,,,,,,,,,,,,,,,,,,,,,,,,,,,,,,,1098.43,16.0,,,,13.69,,30.94,,,,,,,,,,,,,,,,,159.5,,,,,,678.15,,,,,,,,,,,,193.6,,,,,,,,,,,,6.55,,APPROVED,Female,20.0,FALSE
354,2022-03-21 23:54:34,19,en,1413329783,2022-03-21 23:42:12,2022-03-21 23:54:34,Y,Y,A1,,,0,5.0,6.0,5.0,3.0,5.0,5.0,7.0,4.0,6.0,5.0,5.0,6.0,6.0,4.0,6.0,4.0,5.0,4.0,6.0,6.0,3.0,7.0,2.0,6.0,6.0,4.0,3.0,6.0,5.0,5.0,5.0,1.0,13,,,,,,,,,,,,,,,,,,,,,,,,,,,,,,,,,1,4.0,5.0,4.0,6.0,6.0,6.0,5.0,6.0,4.0,5.0,6.0,6.0,6.0,3.0,2.0,6.0,4.0,5.0,6.0,6.0,3.0,7.0,5.0,4.0,6.0,5.0,4.0,5.0,6.0,5.0,6.0,3.0,4,,,,,,,,,,,,,,,,,,,,,,,,,,,,,,,,,5,,,,,,,,,,,,,,,,,,,,,,,,,,,,,,,,,7,,,,,,,,,,,,,,,,,,,,,,,,,,,,,,,,,6,,,,,,,,,,,,,,,,,,,,,,,,,,,,,,,,,9,,,,,,,,,,,,,,,,,,,,,,,,,,,,,,,,,10,,,,,,,,,,,,,,,,,,,,,,,,,,,,,,,,,8,,,,,,,,,,,,,,,,,,,,,,,,,,,,,,,,,3,,,,,,,,,,,,,,,,,,,,,,,,,,,,,,,,,14,,,,,,,,,,,,,,,,,,,,,,,,,,,,,,,,,11,,,,,,,,,,,,,,,,,,,,,,,,,,,,,,,,,2,2.0,4.0,3.0,5.0,2.0,6.0,4.0,5.0,4.0,1.0,2.0,5.0,3.0,3.0,6.0,4.0,7.0,2.0,4.0,3.0,3.0,3.0,6.0,2.0,2.0,7.0,2.0,2.0,4.0,2.0,5.0,7.0,12,,,,,,,,,,,,,,,,,,,,,,,,,,,,,,,,,,664.49,67.43,,,,8.13,,67.23,,111.34,,,,,,296.08,,,,,,,,,,,,,,,,,,,,,,,,,,,,,,,,,110.65,,,,,,3.63,,APPROVED,Male,23.0,FALSE
355,2022-03-21 23:54:16,19,en,791426037,2022-03-21 23:42:13,2022-03-21 23:54:16,Y,Y,A1,,,4,,,,,,,,,,,,,,,,,,,,,,,,,,,,,,,,,7,,,,,,,,,,,,,,,,,,,,,,,,,,,,,,,,,0,6.0,6.0,5.0,4.0,5.0,5.0,4.0,7.0,6.0,6.0,4.0,5.0,5.0,5.0,5.0,5.0,4.0,5.0,6.0,5.0,4.0,5.0,4.0,5.0,5.0,4.0,5.0,6.0,6.0,5.0,5.0,3.0,5,,,,,,,,,,,,,,,,,,,,,,,,,,,,,,,,,2,3.0,5.0,3.0,2.0,3.0,2.0,2.0,5.0,5.0,2.0,1.0,2.0,2.0,4.0,2.0,3.0,5.0,2.0,4.0,3.0,3.0,3.0,1.0,4.0,4.0,2.0,2.0,4.0,4.0,4.0,2.0,5.0,6,,,,,,,,,,,,,,,,,,,,,,,,,,,,,,,,,9,,,,,,,,,,,,,,,,,,,,,,,,,,,,,,,,,10,,,,,,,,,,,,,,,,,,,,,,,,,,,,,,,,,12,,,,,,,,,,,,,,,,,,,,,,,,,,,,,,,,,3,,,,,,,,,,,,,,,,,,,,,,,,,,,,,,,,,14,,,,,,,,,,,,,,,,,,,,,,,,,,,,,,,,,11,,,,,,,,,,,,,,,,,,,,,,,,,,,,,,,,,8,,,,,,,,,,,,,,,,,,,,,,,,,,,,,,,,,13,,,,,,,,,,,,,,,,,,,,,,,,,,,,,,,,,1,6.0,6.0,7.0,6.0,5.0,5.0,5.0,6.0,6.0,6.0,7.0,5.0,4.0,5.0,6.0,5.0,7.0,6.0,6.0,4.0,6.0,6.0,6.0,6.0,6.0,6.0,5.0,6.0,7.0,6.0,6.0,1.0,I did not know you could use that many adjectives to describe a data design,550.37,20.41,,,,9.37,,64.93,,,,,,,,141.63,,,,,,143.22,,,,,,,,,,,,,,,,,,,,,,,,,,,,,,101.46,,,69.35,,APPROVED,Female,26.0,FALSE
356,2022-03-21 23:47:57,19,en,89772396,2022-03-21 23:42:14,2022-03-21 23:47:57,Y,Y,A2,,,10,,,,,,,,,,,,,,,,,,,,,,,,,,,,,,,,,8,,,,,,,,,,,,,,,,,,,,,,,,,,,,,,,,,14,,,,,,,,,,,,,,,,,,,,,,,,,,,,,,,,,4,,,,,,,,,,,,,,,,,,,,,,,,,,,,,,,,,13,,,,,,,,,,,,,,,,,,,,,,,,,,,,,,,,,5,,,,,,,,,,,,,,,,,,,,,,,,,,,,,,,,,12,,,,,,,,,,,,,,,,,,,,,,,,,,,,,,,,,6,,,,,,,,,,,,,,,,,,,,,,,,,,,,,,,,,11,,,,,,,,,,,,,,,,,,,,,,,,,,,,,,,,,1,2.0,2.0,1.0,1.0,2.0,1.0,7.0,1.0,1.0,1.0,1.0,2.0,1.0,2.0,1.0,1.0,3.0,2.0,3.0,1.0,2.0,2.0,1.0,1.0,1.0,1.0,5.0,1.0,1.0,1.0,1.0,3.0,2,4.0,5.0,5.0,4.0,5.0,1.0,7.0,7.0,5.0,4.0,5.0,3.0,4.0,4.0,4.0,5.0,5.0,3.0,5.0,5.0,3.0,5.0,2.0,5.0,5.0,2.0,2.0,5.0,3.0,5.0,4.0,4.0,0,5.0,5.0,4.0,5.0,4.0,4.0,3.0,6.0,5.0,4.0,3.0,5.0,5.0,4.0,3.0,5.0,6.0,4.0,5.0,4.0,2.0,5.0,2.0,5.0,5.0,2.0,2.0,6.0,3.0,4.0,3.0,5.0,7,,,,,,,,,,,,,,,,,,,,,,,,,,,,,,,,,3,,,,,,,,,,,,,,,,,,,,,,,,,,,,,,,,,9,,,,,,,,,,,,,,,,,,,,,,,,,,,,,,,,,,346.0,17.69,,,,5.17,,27.29,,,,,,,,,,,,,,,,,,,,,,,,,,,,,89.31,,,69.39,,,133.59,,,,,,,,,,,,3.56,,APPROVED,Female,23.0,FALSE
357,2022-03-21 23:53:01,19,en,2095010039,2022-03-21 23:42:16,2022-03-21 23:53:01,Y,Y,A1,,,12,,,,,,,,,,,,,,,,,,,,,,,,,,,,,,,,,13,,,,,,,,,,,,,,,,,,,,,,,,,,,,,,,,,1,4.0,5.0,5.0,5.0,5.0,5.0,4.0,5.0,7.0,4.0,4.0,6.0,5.0,5.0,5.0,5.0,6.0,4.0,6.0,5.0,4.0,6.0,6.0,4.0,6.0,4.0,2.0,5.0,6.0,3.0,6.0,3.0,7,,,,,,,,,,,,,,,,,,,,,,,,,,,,,,,,,9,,,,,,,,,,,,,,,,,,,,,,,,,,,,,,,,,4,,,,,,,,,,,,,,,,,,,,,,,,,,,,,,,,,11,,,,,,,,,,,,,,,,,,,,,,,,,,,,,,,,,8,,,,,,,,,,,,,,,,,,,,,,,,,,,,,,,,,6,,,,,,,,,,,,,,,,,,,,,,,,,,,,,,,,,10,,,,,,,,,,,,,,,,,,,,,,,,,,,,,,,,,14,,,,,,,,,,,,,,,,,,,,,,,,,,,,,,,,,1,6.0,6.0,6.0,6.0,6.0,3.0,4.0,6.0,6.0,4.0,5.0,4.0,6.0,6.0,5.0,6.0,5.0,5.0,6.0,6.0,5.0,6.0,6.0,5.0,6.0,4.0,1.0,7.0,5.0,4.0,5.0,5.0,5,,,,,,,,,,,,,,,,,,,,,,,,,,,,,,,,,2,5.0,5.0,5.0,6.0,3.0,4.0,4.0,6.0,5.0,4.0,4.0,5.0,5.0,4.0,5.0,5.0,6.0,6.0,6.0,4.0,6.0,5.0,4.0,4.0,4.0,6.0,2.0,4.0,5.0,6.0,6.0,7.0,3,,,,,,,,,,,,,,,,,,,,,,,,,,,,,,,,,,647.75,81.39,,,,46.43,,56.3,,,,,,,,160.79,,,,,,,,,,,,,,,,,,,,,,,,,,,124.74,,,,,,172.87,,,,,,5.23,,APPROVED,Male,26.0,FALSE
359,2022-03-22 00:12:01,19,en,1826527740,2022-03-21 23:42:19,2022-03-22 00:12:01,Y,Y,A1,,,2,5.0,7.0,5.0,3.0,5.0,5.0,5.0,4.0,7.0,4.0,5.0,7.0,6.0,5.0,6.0,7.0,6.0,3.0,5.0,5.0,6.0,5.0,2.0,3.0,5.0,5.0,7.0,5.0,5.0,3.0,5.0,1.0,1,7.0,3.0,5.0,7.0,5.0,7.0,1.0,7.0,2.0,5.0,5.0,6.0,7.0,4.0,6.0,6.0,7.0,6.0,6.0,5.0,4.0,6.0,7.0,7.0,6.0,7.0,3.0,6.0,6.0,7.0,7.0,2.0,12,,,,,,,,,,,,,,,,,,,,,,,,,,,,,,,,,8,,,,,,,,,,,,,,,,,,,,,,,,,,,,,,,,,0,6.0,3.0,5.0,2.0,6.0,2.0,6.0,7.0,5.0,5.0,2.0,4.0,5.0,5.0,5.0,3.0,6.0,2.0,5.0,4.0,3.0,5.0,1.0,6.0,5.0,2.0,5.0,5.0,3.0,5.0,4.0,5.0,6,,,,,,,,,,,,,,,,,,,,,,,,,,,,,,,,,14,,,,,,,,,,,,,,,,,,,,,,,,,,,,,,,,,11,,,,,,,,,,,,,,,,,,,,,,,,,,,,,,,,,4,,,,,,,,,,,,,,,,,,,,,,,,,,,,,,,,,3,,,,,,,,,,,,,,,,,,,,,,,,,,,,,,,,,7,,,,,,,,,,,,,,,,,,,,,,,,,,,,,,,,,5,,,,,,,,,,,,,,,,,,,,,,,,,,,,,,,,,10,,,,,,,,,,,,,,,,,,,,,,,,,,,,,,,,,9,,,,,,,,,,,,,,,,,,,,,,,,,,,,,,,,,13,,,,,,,,,,,,,,,,,,,,,,,,,,,,,,,,,,361.68,45.25,,,,5.33,,28.68,,88.98,,,79.39,,,,,,,,,110.73,,,,,,,,,,,,,,,,,,,,,,,,,,,,,,,,,3.32,,APPROVED,Male,24.0,FALSE
361,2022-03-22 00:02:30,19,en,1210602032,2022-03-21 23:42:22,2022-03-22 00:02:30,Y,Y,-oth-,high school diploma ,,10,,,,,,,,,,,,,,,,,,,,,,,,,,,,,,,,,9,,,,,,,,,,,,,,,,,,,,,,,,,,,,,,,,,14,,,,,,,,,,,,,,,,,,,,,,,,,,,,,,,,,5,,,,,,,,,,,,,,,,,,,,,,,,,,,,,,,,,13,,,,,,,,,,,,,,,,,,,,,,,,,,,,,,,,,3,,,,,,,,,,,,,,,,,,,,,,,,,,,,,,,,,4,,,,,,,,,,,,,,,,,,,,,,,,,,,,,,,,,7,,,,,,,,,,,,,,,,,,,,,,,,,,,,,,,,,6,,,,,,,,,,,,,,,,,,,,,,,,,,,,,,,,,11,,,,,,,,,,,,,,,,,,,,,,,,,,,,,,,,,1,6.0,6.0,7.0,4.0,6.0,6.0,2.0,6.0,7.0,5.0,6.0,6.0,6.0,7.0,6.0,4.0,6.0,6.0,6.0,4.0,6.0,5.0,4.0,5.0,6.0,5.0,6.0,6.0,5.0,6.0,5.0,4.0,12,,,,,,,,,,,,,,,,,,,,,,,,,,,,,,,,,2,6.0,6.0,6.0,6.0,5.0,6.0,5.0,5.0,6.0,6.0,6.0,6.0,6.0,6.0,5.0,5.0,6.0,6.0,5.0,5.0,5.0,6.0,6.0,6.0,6.0,6.0,6.0,6.0,5.0,6.0,6.0,6.0,0,6.0,6.0,7.0,6.0,4.0,7.0,2.0,7.0,6.0,4.0,4.0,6.0,6.0,5.0,6.0,6.0,6.0,6.0,6.0,2.0,6.0,6.0,6.0,6.0,4.0,6.0,5.0,6.0,6.0,6.0,6.0,7.0,8,,,,,,,,,,,,,,,,,,,,,,,,,,,,,,,,,,1211.29,44.03,,,,77.93,,52.54,,,,,,,,,,,,,,,,,,,,,,,,,,,,,,,,340.92,,,,,,351.13,,,338.75,,,,,,5.99,,APPROVED,Female,23.0,FALSE
362,2022-03-21 23:54:49,19,en,1396900724,2022-03-21 23:42:22,2022-03-21 23:54:49,Y,Y,-oth-,Highschool,,6,,,,,,,,,,,,,,,,,,,,,,,,,,,,,,,,,0,6.0,5.0,5.0,3.0,6.0,7.0,5.0,5.0,5.0,5.0,6.0,6.0,5.0,5.0,5.0,4.0,6.0,4.0,5.0,6.0,4.0,6.0,6.0,6.0,5.0,6.0,3.0,6.0,4.0,6.0,6.0,2.0,12,,,,,,,,,,,,,,,,,,,,,,,,,,,,,,,,,14,,,,,,,,,,,,,,,,,,,,,,,,,,,,,,,,,11,,,,,,,,,,,,,,,,,,,,,,,,,,,,,,,,,13,,,,,,,,,,,,,,,,,,,,,,,,,,,,,,,,,10,,,,,,,,,,,,,,,,,,,,,,,,,,,,,,,,,4,,,,,,,,,,,,,,,,,,,,,,,,,,,,,,,,,8,,,,,,,,,,,,,,,,,,,,,,,,,,,,,,,,,1,2.0,1.0,1.0,2.0,3.0,3.0,7.0,1.0,2.0,1.0,1.0,2.0,2.0,2.0,5.0,2.0,5.0,4.0,3.0,2.0,2.0,5.0,5.0,1.0,4.0,5.0,2.0,2.0,3.0,2.0,4.0,3.0,7,,,,,,,,,,,,,,,,,,,,,,,,,,,,,,,,,9,,,,,,,,,,,,,,,,,,,,,,,,,,,,,,,,,5,,,,,,,,,,,,,,,,,,,,,,,,,,,,,,,,,3,,,,,,,,,,,,,,,,,,,,,,,,,,,,,,,,,2,5.0,5.0,5.0,5.0,5.0,4.0,6.0,6.0,5.0,5.0,6.0,6.0,5.0,3.0,5.0,4.0,5.0,3.0,6.0,3.0,3.0,5.0,5.0,5.0,4.0,5.0,5.0,5.0,5.0,4.0,3.0,1.0,,637.31,28.41,,,,17.74,,84.56,,,,,116.76,,,,,,,,,,,,,,,,,,,,,,,,193.2,,,,,,,,,,,,,,,188.2,,,8.44,,APPROVED,Male,22.0,FALSE
363,2022-03-21 23:48:39,19,en,923634655,2022-03-21 23:42:28,2022-03-21 23:48:39,Y,Y,A1,,,4,,,,,,,,,,,,,,,,,,,,,,,,,,,,,,,,,8,,,,,,,,,,,,,,,,,,,,,,,,,,,,,,,,,14,,,,,,,,,,,,,,,,,,,,,,,,,,,,,,,,,1,6.0,7.0,7.0,5.0,7.0,5.0,4.0,7.0,7.0,6.0,7.0,7.0,7.0,7.0,7.0,5.0,7.0,6.0,7.0,7.0,7.0,7.0,6.0,7.0,7.0,6.0,4.0,7.0,7.0,7.0,7.0,4.0,6,,,,,,,,,,,,,,,,,,,,,,,,,,,,,,,,,5,,,,,,,,,,,,,,,,,,,,,,,,,,,,,,,,,3,,,,,,,,,,,,,,,,,,,,,,,,,,,,,,,,,0,2.0,2.0,2.0,2.0,1.0,1.0,7.0,4.0,1.0,2.0,1.0,3.0,2.0,3.0,2.0,2.0,3.0,2.0,3.0,2.0,1.0,2.0,1.0,2.0,2.0,2.0,4.0,1.0,3.0,2.0,2.0,1.0,7,,,,,,,,,,,,,,,,,,,,,,,,,,,,,,,,,13,,,,,,,,,,,,,,,,,,,,,,,,,,,,,,,,,12,,,,,,,,,,,,,,,,,,,,,,,,,,,,,,,,,2,3.0,6.0,3.0,5.0,4.0,3.0,4.0,6.0,5.0,3.0,2.0,4.0,3.0,3.0,3.0,5.0,3.0,3.0,4.0,3.0,3.0,3.0,4.0,3.0,3.0,4.0,4.0,3.0,5.0,4.0,3.0,5.0,10,,,,,,,,,,,,,,,,,,,,,,,,,,,,,,,,,9,,,,,,,,,,,,,,,,,,,,,,,,,,,,,,,,,11,,,,,,,,,,,,,,,,,,,,,,,,,,,,,,,,,,316.22,9.9,,,,6.13,,9.6,,,,,,,,,,,59.26,,,,,,,,,,,,146.46,,,,,,,,,,,,81.7,,,,,,,,,,,,3.17,,APPROVED,Male,25.0,FALSE
365,2022-03-21 23:47:44,19,en,1907886685,2022-03-21 23:42:35,2022-03-21 23:47:44,Y,Y,A2,,,1,6.0,6.0,5.0,3.0,5.0,3.0,4.0,5.0,7.0,5.0,5.0,4.0,5.0,4.0,5.0,5.0,6.0,4.0,5.0,4.0,5.0,5.0,2.0,6.0,5.0,4.0,4.0,5.0,6.0,4.0,5.0,1.0,6,,,,,,,,,,,,,,,,,,,,,,,,,,,,,,,,,4,,,,,,,,,,,,,,,,,,,,,,,,,,,,,,,,,13,,,,,,,,,,,,,,,,,,,,,,,,,,,,,,,,,9,,,,,,,,,,,,,,,,,,,,,,,,,,,,,,,,,5,,,,,,,,,,,,,,,,,,,,,,,,,,,,,,,,,3,,,,,,,,,,,,,,,,,,,,,,,,,,,,,,,,,10,,,,,,,,,,,,,,,,,,,,,,,,,,,,,,,,,0,2.0,2.0,1.0,2.0,2.0,3.0,2.0,3.0,1.0,2.0,1.0,2.0,1.0,2.0,1.0,2.0,1.0,2.0,2.0,2.0,2.0,2.0,4.0,2.0,1.0,2.0,1.0,2.0,2.0,2.0,2.0,2.0,7,,,,,,,,,,,,,,,,,,,,,,,,,,,,,,,,,11,,,,,,,,,,,,,,,,,,,,,,,,,,,,,,,,,12,,,,,,,,,,,,,,,,,,,,,,,,,,,,,,,,,14,,,,,,,,,,,,,,,,,,,,,,,,,,,,,,,,,2,5.0,4.0,3.0,5.0,3.0,5.0,4.0,6.0,5.0,3.0,4.0,4.0,4.0,4.0,5.0,4.0,5.0,5.0,5.0,3.0,3.0,3.0,6.0,3.0,4.0,4.0,4.0,3.0,5.0,3.0,6.0,7.0,8,,,,,,,,,,,,,,,,,,,,,,,,,,,,,,,,,,197.56,12.13,,,,3.66,,24.11,,56.35,,,,,,,,,,,,,,,,,,,,,,,,42.17,,,,,,,,,,,,,,,54.68,,,,,,4.46,,APPROVED,Male,24.0,FALSE
366,2022-03-21 23:49:01,19,en,1713415469,2022-03-21 23:42:43,2022-03-21 23:49:01,Y,Y,A1,,,3,,,,,,,,,,,,,,,,,,,,,,,,,,,,,,,,,4,,,,,,,,,,,,,,,,,,,,,,,,,,,,,,,,,8,,,,,,,,,,,,,,,,,,,,,,,,,,,,,,,,,7,,,,,,,,,,,,,,,,,,,,,,,,,,,,,,,,,2,6.0,6.0,6.0,6.0,6.0,6.0,4.0,6.0,6.0,6.0,6.0,6.0,5.0,6.0,7.0,5.0,6.0,6.0,5.0,5.0,6.0,7.0,6.0,6.0,6.0,6.0,2.0,5.0,6.0,3.0,6.0,5.0,10,,,,,,,,,,,,,,,,,,,,,,,,,,,,,,,,,14,,,,,,,,,,,,,,,,,,,,,,,,,,,,,,,,,13,,,,,,,,,,,,,,,,,,,,,,,,,,,,,,,,,0,3.0,5.0,3.0,5.0,3.0,1.0,2.0,4.0,1.0,2.0,2.0,2.0,2.0,2.0,2.0,3.0,6.0,5.0,1.0,3.0,2.0,1.0,1.0,2.0,1.0,2.0,2.0,2.0,5.0,5.0,1.0,2.0,6,,,,,,,,,,,,,,,,,,,,,,,,,,,,,,,,,12,,,,,,,,,,,,,,,,,,,,,,,,,,,,,,,,,9,,,,,,,,,,,,,,,,,,,,,,,,,,,,,,,,,11,,,,,,,,,,,,,,,,,,,,,,,,,,,,,,,,,1,5.0,5.0,3.0,5.0,4.0,5.0,4.0,5.0,6.0,3.0,5.0,3.0,5.0,5.0,3.0,5.0,6.0,3.0,5.0,4.0,4.0,5.0,3.0,3.0,5.0,3.0,6.0,3.0,5.0,2.0,3.0,7.0,5,,,,,,,,,,,,,,,,,,,,,,,,,,,,,,,,,,379.5,11.55,,,,4.98,,35.99,,,,,,,,,,,,,,125.94,,,,,,,,,,,,99.29,,,,,,,,,,,,,,,98.03,,,,,,3.72,,APPROVED,Male,21.0,FALSE
368,2022-03-21 23:57:47,19,en,2005107369,2022-03-21 23:42:48,2022-03-21 23:57:47,Y,Y,A1,,,2,7.0,7.0,7.0,3.0,7.0,2.0,5.0,3.0,7.0,7.0,5.0,4.0,5.0,6.0,7.0,6.0,7.0,4.0,7.0,7.0,4.0,7.0,3.0,6.0,7.0,3.0,5.0,6.0,3.0,5.0,7.0,1.0,5,,,,,,,,,,,,,,,,,,,,,,,,,,,,,,,,,1,1.0,1.0,7.0,3.0,7.0,4.0,5.0,7.0,7.0,7.0,4.0,1.0,7.0,1.0,7.0,4.0,1.0,6.0,6.0,6.0,5.0,2.0,4.0,5.0,7.0,4.0,1.0,7.0,5.0,7.0,1.0,3.0,12,,,,,,,,,,,,,,,,,,,,,,,,,,,,,,,,,0,1.0,6.0,4.0,1.0,2.0,1.0,7.0,1.0,4.0,2.0,1.0,2.0,1.0,3.0,6.0,1.0,3.0,1.0,1.0,1.0,1.0,2.0,1.0,1.0,2.0,1.0,4.0,1.0,1.0,2.0,2.0,5.0,11,,,,,,,,,,,,,,,,,,,,,,,,,,,,,,,,,14,,,,,,,,,,,,,,,,,,,,,,,,,,,,,,,,,10,,,,,,,,,,,,,,,,,,,,,,,,,,,,,,,,,8,,,,,,,,,,,,,,,,,,,,,,,,,,,,,,,,,4,,,,,,,,,,,,,,,,,,,,,,,,,,,,,,,,,9,,,,,,,,,,,,,,,,,,,,,,,,,,,,,,,,,6,,,,,,,,,,,,,,,,,,,,,,,,,,,,,,,,,7,,,,,,,,,,,,,,,,,,,,,,,,,,,,,,,,,13,,,,,,,,,,,,,,,,,,,,,,,,,,,,,,,,,3,,,,,,,,,,,,,,,,,,,,,,,,,,,,,,,,,These were very interesting pictures. Although I did not understand why I had to tick under words that meant the same thing.,902.89,120.39,,,,26.85,,36.15,,280.8,,,,,,172.1,,,,,,163.67,,,,,,,,,,,,,,,,,,,,,,,,,,,,,,,,,102.93,,APPROVED,Female,23.0,FALSE
371,2022-03-21 23:49:42,19,en,383182110,2022-03-21 23:43:00,2022-03-21 23:49:42,Y,Y,A1,,,12,,,,,,,,,,,,,,,,,,,,,,,,,,,,,,,,,10,,,,,,,,,,,,,,,,,,,,,,,,,,,,,,,,,9,,,,,,,,,,,,,,,,,,,,,,,,,,,,,,,,,11,,,,,,,,,,,,,,,,,,,,,,,,,,,,,,,,,6,,,,,,,,,,,,,,,,,,,,,,,,,,,,,,,,,1,6.0,6.0,7.0,3.0,5.0,5.0,3.0,5.0,6.0,5.0,2.0,7.0,7.0,6.0,7.0,3.0,7.0,4.0,5.0,4.0,5.0,5.0,3.0,5.0,4.0,3.0,4.0,5.0,4.0,7.0,5.0,6.0,7,,,,,,,,,,,,,,,,,,,,,,,,,,,,,,,,,4,,,,,,,,,,,,,,,,,,,,,,,,,,,,,,,,,3,,,,,,,,,,,,,,,,,,,,,,,,,,,,,,,,,0,2.0,7.0,2.0,1.0,1.0,1.0,7.0,1.0,5.0,2.0,1.0,1.0,3.0,5.0,5.0,2.0,5.0,1.0,4.0,1.0,2.0,2.0,1.0,1.0,3.0,3.0,7.0,2.0,6.0,3.0,1.0,1.0,2,2.0,7.0,5.0,6.0,3.0,2.0,5.0,6.0,7.0,4.0,6.0,6.0,4.0,6.0,5.0,6.0,6.0,3.0,5.0,4.0,3.0,7.0,3.0,2.0,3.0,5.0,6.0,3.0,5.0,4.0,4.0,4.0,5,,,,,,,,,,,,,,,,,,,,,,,,,,,,,,,,,14,,,,,,,,,,,,,,,,,,,,,,,,,,,,,,,,,13,,,,,,,,,,,,,,,,,,,,,,,,,,,,,,,,,8,,,,,,,,,,,,,,,,,,,,,,,,,,,,,,,,,,331.2,30.38,,,,11.73,,36.28,,,,,,,,,,,,,,,,,86.65,,,,,,,,,,,,77.5,,,83.94,,,,,,,,,,,,,,,4.72,,APPROVED,Male,23.0,FALSE
377,2022-03-21 23:50:09,19,en,1855465506,2022-03-21 23:43:21,2022-03-21 23:50:09,Y,Y,-oth-,High school equvilent,,8,,,,,,,,,,,,,,,,,,,,,,,,,,,,,,,,,11,,,,,,,,,,,,,,,,,,,,,,,,,,,,,,,,,6,,,,,,,,,,,,,,,,,,,,,,,,,,,,,,,,,10,,,,,,,,,,,,,,,,,,,,,,,,,,,,,,,,,13,,,,,,,,,,,,,,,,,,,,,,,,,,,,,,,,,2,1.0,1.0,1.0,1.0,1.0,7.0,7.0,7.0,5.0,1.0,7.0,1.0,5.0,1.0,1.0,1.0,6.0,1.0,1.0,1.0,1.0,6.0,6.0,1.0,1.0,7.0,1.0,1.0,1.0,1.0,7.0,6.0,14,,,,,,,,,,,,,,,,,,,,,,,,,,,,,,,,,9,,,,,,,,,,,,,,,,,,,,,,,,,,,,,,,,,12,,,,,,,,,,,,,,,,,,,,,,,,,,,,,,,,,4,,,,,,,,,,,,,,,,,,,,,,,,,,,,,,,,,5,,,,,,,,,,,,,,,,,,,,,,,,,,,,,,,,,7,,,,,,,,,,,,,,,,,,,,,,,,,,,,,,,,,3,,,,,,,,,,,,,,,,,,,,,,,,,,,,,,,,,1,1.0,7.0,1.0,7.0,1.0,3.0,1.0,1.0,1.0,1.0,7.0,1.0,1.0,1.0,1.0,1.0,1.0,1.0,1.0,1.0,1.0,1.0,7.0,1.0,1.0,7.0,1.0,1.0,1.0,1.0,7.0,7.0,0,1.0,7.0,1.0,6.0,5.0,7.0,7.0,7.0,6.0,1.0,6.0,1.0,5.0,1.0,1.0,5.0,6.0,1.0,5.0,1.0,1.0,4.0,7.0,5.0,5.0,7.0,1.0,6.0,4.0,1.0,5.0,1.0,,298.03,5.43,,,,21.98,,19.6,,,,,,,,,,,,,,,,,34.65,,,,,,,,,,,,,,,,,,,,,,,,60.42,,,135.22,,,20.73,,APPROVED,Male,19.0,FALSE
378,2022-03-21 23:48:51,19,en,810095903,2022-03-21 23:43:21,2022-03-21 23:48:51,Y,Y,A1,,,14,,,,,,,,,,,,,,,,,,,,,,,,,,,,,,,,,9,,,,,,,,,,,,,,,,,,,,,,,,,,,,,,,,,1,5.0,7.0,7.0,5.0,7.0,6.0,1.0,7.0,7.0,6.0,3.0,6.0,7.0,6.0,7.0,7.0,6.0,6.0,7.0,7.0,5.0,6.0,3.0,7.0,7.0,5.0,2.0,7.0,4.0,5.0,7.0,3.0,4,,,,,,,,,,,,,,,,,,,,,,,,,,,,,,,,,2,5.0,5.0,6.0,3.0,5.0,3.0,6.0,7.0,5.0,3.0,2.0,3.0,6.0,5.0,7.0,3.0,6.0,6.0,6.0,4.0,5.0,6.0,3.0,5.0,6.0,7.0,1.0,3.0,6.0,6.0,6.0,5.0,3,,,,,,,,,,,,,,,,,,,,,,,,,,,,,,,,,8,,,,,,,,,,,,,,,,,,,,,,,,,,,,,,,,,13,,,,,,,,,,,,,,,,,,,,,,,,,,,,,,,,,0,3.0,1.0,1.0,3.0,2.0,3.0,4.0,1.0,1.0,1.0,1.0,4.0,1.0,1.0,2.0,1.0,3.0,1.0,1.0,2.0,1.0,1.0,6.0,1.0,1.0,6.0,1.0,3.0,6.0,1.0,4.0,2.0,11,,,,,,,,,,,,,,,,,,,,,,,,,,,,,,,,,10,,,,,,,,,,,,,,,,,,,,,,,,,,,,,,,,,7,,,,,,,,,,,,,,,,,,,,,,,,,,,,,,,,,12,,,,,,,,,,,,,,,,,,,,,,,,,,,,,,,,,5,,,,,,,,,,,,,,,,,,,,,,,,,,,,,,,,,6,,,,,,,,,,,,,,,,,,,,,,,,,,,,,,,,,,307.09,9.54,,,,8.15,,16.94,,,,,,,,65.81,,,,,,113.35,,,,,,,,,,,,90.71,,,,,,,,,,,,,,,,,,,,,2.59,,APPROVED,Male,24.0,FALSE
379,2022-03-21 23:51:11,19,en,738358662,2022-03-21 23:43:23,2022-03-21 23:51:11,Y,Y,A2,,,0,5.0,5.0,5.0,3.0,4.0,2.0,5.0,4.0,5.0,1.0,3.0,5.0,4.0,4.0,3.0,3.0,5.0,5.0,4.0,1.0,4.0,5.0,1.0,4.0,4.0,4.0,4.0,3.0,4.0,3.0,4.0,1.0,2,4.0,6.0,4.0,6.0,4.0,7.0,4.0,6.0,5.0,4.0,4.0,4.0,5.0,4.0,4.0,5.0,6.0,4.0,5.0,1.0,4.0,4.0,6.0,4.0,4.0,6.0,4.0,4.0,6.0,4.0,6.0,2.0,13,,,,,,,,,,,,,,,,,,,,,,,,,,,,,,,,,14,,,,,,,,,,,,,,,,,,,,,,,,,,,,,,,,,1,2.0,1.0,1.0,1.0,1.0,1.0,1.0,1.0,2.0,1.0,1.0,2.0,1.0,1.0,2.0,1.0,3.0,1.0,1.0,1.0,1.0,1.0,1.0,1.0,1.0,1.0,1.0,2.0,1.0,1.0,1.0,1.0,10,,,,,,,,,,,,,,,,,,,,,,,,,,,,,,,,,8,,,,,,,,,,,,,,,,,,,,,,,,,,,,,,,,,3,,,,,,,,,,,,,,,,,,,,,,,,,,,,,,,,,12,,,,,,,,,,,,,,,,,,,,,,,,,,,,,,,,,7,,,,,,,,,,,,,,,,,,,,,,,,,,,,,,,,,5,,,,,,,,,,,,,,,,,,,,,,,,,,,,,,,,,4,,,,,,,,,,,,,,,,,,,,,,,,,,,,,,,,,11,,,,,,,,,,,,,,,,,,,,,,,,,,,,,,,,,9,,,,,,,,,,,,,,,,,,,,,,,,,,,,,,,,,6,,,,,,,,,,,,,,,,,,,,,,,,,,,,,,,,,I dont,383.36,18.1,,,,32.61,,86.56,,143.74,,,52.81,,,,,,,,,40.01,,,,,,,,,,,,,,,,,,,,,,,,,,,,,,,,,9.53,,APPROVED,Female,26.0,FALSE
380,2022-03-21 23:48:44,19,en,1191771135,2022-03-21 23:43:23,2022-03-21 23:48:44,Y,Y,A1,,,2,6.0,5.0,5.0,5.0,4.0,7.0,7.0,7.0,7.0,4.0,5.0,5.0,4.0,6.0,7.0,6.0,5.0,6.0,6.0,5.0,6.0,6.0,7.0,5.0,5.0,7.0,4.0,7.0,7.0,6.0,7.0,1.0,13,,,,,,,,,,,,,,,,,,,,,,,,,,,,,,,,,10,,,,,,,,,,,,,,,,,,,,,,,,,,,,,,,,,5,,,,,,,,,,,,,,,,,,,,,,,,,,,,,,,,,12,,,,,,,,,,,,,,,,,,,,,,,,,,,,,,,,,1,3.0,2.0,5.0,5.0,1.0,3.0,2.0,2.0,3.0,4.0,2.0,3.0,3.0,4.0,5.0,2.0,5.0,3.0,3.0,4.0,5.0,1.0,4.0,2.0,1.0,6.0,5.0,3.0,2.0,3.0,2.0,6.0,9,,,,,,,,,,,,,,,,,,,,,,,,,,,,,,,,,6,,,,,,,,,,,,,,,,,,,,,,,,,,,,,,,,,0,3.0,6.0,1.0,2.0,3.0,4.0,3.0,1.0,2.0,4.0,4.0,3.0,2.0,4.0,2.0,6.0,6.0,5.0,4.0,5.0,1.0,4.0,6.0,6.0,2.0,5.0,4.0,5.0,2.0,3.0,3.0,2.0,11,,,,,,,,,,,,,,,,,,,,,,,,,,,,,,,,,7,,,,,,,,,,,,,,,,,,,,,,,,,,,,,,,,,3,,,,,,,,,,,,,,,,,,,,,,,,,,,,,,,,,14,,,,,,,,,,,,,,,,,,,,,,,,,,,,,,,,,8,,,,,,,,,,,,,,,,,,,,,,,,,,,,,,,,,4,,,,,,,,,,,,,,,,,,,,,,,,,,,,,,,,,,322.94,41.67,,,,18.71,,20.6,,53.06,,,,,,,,,,,,,,,77.46,,,,,,,,,108.64,,,,,,,,,,,,,,,,,,,,,2.8,,APPROVED,Male,27.0,FALSE
381,2022-03-21 23:57:26,19,en,215726895,2022-03-21 23:43:31,2022-03-21 23:57:26,Y,Y,-oth-,High School,,5,,,,,,,,,,,,,,,,,,,,,,,,,,,,,,,,,8,,,,,,,,,,,,,,,,,,,,,,,,,,,,,,,,,7,,,,,,,,,,,,,,,,,,,,,,,,,,,,,,,,,0,4.0,4.0,3.0,3.0,3.0,3.0,6.0,4.0,4.0,2.0,4.0,2.0,2.0,3.0,4.0,2.0,5.0,4.0,2.0,2.0,2.0,3.0,3.0,3.0,2.0,4.0,4.0,3.0,5.0,2.0,3.0,4.0,3,,,,,,,,,,,,,,,,,,,,,,,,,,,,,,,,,1,2.0,2.0,2.0,3.0,2.0,2.0,7.0,3.0,2.0,4.0,2.0,2.0,4.0,3.0,2.0,3.0,3.0,3.0,4.0,4.0,2.0,3.0,2.0,2.0,4.0,2.0,4.0,1.0,3.0,3.0,2.0,6.0,11,,,,,,,,,,,,,,,,,,,,,,,,,,,,,,,,,10,,,,,,,,,,,,,,,,,,,,,,,,,,,,,,,,,14,,,,,,,,,,,,,,,,,,,,,,,,,,,,,,,,,12,,,,,,,,,,,,,,,,,,,,,,,,,,,,,,,,,2,3.0,4.0,3.0,4.0,2.0,5.0,4.0,4.0,5.0,4.0,3.0,4.0,5.0,3.0,2.0,4.0,6.0,4.0,4.0,4.0,3.0,4.0,4.0,3.0,3.0,3.0,3.0,5.0,2.0,4.0,3.0,4.0,6,,,,,,,,,,,,,,,,,,,,,,,,,,,,,,,,,13,,,,,,,,,,,,,,,,,,,,,,,,,,,,,,,,,4,,,,,,,,,,,,,,,,,,,,,,,,,,,,,,,,,9,,,,,,,,,,,,,,,,,,,,,,,,,,,,,,,,,,862.48,109.79,,,,25.47,,8.88,,,,,,,,,,,131.77,,,,,,218.57,,,,,,,,,,,,,,,363.08,,,,,,,,,,,,,,,4.92,,APPROVED,Male,21.0,FALSE
382,2022-03-22 00:06:50,19,en,1507077166,2022-03-21 23:43:40,2022-03-22 00:06:50,Y,Y,A1,,,14,,,,,,,,,,,,,,,,,,,,,,,,,,,,,,,,,10,,,,,,,,,,,,,,,,,,,,,,,,,,,,,,,,,4,,,,,,,,,,,,,,,,,,,,,,,,,,,,,,,,,13,,,,,,,,,,,,,,,,,,,,,,,,,,,,,,,,,6,,,,,,,,,,,,,,,,,,,,,,,,,,,,,,,,,0,4.0,3.0,2.0,4.0,5.0,2.0,5.0,2.0,5.0,4.0,4.0,4.0,4.0,6.0,5.0,3.0,7.0,4.0,5.0,3.0,3.0,5.0,4.0,4.0,4.0,4.0,4.0,4.0,4.0,4.0,4.0,6.0,3,,,,,,,,,,,,,,,,,,,,,,,,,,,,,,,,,9,,,,,,,,,,,,,,,,,,,,,,,,,,,,,,,,,7,,,,,,,,,,,,,,,,,,,,,,,,,,,,,,,,,12,,,,,,,,,,,,,,,,,,,,,,,,,,,,,,,,,8,,,,,,,,,,,,,,,,,,,,,,,,,,,,,,,,,1,7.0,4.0,4.0,3.0,5.0,5.0,4.0,6.0,5.0,6.0,5.0,5.0,7.0,4.0,6.0,4.0,5.0,4.0,4.0,5.0,4.0,5.0,5.0,5.0,5.0,4.0,4.0,4.0,4.0,5.0,4.0,5.0,11,,,,,,,,,,,,,,,,,,,,,,,,,,,,,,,,,2,1.0,1.0,1.0,1.0,1.0,1.0,1.0,1.0,1.0,1.0,1.0,1.0,1.0,1.0,6.0,1.0,5.0,1.0,1.0,1.0,1.0,1.0,1.0,1.0,1.0,1.0,7.0,1.0,1.0,1.0,1.0,7.0,5,,,,,,,,,,,,,,,,,,,,,,,,,,,,,,,,,,189.35,17.83,,,,12.95,,8.96,,,,,,,,,,,,,,,,,75.07,,,,,,,,,,,,,,,,,,41.46,,,,,,29.93,,,,,,3.15,,APPROVED,Male,26.0,FALSE
384,2022-03-21 23:49:36,19,en,2093752655,2022-03-21 23:43:49,2022-03-21 23:49:36,Y,Y,A1,,,7,,,,,,,,,,,,,,,,,,,,,,,,,,,,,,,,,13,,,,,,,,,,,,,,,,,,,,,,,,,,,,,,,,,6,,,,,,,,,,,,,,,,,,,,,,,,,,,,,,,,,10,,,,,,,,,,,,,,,,,,,,,,,,,,,,,,,,,8,,,,,,,,,,,,,,,,,,,,,,,,,,,,,,,,,1,4.0,4.0,4.0,5.0,4.0,3.0,4.0,4.0,5.0,4.0,4.0,4.0,4.0,4.0,4.0,4.0,4.0,4.0,4.0,4.0,4.0,4.0,4.0,3.0,4.0,4.0,4.0,4.0,4.0,4.0,3.0,6.0,14,,,,,,,,,,,,,,,,,,,,,,,,,,,,,,,,,9,,,,,,,,,,,,,,,,,,,,,,,,,,,,,,,,,11,,,,,,,,,,,,,,,,,,,,,,,,,,,,,,,,,3,,,,,,,,,,,,,,,,,,,,,,,,,,,,,,,,,12,,,,,,,,,,,,,,,,,,,,,,,,,,,,,,,,,4,,,,,,,,,,,,,,,,,,,,,,,,,,,,,,,,,5,,,,,,,,,,,,,,,,,,,,,,,,,,,,,,,,,2,4.0,4.0,4.0,5.0,4.0,5.0,4.0,4.0,4.0,4.0,4.0,4.0,4.0,4.0,5.0,4.0,5.0,4.0,4.0,4.0,4.0,4.0,4.0,4.0,4.0,4.0,4.0,4.0,4.0,4.0,5.0,7.0,0,4.0,5.0,4.0,4.0,4.0,4.0,4.0,4.0,5.0,4.0,4.0,4.0,4.0,4.0,4.0,4.0,4.0,4.0,4.0,4.0,4.0,4.0,4.0,4.0,4.0,4.0,4.0,4.0,4.0,4.0,4.0,1.0,,325.57,14.52,,,,66.7,,36.64,,,,,,,,,,,,,,,,,82.04,,,,,,,,,,,,,,,,,,,,,,,,60.13,,,61.71,,,3.83,,APPROVED,Male,25.0,FALSE
386,2022-03-21 23:49:51,19,en,231758081,2022-03-21 23:44:04,2022-03-21 23:49:51,Y,Y,A2,,,11,,,,,,,,,,,,,,,,,,,,,,,,,,,,,,,,,5,,,,,,,,,,,,,,,,,,,,,,,,,,,,,,,,,9,,,,,,,,,,,,,,,,,,,,,,,,,,,,,,,,,14,,,,,,,,,,,,,,,,,,,,,,,,,,,,,,,,,3,,,,,,,,,,,,,,,,,,,,,,,,,,,,,,,,,7,,,,,,,,,,,,,,,,,,,,,,,,,,,,,,,,,8,,,,,,,,,,,,,,,,,,,,,,,,,,,,,,,,,1,1.0,5.0,2.0,2.0,3.0,2.0,3.0,2.0,5.0,2.0,3.0,2.0,3.0,3.0,5.0,3.0,5.0,1.0,3.0,2.0,1.0,3.0,2.0,2.0,1.0,5.0,4.0,2.0,2.0,3.0,3.0,1.0,2,1.0,5.0,1.0,2.0,1.0,1.0,4.0,1.0,5.0,1.0,1.0,1.0,1.0,1.0,1.0,1.0,1.0,1.0,1.0,1.0,1.0,3.0,2.0,1.0,1.0,3.0,1.0,1.0,2.0,1.0,2.0,2.0,6,,,,,,,,,,,,,,,,,,,,,,,,,,,,,,,,,4,,,,,,,,,,,,,,,,,,,,,,,,,,,,,,,,,13,,,,,,,,,,,,,,,,,,,,,,,,,,,,,,,,,10,,,,,,,,,,,,,,,,,,,,,,,,,,,,,,,,,12,,,,,,,,,,,,,,,,,,,,,,,,,,,,,,,,,0,7.0,7.0,6.0,6.0,7.0,6.0,4.0,7.0,7.0,7.0,7.0,7.0,6.0,7.0,5.0,7.0,7.0,6.0,7.0,6.0,5.0,7.0,7.0,6.0,7.0,7.0,4.0,7.0,7.0,6.0,7.0,1.0,"Thank you for the opportunity, interesting study!",348.98,36.94,,,,8.89,,39.66,,,,,,,,,,,,,,,,,,,,,,,83.96,,,85.31,,,,,,,,,,,,,,,,,,65.75,,,28.47,,APPROVED,Female,21.0,FALSE
388,2022-03-21 23:48:19,19,en,1452258039,2022-03-21 23:44:22,2022-03-21 23:48:19,Y,Y,A1,,,8,,,,,,,,,,,,,,,,,,,,,,,,,,,,,,,,,1,5.0,5.0,6.0,6.0,5.0,6.0,5.0,5.0,6.0,5.0,6.0,5.0,5.0,6.0,5.0,5.0,6.0,4.0,7.0,6.0,6.0,6.0,6.0,5.0,6.0,6.0,5.0,5.0,6.0,5.0,6.0,2.0,12,,,,,,,,,,,,,,,,,,,,,,,,,,,,,,,,,2,6.0,6.0,5.0,5.0,5.0,5.0,6.0,5.0,6.0,4.0,6.0,5.0,5.0,5.0,6.0,6.0,6.0,5.0,5.0,5.0,5.0,6.0,5.0,6.0,5.0,6.0,5.0,6.0,5.0,5.0,6.0,4.0,7,,,,,,,,,,,,,,,,,,,,,,,,,,,,,,,,,3,,,,,,,,,,,,,,,,,,,,,,,,,,,,,,,,,9,,,,,,,,,,,,,,,,,,,,,,,,,,,,,,,,,4,,,,,,,,,,,,,,,,,,,,,,,,,,,,,,,,,11,,,,,,,,,,,,,,,,,,,,,,,,,,,,,,,,,13,,,,,,,,,,,,,,,,,,,,,,,,,,,,,,,,,10,,,,,,,,,,,,,,,,,,,,,,,,,,,,,,,,,6,,,,,,,,,,,,,,,,,,,,,,,,,,,,,,,,,5,,,,,,,,,,,,,,,,,,,,,,,,,,,,,,,,,0,5.0,5.0,3.0,5.0,3.0,5.0,4.0,4.0,4.0,4.0,3.0,5.0,4.0,3.0,4.0,4.0,5.0,3.0,5.0,5.0,4.0,4.0,5.0,3.0,3.0,3.0,3.0,3.0,3.0,3.0,2.0,7.0,14,,,,,,,,,,,,,,,,,,,,,,,,,,,,,,,,,,239.93,20.46,,,,43.73,,38.39,,,,,41.91,,,,,,44.05,,,,,,,,,,,,,,,,,,,,,,,,,,,,,,48.3,,,,,,3.09,,APPROVED,Male,19.0,FALSE
389,2022-03-21 23:51:42,19,en,408241620,2022-03-21 23:44:22,2022-03-21 23:51:42,Y,Y,A2,,,12,,,,,,,,,,,,,,,,,,,,,,,,,,,,,,,,,11,,,,,,,,,,,,,,,,,,,,,,,,,,,,,,,,,14,,,,,,,,,,,,,,,,,,,,,,,,,,,,,,,,,13,,,,,,,,,,,,,,,,,,,,,,,,,,,,,,,,,10,,,,,,,,,,,,,,,,,,,,,,,,,,,,,,,,,0,2.0,4.0,2.0,1.0,1.0,2.0,2.0,5.0,1.0,1.0,2.0,2.0,1.0,2.0,1.0,1.0,1.0,1.0,2.0,2.0,1.0,1.0,1.0,1.0,2.0,1.0,1.0,1.0,3.0,1.0,2.0,6.0,1,6.0,5.0,5.0,6.0,5.0,6.0,5.0,5.0,5.0,4.0,5.0,6.0,5.0,3.0,5.0,6.0,6.0,5.0,5.0,4.0,3.0,5.0,6.0,4.0,3.0,4.0,3.0,6.0,5.0,4.0,4.0,7.0,3,,,,,,,,,,,,,,,,,,,,,,,,,,,,,,,,,6,,,,,,,,,,,,,,,,,,,,,,,,,,,,,,,,,4,,,,,,,,,,,,,,,,,,,,,,,,,,,,,,,,,2,2.0,6.0,1.0,1.0,2.0,1.0,2.0,4.0,6.0,2.0,2.0,2.0,1.0,2.0,2.0,2.0,5.0,3.0,2.0,2.0,2.0,2.0,2.0,3.0,2.0,3.0,3.0,5.0,2.0,3.0,5.0,4.0,5,,,,,,,,,,,,,,,,,,,,,,,,,,,,,,,,,9,,,,,,,,,,,,,,,,,,,,,,,,,,,,,,,,,7,,,,,,,,,,,,,,,,,,,,,,,,,,,,,,,,,8,,,,,,,,,,,,,,,,,,,,,,,,,,,,,,,,,,441.73,22.72,,,,10.92,,176.9,,,,,,,,,,,,,,,,,93.09,,,60.62,,,,,,,,,,,,74.19,,,,,,,,,,,,,,,3.29,,APPROVED,Male,26.0,FALSE
390,2022-03-21 23:50:00,19,en,1820282527,2022-03-21 23:44:22,2022-03-21 23:50:00,Y,Y,-oth-,high school,,0,1.0,5.0,1.0,1.0,1.0,1.0,7.0,1.0,6.0,2.0,1.0,1.0,1.0,1.0,1.0,1.0,1.0,1.0,1.0,1.0,1.0,1.0,1.0,1.0,1.0,1.0,5.0,1.0,4.0,1.0,1.0,1.0,1,6.0,2.0,5.0,6.0,4.0,6.0,2.0,6.0,2.0,5.0,5.0,6.0,6.0,2.0,2.0,5.0,5.0,5.0,6.0,3.0,5.0,6.0,6.0,5.0,5.0,6.0,4.0,5.0,4.0,5.0,5.0,2.0,4,,,,,,,,,,,,,,,,,,,,,,,,,,,,,,,,,5,,,,,,,,,,,,,,,,,,,,,,,,,,,,,,,,,12,,,,,,,,,,,,,,,,,,,,,,,,,,,,,,,,,6,,,,,,,,,,,,,,,,,,,,,,,,,,,,,,,,,8,,,,,,,,,,,,,,,,,,,,,,,,,,,,,,,,,2,6.0,2.0,3.0,2.0,3.0,2.0,6.0,2.0,4.0,6.0,2.0,6.0,6.0,6.0,5.0,2.0,6.0,6.0,6.0,2.0,5.0,5.0,2.0,6.0,5.0,2.0,6.0,2.0,2.0,6.0,2.0,1.0,10,,,,,,,,,,,,,,,,,,,,,,,,,,,,,,,,,13,,,,,,,,,,,,,,,,,,,,,,,,,,,,,,,,,9,,,,,,,,,,,,,,,,,,,,,,,,,,,,,,,,,14,,,,,,,,,,,,,,,,,,,,,,,,,,,,,,,,,7,,,,,,,,,,,,,,,,,,,,,,,,,,,,,,,,,3,,,,,,,,,,,,,,,,,,,,,,,,,,,,,,,,,11,,,,,,,,,,,,,,,,,,,,,,,,,,,,,,,,,,339.13,37.67,,,,18.44,,27.67,,59.93,,,80.52,,,,,,,,,,,,,,,,,,111.8,,,,,,,,,,,,,,,,,,,,,,,,3.1,,APPROVED,Male,19.0,FALSE
393,2022-03-21 23:52:51,19,en,169375085,2022-03-21 23:44:46,2022-03-21 23:52:51,Y,Y,A1,,,2,5.0,6.0,4.0,4.0,4.0,4.0,4.0,2.0,4.0,4.0,4.0,5.0,5.0,6.0,6.0,5.0,6.0,5.0,5.0,4.0,4.0,5.0,3.0,4.0,5.0,4.0,6.0,5.0,5.0,5.0,5.0,1.0,4,,,,,,,,,,,,,,,,,,,,,,,,,,,,,,,,,5,,,,,,,,,,,,,,,,,,,,,,,,,,,,,,,,,10,,,,,,,,,,,,,,,,,,,,,,,,,,,,,,,,,6,,,,,,,,,,,,,,,,,,,,,,,,,,,,,,,,,1,3.0,5.0,3.0,4.0,5.0,3.0,4.0,6.0,5.0,3.0,3.0,4.0,3.0,4.0,5.0,4.0,4.0,4.0,3.0,4.0,2.0,4.0,3.0,3.0,5.0,4.0,4.0,3.0,5.0,4.0,3.0,6.0,3,,,,,,,,,,,,,,,,,,,,,,,,,,,,,,,,,13,,,,,,,,,,,,,,,,,,,,,,,,,,,,,,,,,11,,,,,,,,,,,,,,,,,,,,,,,,,,,,,,,,,9,,,,,,,,,,,,,,,,,,,,,,,,,,,,,,,,,7,,,,,,,,,,,,,,,,,,,,,,,,,,,,,,,,,14,,,,,,,,,,,,,,,,,,,,,,,,,,,,,,,,,0,5.0,3.0,5.0,4.0,4.0,3.0,5.0,4.0,4.0,4.0,3.0,3.0,4.0,5.0,5.0,4.0,5.0,5.0,5.0,4.0,4.0,4.0,3.0,5.0,4.0,5.0,4.0,4.0,5.0,4.0,4.0,6.0,8,,,,,,,,,,,,,,,,,,,,,,,,,,,,,,,,,12,,,,,,,,,,,,,,,,,,,,,,,,,,,,,,,,,I lreally liked this study; the second image gave me very mixed feelings,487.82,51.79,,,,46.18,,38.32,,86.41,,,,,,,,,,,,,,,113.12,,,,,,,,,,,,,,,,,,,,,112.37,,,,,,,,,39.63,,APPROVED,Female,20.0,FALSE
394,2022-03-21 23:48:46,19,en,836560747,2022-03-21 23:44:55,2022-03-21 23:48:46,Y,Y,A1,,,9,,,,,,,,,,,,,,,,,,,,,,,,,,,,,,,,,10,,,,,,,,,,,,,,,,,,,,,,,,,,,,,,,,,2,4.0,7.0,5.0,4.0,3.0,3.0,6.0,5.0,4.0,5.0,5.0,4.0,5.0,5.0,4.0,6.0,6.0,5.0,6.0,4.0,4.0,6.0,5.0,3.0,3.0,6.0,7.0,5.0,7.0,5.0,4.0,3.0,3,,,,,,,,,,,,,,,,,,,,,,,,,,,,,,,,,13,,,,,,,,,,,,,,,,,,,,,,,,,,,,,,,,,1,3.0,4.0,2.0,3.0,3.0,2.0,7.0,4.0,5.0,3.0,3.0,5.0,3.0,4.0,3.0,3.0,3.0,4.0,4.0,3.0,3.0,5.0,4.0,3.0,4.0,7.0,5.0,2.0,7.0,3.0,5.0,6.0,4,,,,,,,,,,,,,,,,,,,,,,,,,,,,,,,,,8,,,,,,,,,,,,,,,,,,,,,,,,,,,,,,,,,7,,,,,,,,,,,,,,,,,,,,,,,,,,,,,,,,,11,,,,,,,,,,,,,,,,,,,,,,,,,,,,,,,,,0,4.0,7.0,3.0,6.0,4.0,2.0,7.0,6.0,6.0,6.0,5.0,6.0,4.0,5.0,5.0,5.0,5.0,4.0,5.0,4.0,4.0,6.0,3.0,6.0,4.0,6.0,5.0,6.0,7.0,5.0,5.0,4.0,14,,,,,,,,,,,,,,,,,,,,,,,,,,,,,,,,,6,,,,,,,,,,,,,,,,,,,,,,,,,,,,,,,,,5,,,,,,,,,,,,,,,,,,,,,,,,,,,,,,,,,12,,,,,,,,,,,,,,,,,,,,,,,,,,,,,,,,,,232.11,13.52,,,,5.51,,16.54,,,,,,,,62.62,,,,,,,,,61.94,,,,,,,,,,,,,,,68.11,,,,,,,,,,,,,,,3.87,,APPROVED,Male,29.0,FALSE
395,2022-03-21 23:48:46,19,en,2135991424,2022-03-21 23:44:59,2022-03-21 23:48:46,Y,Y,A1,,,13,,,,,,,,,,,,,,,,,,,,,,,,,,,,,,,,,6,,,,,,,,,,,,,,,,,,,,,,,,,,,,,,,,,5,,,,,,,,,,,,,,,,,,,,,,,,,,,,,,,,,2,5.0,6.0,5.0,6.0,5.0,6.0,3.0,5.0,6.0,5.0,6.0,6.0,6.0,5.0,5.0,5.0,6.0,5.0,6.0,5.0,6.0,6.0,6.0,5.0,6.0,6.0,5.0,6.0,5.0,6.0,6.0,4.0,7,,,,,,,,,,,,,,,,,,,,,,,,,,,,,,,,,8,,,,,,,,,,,,,,,,,,,,,,,,,,,,,,,,,3,,,,,,,,,,,,,,,,,,,,,,,,,,,,,,,,,11,,,,,,,,,,,,,,,,,,,,,,,,,,,,,,,,,12,,,,,,,,,,,,,,,,,,,,,,,,,,,,,,,,,10,,,,,,,,,,,,,,,,,,,,,,,,,,,,,,,,,0,2.0,3.0,3.0,3.0,3.0,2.0,7.0,3.0,3.0,3.0,3.0,3.0,5.0,3.0,3.0,3.0,5.0,3.0,3.0,3.0,3.0,3.0,3.0,3.0,3.0,2.0,3.0,3.0,3.0,3.0,2.0,4.0,1,6.0,6.0,5.0,6.0,5.0,6.0,3.0,6.0,6.0,6.0,6.0,6.0,6.0,5.0,5.0,6.0,6.0,5.0,5.0,5.0,5.0,6.0,6.0,6.0,6.0,6.0,5.0,6.0,6.0,6.0,6.0,5.0,9,,,,,,,,,,,,,,,,,,,,,,,,,,,,,,,,,4,,,,,,,,,,,,,,,,,,,,,,,,,,,,,,,,,14,,,,,,,,,,,,,,,,,,,,,,,,,,,,,,,,,,229.94,21.32,,,,4.29,,18.8,,,,,,,,,,,68.7,,,,,,,,,,,,,,,,,,,,,56.53,,,41.55,,,,,,,,,,,,18.75,,APPROVED,Male,28.0,FALSE
396,2022-03-21 23:51:44,19,en,2008887540,2022-03-21 23:45:02,2022-03-21 23:51:44,Y,Y,A1,,,6,,,,,,,,,,,,,,,,,,,,,,,,,,,,,,,,,3,,,,,,,,,,,,,,,,,,,,,,,,,,,,,,,,,2,7.0,6.0,6.0,6.0,6.0,7.0,6.0,7.0,6.0,5.0,6.0,7.0,6.0,6.0,6.0,6.0,6.0,6.0,6.0,6.0,6.0,7.0,7.0,6.0,6.0,6.0,4.0,6.0,6.0,4.0,7.0,3.0,5,,,,,,,,,,,,,,,,,,,,,,,,,,,,,,,,,10,,,,,,,,,,,,,,,,,,,,,,,,,,,,,,,,,13,,,,,,,,,,,,,,,,,,,,,,,,,,,,,,,,,1,2.0,1.0,2.0,2.0,2.0,3.0,4.0,2.0,3.0,2.0,2.0,2.0,2.0,2.0,1.0,3.0,2.0,2.0,2.0,2.0,2.0,3.0,2.0,2.0,1.0,2.0,2.0,2.0,3.0,2.0,2.0,1.0,11,,,,,,,,,,,,,,,,,,,,,,,,,,,,,,,,,9,,,,,,,,,,,,,,,,,,,,,,,,,,,,,,,,,4,,,,,,,,,,,,,,,,,,,,,,,,,,,,,,,,,7,,,,,,,,,,,,,,,,,,,,,,,,,,,,,,,,,14,,,,,,,,,,,,,,,,,,,,,,,,,,,,,,,,,8,,,,,,,,,,,,,,,,,,,,,,,,,,,,,,,,,12,,,,,,,,,,,,,,,,,,,,,,,,,,,,,,,,,0,6.0,5.0,6.0,6.0,5.0,6.0,4.0,6.0,5.0,4.0,5.0,4.0,4.0,4.0,4.0,4.0,6.0,4.0,6.0,4.0,5.0,6.0,5.0,4.0,5.0,6.0,4.0,6.0,6.0,3.0,6.0,1.0,,405.02,30.67,,,,7.67,,34.56,,,,,,,,75.96,,,,,,,,,,,,132.41,,,,,,,,,,,,,,,,,,,,,,,,117.55,,,6.2,,APPROVED,Female,24.0,FALSE
397,2022-03-21 23:52:01,19,en,768615780,2022-03-21 23:45:07,2022-03-21 23:52:01,Y,Y,A1,,,3,,,,,,,,,,,,,,,,,,,,,,,,,,,,,,,,,5,,,,,,,,,,,,,,,,,,,,,,,,,,,,,,,,,11,,,,,,,,,,,,,,,,,,,,,,,,,,,,,,,,,7,,,,,,,,,,,,,,,,,,,,,,,,,,,,,,,,,13,,,,,,,,,,,,,,,,,,,,,,,,,,,,,,,,,14,,,,,,,,,,,,,,,,,,,,,,,,,,,,,,,,,8,,,,,,,,,,,,,,,,,,,,,,,,,,,,,,,,,12,,,,,,,,,,,,,,,,,,,,,,,,,,,,,,,,,0,2.0,3.0,1.0,4.0,1.0,2.0,7.0,2.0,2.0,3.0,1.0,2.0,2.0,3.0,2.0,3.0,3.0,4.0,3.0,1.0,3.0,1.0,4.0,1.0,1.0,4.0,4.0,2.0,2.0,4.0,3.0,2.0,9,,,,,,,,,,,,,,,,,,,,,,,,,,,,,,,,,4,,,,,,,,,,,,,,,,,,,,,,,,,,,,,,,,,2,5.0,4.0,4.0,4.0,4.0,4.0,3.0,4.0,5.0,4.0,3.0,4.0,4.0,5.0,5.0,5.0,5.0,4.0,4.0,4.0,5.0,4.0,4.0,4.0,4.0,4.0,4.0,5.0,4.0,4.0,4.0,5.0,1,4.0,6.0,4.0,4.0,4.0,2.0,4.0,4.0,5.0,4.0,3.0,4.0,4.0,5.0,4.0,5.0,5.0,4.0,4.0,3.0,4.0,4.0,3.0,4.0,4.0,3.0,3.0,4.0,4.0,4.0,4.0,6.0,10,,,,,,,,,,,,,,,,,,,,,,,,,,,,,,,,,6,,,,,,,,,,,,,,,,,,,,,,,,,,,,,,,,,,417.24,55.42,,,,13.61,,55.54,,,,,,,,,,,,,,,,,,,,,,,,,,122.84,,,,,,,,,73.37,,,89.25,,,,,,,,,7.21,,APPROVED,Female,33.0,FALSE
398,2022-03-21 23:58:57,19,en,1061994896,2022-03-21 23:45:07,2022-03-21 23:58:57,Y,Y,A1,,,9,,,,,,,,,,,,,,,,,,,,,,,,,,,,,,,,,12,,,,,,,,,,,,,,,,,,,,,,,,,,,,,,,,,2,5.0,5.0,6.0,7.0,7.0,6.0,4.0,6.0,6.0,4.0,6.0,6.0,6.0,6.0,6.0,6.0,6.0,6.0,6.0,6.0,6.0,6.0,6.0,6.0,5.0,6.0,4.0,6.0,4.0,2.0,6.0,1.0,7,,,,,,,,,,,,,,,,,,,,,,,,,,,,,,,,,6,,,,,,,,,,,,,,,,,,,,,,,,,,,,,,,,,3,,,,,,,,,,,,,,,,,,,,,,,,,,,,,,,,,13,,,,,,,,,,,,,,,,,,,,,,,,,,,,,,,,,11,,,,,,,,,,,,,,,,,,,,,,,,,,,,,,,,,1,5.0,3.0,3.0,2.0,4.0,4.0,5.0,4.0,5.0,4.0,5.0,5.0,3.0,4.0,4.0,3.0,4.0,5.0,5.0,4.0,4.0,4.0,3.0,4.0,4.0,4.0,4.0,4.0,4.0,1.0,3.0,2.0,8,,,,,,,,,,,,,,,,,,,,,,,,,,,,,,,,,4,,,,,,,,,,,,,,,,,,,,,,,,,,,,,,,,,14,,,,,,,,,,,,,,,,,,,,,,,,,,,,,,,,,5,,,,,,,,,,,,,,,,,,,,,,,,,,,,,,,,,0,2.0,4.0,2.0,4.0,3.0,2.0,3.0,4.0,2.0,2.0,2.0,2.0,2.0,2.0,2.0,3.0,2.0,2.0,2.0,2.0,1.0,2.0,4.0,2.0,2.0,2.0,5.0,2.0,3.0,2.0,3.0,7.0,10,,,,,,,,,,,,,,,,,,,,,,,,,,,,,,,,,,946.81,20.21,,,,14.37,,552.55,,,,,,,,120.76,,,,,,,,,,,,,,,,,,129.41,,,,,,,,,,,,,,,101.22,,,,,,8.29,,APPROVED,Male,24.0,FALSE
399,2022-03-21 23:55:48,19,en,664167383,2022-03-21 23:45:09,2022-03-21 23:55:48,Y,Y,A2,,,4,,,,,,,,,,,,,,,,,,,,,,,,,,,,,,,,,2,6.0,7.0,5.0,6.0,6.0,7.0,5.0,7.0,6.0,7.0,5.0,7.0,7.0,6.0,7.0,6.0,7.0,6.0,6.0,7.0,5.0,7.0,7.0,7.0,7.0,7.0,2.0,7.0,6.0,4.0,6.0,2.0,3,,,,,,,,,,,,,,,,,,,,,,,,,,,,,,,,,6,,,,,,,,,,,,,,,,,,,,,,,,,,,,,,,,,1,5.0,6.0,6.0,5.0,5.0,5.0,3.0,7.0,5.0,5.0,4.0,6.0,6.0,5.0,4.0,5.0,6.0,5.0,7.0,4.0,5.0,4.0,4.0,6.0,6.0,6.0,3.0,6.0,7.0,5.0,6.0,5.0,9,,,,,,,,,,,,,,,,,,,,,,,,,,,,,,,,,13,,,,,,,,,,,,,,,,,,,,,,,,,,,,,,,,,10,,,,,,,,,,,,,,,,,,,,,,,,,,,,,,,,,14,,,,,,,,,,,,,,,,,,,,,,,,,,,,,,,,,0,5.0,7.0,3.0,2.0,3.0,2.0,4.0,2.0,6.0,4.0,4.0,3.0,3.0,3.0,3.0,4.0,3.0,3.0,5.0,4.0,3.0,3.0,2.0,4.0,4.0,3.0,4.0,3.0,5.0,3.0,2.0,3.0,12,,,,,,,,,,,,,,,,,,,,,,,,,,,,,,,,,8,,,,,,,,,,,,,,,,,,,,,,,,,,,,,,,,,5,,,,,,,,,,,,,,,,,,,,,,,,,,,,,,,,,11,,,,,,,,,,,,,,,,,,,,,,,,,,,,,,,,,7,,,,,,,,,,,,,,,,,,,,,,,,,,,,,,,,,No comment,534.97,71.11,,,,9.29,,48.36,,,,,104.99,,,,,,,,,104.68,,,,,,,,,,,,,,,175.73,,,,,,,,,,,,,,,,,,20.81,,APPROVED,Male,32.0,FALSE
400,2022-03-22 00:02:43,19,en,102529572,2022-03-21 23:45:10,2022-03-22 00:02:43,Y,Y,A1,,,10,,,,,,,,,,,,,,,,,,,,,,,,,,,,,,,,,11,,,,,,,,,,,,,,,,,,,,,,,,,,,,,,,,,5,,,,,,,,,,,,,,,,,,,,,,,,,,,,,,,,,9,,,,,,,,,,,,,,,,,,,,,,,,,,,,,,,,,6,,,,,,,,,,,,,,,,,,,,,,,,,,,,,,,,,3,,,,,,,,,,,,,,,,,,,,,,,,,,,,,,,,,2,5.0,6.0,4.0,5.0,5.0,5.0,2.0,6.0,7.0,5.0,6.0,4.0,5.0,5.0,5.0,6.0,5.0,5.0,6.0,5.0,6.0,5.0,5.0,5.0,6.0,4.0,3.0,6.0,5.0,5.0,5.0,7.0,7,,,,,,,,,,,,,,,,,,,,,,,,,,,,,,,,,1,3.0,5.0,5.0,4.0,3.0,1.0,2.0,5.0,2.0,5.0,2.0,3.0,5.0,5.0,4.0,3.0,5.0,2.0,4.0,3.0,4.0,5.0,2.0,2.0,3.0,5.0,5.0,5.0,2.0,4.0,3.0,2.0,8,,,,,,,,,,,,,,,,,,,,,,,,,,,,,,,,,12,,,,,,,,,,,,,,,,,,,,,,,,,,,,,,,,,13,,,,,,,,,,,,,,,,,,,,,,,,,,,,,,,,,1,2.0,5.0,2.0,2.0,2.0,2.0,2.0,3.0,5.0,4.0,1.0,2.0,2.0,2.0,4.0,2.0,2.0,3.0,2.0,2.0,3.0,4.0,6.0,4.0,2.0,4.0,4.0,3.0,2.0,2.0,3.0,6.0,14,,,,,,,,,,,,,,,,,,,,,,,,,,,,,,,,,4,,,,,,,,,,,,,,,,,,,,,,,,,,,,,,,,,,1056.81,60.84,,,,13.08,,85.55,,,,,,,,,,,,,,,,,,,,109.51,,,,,,678.52,,,,,,,,,,,,106.33,,,,,,,,,2.98,,APPROVED,Male,24.0,FALSE
402,2022-03-21 23:54:07,19,en,2126461019,2022-03-21 23:45:37,2022-03-21 23:54:07,Y,Y,-oth-,DIploma,,3,,,,,,,,,,,,,,,,,,,,,,,,,,,,,,,,,9,,,,,,,,,,,,,,,,,,,,,,,,,,,,,,,,,14,,,,,,,,,,,,,,,,,,,,,,,,,,,,,,,,,8,,,,,,,,,,,,,,,,,,,,,,,,,,,,,,,,,12,,,,,,,,,,,,,,,,,,,,,,,,,,,,,,,,,10,,,,,,,,,,,,,,,,,,,,,,,,,,,,,,,,,2,1.0,1.0,1.0,1.0,4.0,2.0,1.0,2.0,1.0,1.0,1.0,1.0,1.0,1.0,1.0,1.0,1.0,1.0,1.0,1.0,1.0,1.0,1.0,1.0,1.0,1.0,3.0,3.0,1.0,1.0,1.0,7.0,13,,,,,,,,,,,,,,,,,,,,,,,,,,,,,,,,,2,1.0,5.0,1.0,2.0,1.0,1.0,2.0,1.0,1.0,1.0,3.0,1.0,1.0,3.0,1.0,2.0,5.0,1.0,1.0,1.0,1.0,2.0,1.0,1.0,2.0,1.0,1.0,1.0,1.0,1.0,2.0,2.0,2,1.0,1.0,2.0,2.0,1.0,2.0,1.0,1.0,1.0,1.0,1.0,1.0,1.0,1.0,1.0,1.0,1.0,1.0,1.0,1.0,1.0,1.0,1.0,1.0,1.0,1.0,6.0,1.0,1.0,1.0,1.0,3.0,11,,,,,,,,,,,,,,,,,,,,,,,,,,,,,,,,,7,,,,,,,,,,,,,,,,,,,,,,,,,,,,,,,,,6,,,,,,,,,,,,,,,,,,,,,,,,,,,,,,,,,4,,,,,,,,,,,,,,,,,,,,,,,,,,,,,,,,,5,,,,,,,,,,,,,,,,,,,,,,,,,,,,,,,,,,507.21,35.03,,,,33.43,,30.54,,,,,,,,,,,,,,,,,,,,124.87,,,,,,118.57,,,159.26,,,,,,,,,,,,,,,,,,5.51,,APPROVED,DATA EXPIRED,31.0,FALSE
403,2022-03-21 23:56:04,19,en,1038847848,2022-03-21 23:45:48,2022-03-21 23:56:04,Y,Y,A1,,,4,,,,,,,,,,,,,,,,,,,,,,,,,,,,,,,,,1,4.0,6.0,4.0,6.0,4.0,5.0,7.0,5.0,6.0,4.0,4.0,3.0,4.0,4.0,5.0,6.0,6.0,3.0,4.0,4.0,4.0,5.0,5.0,5.0,4.0,6.0,4.0,4.0,3.0,4.0,4.0,2.0,7,,,,,,,,,,,,,,,,,,,,,,,,,,,,,,,,,6,,,,,,,,,,,,,,,,,,,,,,,,,,,,,,,,,2,4.0,6.0,5.0,6.0,4.0,3.0,5.0,5.0,6.0,4.0,4.0,4.0,4.0,4.0,4.0,5.0,6.0,5.0,4.0,4.0,5.0,4.0,3.0,4.0,4.0,6.0,4.0,5.0,5.0,4.0,6.0,5.0,13,,,,,,,,,,,,,,,,,,,,,,,,,,,,,,,,,8,,,,,,,,,,,,,,,,,,,,,,,,,,,,,,,,,12,,,,,,,,,,,,,,,,,,,,,,,,,,,,,,,,,5,,,,,,,,,,,,,,,,,,,,,,,,,,,,,,,,,10,,,,,,,,,,,,,,,,,,,,,,,,,,,,,,,,,3,,,,,,,,,,,,,,,,,,,,,,,,,,,,,,,,,14,,,,,,,,,,,,,,,,,,,,,,,,,,,,,,,,,0,2.0,6.0,3.0,4.0,1.0,3.0,6.0,4.0,3.0,5.0,5.0,4.0,4.0,4.0,3.0,5.0,5.0,4.0,5.0,4.0,4.0,4.0,3.0,4.0,4.0,6.0,4.0,4.0,5.0,4.0,5.0,6.0,11,,,,,,,,,,,,,,,,,,,,,,,,,,,,,,,,,9,,,,,,,,,,,,,,,,,,,,,,,,,,,,,,,,,,621.26,48.9,,,,9.81,,55.72,,,,,211.83,,,,,,,,,140.93,,,,,,,,,,,,,,,,,,,,,,,,148.47,,,,,,,,,5.6,,APPROVED,Female,23.0,FALSE
404,2022-03-21 23:51:21,19,en,808481022,2022-03-21 23:46:47,2022-03-21 23:51:21,Y,Y,A1,,,2,5.0,6.0,5.0,4.0,7.0,2.0,4.0,6.0,7.0,4.0,5.0,5.0,7.0,5.0,6.0,5.0,7.0,5.0,6.0,7.0,6.0,6.0,2.0,5.0,5.0,6.0,5.0,6.0,5.0,5.0,4.0,1.0,5,,,,,,,,,,,,,,,,,,,,,,,,,,,,,,,,,3,,,,,,,,,,,,,,,,,,,,,,,,,,,,,,,,,1,4.0,4.0,4.0,7.0,3.0,6.0,4.0,6.0,4.0,5.0,5.0,5.0,4.0,5.0,6.0,6.0,5.0,4.0,3.0,4.0,5.0,3.0,6.0,4.0,6.0,7.0,4.0,5.0,5.0,5.0,4.0,4.0,9,,,,,,,,,,,,,,,,,,,,,,,,,,,,,,,,,0,5.0,6.0,5.0,2.0,3.0,2.0,5.0,6.0,6.0,6.0,2.0,6.0,6.0,7.0,5.0,3.0,7.0,5.0,4.0,6.0,5.0,5.0,2.0,5.0,5.0,5.0,4.0,5.0,5.0,5.0,5.0,6.0,8,,,,,,,,,,,,,,,,,,,,,,,,,,,,,,,,,12,,,,,,,,,,,,,,,,,,,,,,,,,,,,,,,,,7,,,,,,,,,,,,,,,,,,,,,,,,,,,,,,,,,11,,,,,,,,,,,,,,,,,,,,,,,,,,,,,,,,,10,,,,,,,,,,,,,,,,,,,,,,,,,,,,,,,,,6,,,,,,,,,,,,,,,,,,,,,,,,,,,,,,,,,4,,,,,,,,,,,,,,,,,,,,,,,,,,,,,,,,,14,,,,,,,,,,,,,,,,,,,,,,,,,,,,,,,,,13,,,,,,,,,,,,,,,,,,,,,,,,,,,,,,,,,,277.75,11.83,,,,11.31,,7.52,,72.42,,,,,,,,,71.86,,,,,,98.67,,,,,,,,,,,,,,,,,,,,,,,,,,,,,,4.14,,APPROVED,Male,24.0,FALSE
406,2022-03-21 23:53:39,19,en,475476378,2022-03-21 23:47:50,2022-03-21 23:53:39,Y,Y,-oth-,Professional Art education 4 year college,,13,,,,,,,,,,,,,,,,,,,,,,,,,,,,,,,,,1,6.0,3.0,6.0,6.0,4.0,6.0,2.0,7.0,4.0,4.0,4.0,6.0,6.0,4.0,4.0,6.0,6.0,4.0,6.0,4.0,4.0,6.0,7.0,6.0,6.0,6.0,3.0,6.0,4.0,6.0,6.0,2.0,11,,,,,,,,,,,,,,,,,,,,,,,,,,,,,,,,,12,,,,,,,,,,,,,,,,,,,,,,,,,,,,,,,,,0,4.0,5.0,5.0,2.0,5.0,2.0,7.0,5.0,6.0,4.0,4.0,5.0,4.0,4.0,4.0,4.0,6.0,2.0,5.0,4.0,4.0,4.0,2.0,4.0,4.0,3.0,4.0,4.0,4.0,4.0,2.0,5.0,8,,,,,,,,,,,,,,,,,,,,,,,,,,,,,,,,,3,,,,,,,,,,,,,,,,,,,,,,,,,,,,,,,,,5,,,,,,,,,,,,,,,,,,,,,,,,,,,,,,,,,7,,,,,,,,,,,,,,,,,,,,,,,,,,,,,,,,,14,,,,,,,,,,,,,,,,,,,,,,,,,,,,,,,,,9,,,,,,,,,,,,,,,,,,,,,,,,,,,,,,,,,6,,,,,,,,,,,,,,,,,,,,,,,,,,,,,,,,,2,2.0,5.0,3.0,2.0,4.0,2.0,7.0,6.0,5.0,2.0,2.0,3.0,3.0,5.0,5.0,1.0,4.0,2.0,4.0,2.0,2.0,2.0,1.0,2.0,4.0,2.0,4.0,2.0,2.0,3.0,1.0,6.0,10,,,,,,,,,,,,,,,,,,,,,,,,,,,,,,,,,4,,,,,,,,,,,,,,,,,,,,,,,,,,,,,,,,,,353.03,19.05,,,,52.72,,19.11,,,,,69.78,,,,,,,,,109.44,,,,,,,,,,,,,,,,,,,,,,,,80.19,,,,,,,,,2.74,,APPROVED,Female,20.0,FALSE
409,2022-03-21 23:54:55,19,en,1437324217,2022-03-21 23:50:45,2022-03-21 23:54:55,Y,Y,A2,,,10,,,,,,,,,,,,,,,,,,,,,,,,,,,,,,,,,12,,,,,,,,,,,,,,,,,,,,,,,,,,,,,,,,,5,,,,,,,,,,,,,,,,,,,,,,,,,,,,,,,,,8,,,,,,,,,,,,,,,,,,,,,,,,,,,,,,,,,4,,,,,,,,,,,,,,,,,,,,,,,,,,,,,,,,,0,3.0,6.0,3.0,1.0,6.0,1.0,1.0,5.0,7.0,3.0,2.0,1.0,5.0,6.0,5.0,1.0,6.0,1.0,7.0,6.0,3.0,7.0,1.0,3.0,1.0,2.0,5.0,2.0,1.0,3.0,2.0,6.0,11,,,,,,,,,,,,,,,,,,,,,,,,,,,,,,,,,9,,,,,,,,,,,,,,,,,,,,,,,,,,,,,,,,,1,4.0,1.0,1.0,1.0,1.0,5.0,3.0,1.0,1.0,1.0,1.0,1.0,1.0,1.0,1.0,1.0,2.0,1.0,1.0,1.0,1.0,1.0,6.0,1.0,1.0,5.0,1.0,1.0,4.0,1.0,1.0,2.0,3,,,,,,,,,,,,,,,,,,,,,,,,,,,,,,,,,7,,,,,,,,,,,,,,,,,,,,,,,,,,,,,,,,,6,,,,,,,,,,,,,,,,,,,,,,,,,,,,,,,,,13,,,,,,,,,,,,,,,,,,,,,,,,,,,,,,,,,14,,,,,,,,,,,,,,,,,,,,,,,,,,,,,,,,,2,3.0,7.0,6.0,4.0,5.0,7.0,2.0,2.0,6.0,5.0,7.0,5.0,7.0,6.0,5.0,7.0,6.0,4.0,6.0,4.0,7.0,7.0,4.0,5.0,6.0,2.0,6.0,6.0,5.0,7.0,4.0,1.0,,252.8,35.37,,,,6.39,,36.95,,,,,,,,,,,,,,,,,67.18,,,,,,,,,49.17,,,,,,,,,,,,,,,,,,54.98,,,2.76,,APPROVED,Male,24.0,FALSE
411,2022-03-22 00:09:46,19,en,185824838,2022-03-22 00:02:48,2022-03-22 00:09:46,Y,Y,-oth-,High school,,13,,,,,,,,,,,,,,,,,,,,,,,,,,,,,,,,,14,,,,,,,,,,,,,,,,,,,,,,,,,,,,,,,,,6,,,,,,,,,,,,,,,,,,,,,,,,,,,,,,,,,0,5.0,6.0,6.0,3.0,6.0,3.0,5.0,6.0,6.0,6.0,2.0,6.0,6.0,5.0,6.0,6.0,6.0,6.0,4.0,2.0,6.0,6.0,5.0,6.0,6.0,6.0,5.0,6.0,7.0,6.0,6.0,4.0,1,2.0,2.0,2.0,2.0,2.0,2.0,7.0,6.0,2.0,2.0,2.0,2.0,2.0,2.0,2.0,2.0,3.0,2.0,2.0,2.0,2.0,2.0,2.0,2.0,2.0,2.0,2.0,2.0,2.0,2.0,2.0,5.0,12,,,,,,,,,,,,,,,,,,,,,,,,,,,,,,,,,10,,,,,,,,,,,,,,,,,,,,,,,,,,,,,,,,,7,,,,,,,,,,,,,,,,,,,,,,,,,,,,,,,,,3,,,,,,,,,,,,,,,,,,,,,,,,,,,,,,,,,11,,,,,,,,,,,,,,,,,,,,,,,,,,,,,,,,,8,,,,,,,,,,,,,,,,,,,,,,,,,,,,,,,,,5,,,,,,,,,,,,,,,,,,,,,,,,,,,,,,,,,4,,,,,,,,,,,,,,,,,,,,,,,,,,,,,,,,,9,,,,,,,,,,,,,,,,,,,,,,,,,,,,,,,,,2,6.0,6.0,6.0,6.0,6.0,3.0,5.0,6.0,6.0,6.0,6.0,6.0,6.0,6.0,6.0,6.0,6.0,6.0,6.0,5.0,6.0,6.0,6.0,5.0,6.0,5.0,6.0,6.0,6.0,6.0,5.0,1.0,,419.81,13.6,,,,62.04,,33.19,,,,,,,,,,,147.96,,,82.98,,,,,,,,,,,,,,,,,,,,,,,,,,,,,,76.79,,,3.25,,APPROVED,Female,21.0,FALSE
412,2022-03-22 00:12:25,19,en,1843233804,2022-03-22 00:03:18,2022-03-22 00:12:25,Y,Y,A1,,,2,5.0,7.0,6.0,6.0,6.0,3.0,7.0,7.0,7.0,6.0,3.0,5.0,5.0,5.0,6.0,5.0,5.0,4.0,7.0,5.0,4.0,5.0,5.0,6.0,5.0,3.0,6.0,3.0,3.0,4.0,5.0,1.0,0,6.0,4.0,7.0,7.0,6.0,7.0,1.0,7.0,3.0,6.0,6.0,7.0,6.0,4.0,7.0,4.0,7.0,4.0,5.0,5.0,4.0,6.0,6.0,7.0,6.0,6.0,2.0,7.0,5.0,5.0,7.0,2.0,5,,,,,,,,,,,,,,,,,,,,,,,,,,,,,,,,,8,,,,,,,,,,,,,,,,,,,,,,,,,,,,,,,,,7,,,,,,,,,,,,,,,,,,,,,,,,,,,,,,,,,9,,,,,,,,,,,,,,,,,,,,,,,,,,,,,,,,,1,2.0,6.0,1.0,3.0,1.0,2.0,7.0,6.0,6.0,3.0,2.0,5.0,1.0,4.0,5.0,5.0,6.0,1.0,3.0,1.0,4.0,2.0,6.0,1.0,2.0,3.0,7.0,2.0,2.0,3.0,2.0,7.0,3,,,,,,,,,,,,,,,,,,,,,,,,,,,,,,,,,12,,,,,,,,,,,,,,,,,,,,,,,,,,,,,,,,,4,,,,,,,,,,,,,,,,,,,,,,,,,,,,,,,,,6,,,,,,,,,,,,,,,,,,,,,,,,,,,,,,,,,10,,,,,,,,,,,,,,,,,,,,,,,,,,,,,,,,,13,,,,,,,,,,,,,,,,,,,,,,,,,,,,,,,,,14,,,,,,,,,,,,,,,,,,,,,,,,,,,,,,,,,11,,,,,,,,,,,,,,,,,,,,,,,,,,,,,,,,,,540.68,128.49,,,,8.8,,36.81,,137.12,,,107.17,,,,,,,,,,,,,,,117.06,,,,,,,,,,,,,,,,,,,,,,,,,,,5.23,,APPROVED,Female,28.0,FALSE
413,2022-03-22 00:11:03,19,en,1521846078,2022-03-22 00:03:36,2022-03-22 00:11:03,Y,Y,A1,,,3,,,,,,,,,,,,,,,,,,,,,,,,,,,,,,,,,1,5.0,1.0,5.0,5.0,5.0,7.0,4.0,7.0,4.0,5.0,6.0,5.0,6.0,3.0,3.0,7.0,5.0,5.0,6.0,6.0,4.0,6.0,6.0,5.0,5.0,7.0,2.0,6.0,5.0,5.0,6.0,2.0,10,,,,,,,,,,,,,,,,,,,,,,,,,,,,,,,,,2,5.0,5.0,3.0,2.0,3.0,1.0,5.0,5.0,5.0,5.0,4.0,3.0,5.0,5.0,5.0,3.0,5.0,5.0,5.0,4.0,5.0,4.0,5.0,5.0,5.0,4.0,5.0,5.0,5.0,4.0,5.0,4.0,7,,,,,,,,,,,,,,,,,,,,,,,,,,,,,,,,,13,,,,,,,,,,,,,,,,,,,,,,,,,,,,,,,,,14,,,,,,,,,,,,,,,,,,,,,,,,,,,,,,,,,6,,,,,,,,,,,,,,,,,,,,,,,,,,,,,,,,,8,,,,,,,,,,,,,,,,,,,,,,,,,,,,,,,,,12,,,,,,,,,,,,,,,,,,,,,,,,,,,,,,,,,9,,,,,,,,,,,,,,,,,,,,,,,,,,,,,,,,,11,,,,,,,,,,,,,,,,,,,,,,,,,,,,,,,,,4,,,,,,,,,,,,,,,,,,,,,,,,,,,,,,,,,0,3.0,5.0,3.0,3.0,3.0,3.0,4.0,6.0,5.0,3.0,4.0,5.0,3.0,4.0,3.0,4.0,6.0,5.0,3.0,3.0,3.0,4.0,6.0,2.0,3.0,6.0,4.0,2.0,3.0,3.0,5.0,7.0,5,,,,,,,,,,,,,,,,,,,,,,,,,,,,,,,,,,449.89,104.12,,,,7.51,,41.97,,,,,80.25,,,,,,106.74,,,,,,,,,,,,,,,,,,,,,,,,,,,,,,102.5,,,,,,6.8,,APPROVED,Male,27.0,FALSE
414,2022-03-22 00:16:09,19,en,681253037,2022-03-22 00:03:39,2022-03-22 00:16:09,Y,Y,A1,,,14,,,,,,,,,,,,,,,,,,,,,,,,,,,,,,,,,8,,,,,,,,,,,,,,,,,,,,,,,,,,,,,,,,,11,,,,,,,,,,,,,,,,,,,,,,,,,,,,,,,,,12,,,,,,,,,,,,,,,,,,,,,,,,,,,,,,,,,13,,,,,,,,,,,,,,,,,,,,,,,,,,,,,,,,,1,4.0,3.0,3.0,4.0,4.0,5.0,5.0,6.0,5.0,4.0,3.0,3.0,3.0,5.0,4.0,3.0,5.0,3.0,4.0,2.0,4.0,4.0,5.0,2.0,3.0,4.0,5.0,2.0,5.0,4.0,5.0,6.0,0,1.0,1.0,2.0,2.0,1.0,1.0,3.0,1.0,2.0,1.0,1.0,1.0,2.0,1.0,1.0,1.0,1.0,2.0,1.0,1.0,2.0,2.0,3.0,1.0,1.0,1.0,2.0,1.0,2.0,3.0,1.0,1.0,7,,,,,,,,,,,,,,,,,,,,,,,,,,,,,,,,,3,,,,,,,,,,,,,,,,,,,,,,,,,,,,,,,,,9,,,,,,,,,,,,,,,,,,,,,,,,,,,,,,,,,2,5.0,6.0,5.0,5.0,6.0,5.0,3.0,5.0,6.0,5.0,5.0,6.0,5.0,6.0,6.0,5.0,5.0,5.0,6.0,4.0,4.0,6.0,4.0,5.0,4.0,4.0,6.0,6.0,5.0,5.0,6.0,4.0,10,,,,,,,,,,,,,,,,,,,,,,,,,,,,,,,,,5,,,,,,,,,,,,,,,,,,,,,,,,,,,,,,,,,4,,,,,,,,,,,,,,,,,,,,,,,,,,,,,,,,,6,,,,,,,,,,,,,,,,,,,,,,,,,,,,,,,,,,754.48,26.77,,,,11.32,,44.48,,,,,,,,,,,,,,,,,310.96,,,217.77,,,,,,,,,,,,124.57,,,,,,,,,,,,,,,18.61,,APPROVED,Male,27.0,FALSE
415,2022-03-22 00:10:54,19,en,1452193994,2022-03-22 00:03:39,2022-03-22 00:10:54,Y,Y,A1,,,1,7.0,7.0,7.0,7.0,7.0,7.0,1.0,7.0,7.0,7.0,7.0,7.0,7.0,6.0,6.0,6.0,7.0,7.0,7.0,7.0,6.0,7.0,7.0,7.0,7.0,7.0,1.0,7.0,7.0,6.0,7.0,1.0,6,,,,,,,,,,,,,,,,,,,,,,,,,,,,,,,,,12,,,,,,,,,,,,,,,,,,,,,,,,,,,,,,,,,4,,,,,,,,,,,,,,,,,,,,,,,,,,,,,,,,,10,,,,,,,,,,,,,,,,,,,,,,,,,,,,,,,,,8,,,,,,,,,,,,,,,,,,,,,,,,,,,,,,,,,9,,,,,,,,,,,,,,,,,,,,,,,,,,,,,,,,,5,,,,,,,,,,,,,,,,,,,,,,,,,,,,,,,,,3,,,,,,,,,,,,,,,,,,,,,,,,,,,,,,,,,0,7.0,7.0,6.0,6.0,7.0,4.0,4.0,7.0,7.0,5.0,7.0,7.0,4.0,5.0,7.0,7.0,7.0,5.0,6.0,7.0,6.0,5.0,6.0,6.0,6.0,7.0,1.0,6.0,7.0,6.0,7.0,1.0,14,,,,,,,,,,,,,,,,,,,,,,,,,,,,,,,,,7,,,,,,,,,,,,,,,,,,,,,,,,,,,,,,,,,11,,,,,,,,,,,,,,,,,,,,,,,,,,,,,,,,,2,5.0,7.0,5.0,7.0,4.0,7.0,2.0,7.0,7.0,5.0,3.0,6.0,7.0,6.0,7.0,5.0,7.0,7.0,5.0,3.0,7.0,5.0,7.0,5.0,5.0,7.0,2.0,2.0,7.0,5.0,7.0,7.0,13,,,,,,,,,,,,,,,,,,,,,,,,,,,,,,,,,,437.69,72.35,,,,13.1,,5.42,,85.16,,,,,,,,,,,,,,,,,,,,,,,,,,,160.28,,,,,,,,,,,,94.63,,,,,,6.75,,APPROVED,Male,25.0,FALSE
416,2022-03-22 00:11:12,19,en,1483980117,2022-03-22 00:04:07,2022-03-22 00:11:12,Y,Y,A1,,,10,,,,,,,,,,,,,,,,,,,,,,,,,,,,,,,,,12,,,,,,,,,,,,,,,,,,,,,,,,,,,,,,,,,11,,,,,,,,,,,,,,,,,,,,,,,,,,,,,,,,,7,,,,,,,,,,,,,,,,,,,,,,,,,,,,,,,,,0,5.0,5.0,4.0,6.0,5.0,3.0,6.0,6.0,7.0,5.0,3.0,5.0,5.0,5.0,6.0,5.0,6.0,5.0,5.0,5.0,5.0,5.0,3.0,4.0,4.0,4.0,3.0,7.0,5.0,5.0,6.0,5.0,3,,,,,,,,,,,,,,,,,,,,,,,,,,,,,,,,,9,,,,,,,,,,,,,,,,,,,,,,,,,,,,,,,,,8,,,,,,,,,,,,,,,,,,,,,,,,,,,,,,,,,6,,,,,,,,,,,,,,,,,,,,,,,,,,,,,,,,,1,3.0,7.0,5.0,1.0,3.0,1.0,4.0,1.0,5.0,4.0,4.0,3.0,2.0,3.0,3.0,3.0,5.0,2.0,3.0,3.0,2.0,3.0,2.0,1.0,2.0,6.0,6.0,3.0,3.0,2.0,5.0,3.0,14,,,,,,,,,,,,,,,,,,,,,,,,,,,,,,,,,13,,,,,,,,,,,,,,,,,,,,,,,,,,,,,,,,,4,,,,,,,,,,,,,,,,,,,,,,,,,,,,,,,,,5,,,,,,,,,,,,,,,,,,,,,,,,,,,,,,,,,2,3.0,3.0,1.0,2.0,2.0,1.0,3.0,3.0,5.0,3.0,1.0,2.0,1.0,1.0,5.0,1.0,2.0,1.0,1.0,1.0,1.0,1.0,1.0,3.0,2.0,4.0,5.0,2.0,2.0,1.0,4.0,1.0,,428.48,11.27,,,,47.44,,56.8,,,,,,,,,,,,,,114.03,,,,,,,,,,,,,,,101.93,,,,,,,,,,,,,,,94.05,,,2.96,,APPROVED,Male,19.0,FALSE
417,2022-03-22 00:09:11,19,en,1621162961,2022-03-22 00:04:46,2022-03-22 00:09:11,Y,Y,A1,,,6,,,,,,,,,,,,,,,,,,,,,,,,,,,,,,,,,13,,,,,,,,,,,,,,,,,,,,,,,,,,,,,,,,,2,7.0,7.0,7.0,7.0,7.0,7.0,3.0,7.0,7.0,7.0,7.0,6.0,7.0,6.0,7.0,7.0,7.0,7.0,7.0,7.0,7.0,7.0,7.0,7.0,7.0,7.0,3.0,7.0,7.0,7.0,7.0,3.0,8,,,,,,,,,,,,,,,,,,,,,,,,,,,,,,,,,9,,,,,,,,,,,,,,,,,,,,,,,,,,,,,,,,,7,,,,,,,,,,,,,,,,,,,,,,,,,,,,,,,,,1,1.0,1.0,1.0,1.0,1.0,1.0,6.0,1.0,1.0,1.0,1.0,1.0,2.0,1.0,1.0,2.0,5.0,1.0,1.0,1.0,1.0,1.0,1.0,1.0,1.0,1.0,1.0,1.0,1.0,1.0,1.0,7.0,4,,,,,,,,,,,,,,,,,,,,,,,,,,,,,,,,,3,,,,,,,,,,,,,,,,,,,,,,,,,,,,,,,,,10,,,,,,,,,,,,,,,,,,,,,,,,,,,,,,,,,5,,,,,,,,,,,,,,,,,,,,,,,,,,,,,,,,,0,7.0,7.0,7.0,4.0,7.0,5.0,2.0,7.0,7.0,7.0,7.0,7.0,7.0,6.0,7.0,7.0,7.0,6.0,6.0,6.0,7.0,7.0,6.0,7.0,7.0,5.0,5.0,7.0,7.0,7.0,7.0,5.0,12,,,,,,,,,,,,,,,,,,,,,,,,,,,,,,,,,14,,,,,,,,,,,,,,,,,,,,,,,,,,,,,,,,,11,,,,,,,,,,,,,,,,,,,,,,,,,,,,,,,,,,268.55,17.75,,,,9.31,,35.5,,,,,,,,54.63,,,,,,,,,,,,66.56,,,,,,,,,,,,,,,82.17,,,,,,,,,,,,2.63,,APPROVED,Female,19.0,FALSE
418,2022-03-22 00:09:23,19,en,1757675274,2022-03-22 00:04:52,2022-03-22 00:09:23,Y,Y,A2,,,4,,,,,,,,,,,,,,,,,,,,,,,,,,,,,,,,,11,,,,,,,,,,,,,,,,,,,,,,,,,,,,,,,,,2,7.0,7.0,7.0,7.0,7.0,7.0,2.0,7.0,7.0,7.0,7.0,7.0,7.0,7.0,7.0,7.0,7.0,7.0,7.0,7.0,7.0,7.0,7.0,7.0,7.0,7.0,7.0,7.0,7.0,7.0,7.0,3.0,5,,,,,,,,,,,,,,,,,,,,,,,,,,,,,,,,,7,,,,,,,,,,,,,,,,,,,,,,,,,,,,,,,,,12,,,,,,,,,,,,,,,,,,,,,,,,,,,,,,,,,14,,,,,,,,,,,,,,,,,,,,,,,,,,,,,,,,,10,,,,,,,,,,,,,,,,,,,,,,,,,,,,,,,,,8,,,,,,,,,,,,,,,,,,,,,,,,,,,,,,,,,1,4.0,5.0,5.0,3.0,5.0,1.0,7.0,4.0,5.0,4.0,5.0,5.0,3.0,6.0,5.0,2.0,6.0,3.0,3.0,3.0,2.0,5.0,2.0,3.0,4.0,5.0,6.0,3.0,3.0,3.0,2.0,3.0,3,,,,,,,,,,,,,,,,,,,,,,,,,,,,,,,,,6,,,,,,,,,,,,,,,,,,,,,,,,,,,,,,,,,9,,,,,,,,,,,,,,,,,,,,,,,,,,,,,,,,,0,2.0,4.0,2.0,5.0,2.0,6.0,3.0,5.0,5.0,2.0,2.0,3.0,2.0,3.0,5.0,3.0,5.0,4.0,2.0,2.0,2.0,2.0,5.0,2.0,2.0,5.0,2.0,3.0,5.0,4.0,4.0,7.0,13,,,,,,,,,,,,,,,,,,,,,,,,,,,,,,,,,None,274.84,21.5,,,,4.7,,25.66,,,,,,,,46.65,,,,,,,,,,,,,,,,,,,,,89.34,,,,,,,,,,,,80.86,,,,,,6.13,,APPROVED,Female,36.0,FALSE
419,2022-03-22 00:09:20,19,en,390055281,2022-03-22 00:04:55,2022-03-22 00:09:20,Y,Y,A1,,,6,,,,,,,,,,,,,,,,,,,,,,,,,,,,,,,,,8,,,,,,,,,,,,,,,,,,,,,,,,,,,,,,,,,2,4.0,6.0,5.0,4.0,5.0,1.0,1.0,4.0,6.0,1.0,1.0,1.0,1.0,1.0,1.0,1.0,5.0,5.0,1.0,1.0,1.0,4.0,1.0,1.0,1.0,4.0,1.0,4.0,1.0,1.0,3.0,3.0,4,,,,,,,,,,,,,,,,,,,,,,,,,,,,,,,,,10,,,,,,,,,,,,,,,,,,,,,,,,,,,,,,,,,12,,,,,,,,,,,,,,,,,,,,,,,,,,,,,,,,,3,,,,,,,,,,,,,,,,,,,,,,,,,,,,,,,,,5,,,,,,,,,,,,,,,,,,,,,,,,,,,,,,,,,13,,,,,,,,,,,,,,,,,,,,,,,,,,,,,,,,,14,,,,,,,,,,,,,,,,,,,,,,,,,,,,,,,,,1,1.0,1.0,1.0,1.0,1.0,1.0,1.0,1.0,1.0,1.0,1.0,1.0,1.0,1.0,1.0,1.0,1.0,1.0,1.0,1.0,1.0,1.0,1.0,1.0,1.0,1.0,1.0,1.0,1.0,1.0,1.0,4.0,9,,,,,,,,,,,,,,,,,,,,,,,,,,,,,,,,,7,,,,,,,,,,,,,,,,,,,,,,,,,,,,,,,,,0,1.0,2.0,5.0,4.0,2.0,6.0,4.0,2.0,4.0,1.0,1.0,5.0,4.0,1.0,5.0,2.0,4.0,5.0,6.0,1.0,6.0,4.0,6.0,1.0,2.0,6.0,1.0,1.0,1.0,1.0,4.0,7.0,11,,,,,,,,,,,,,,,,,,,,,,,,,,,,,,,,,"nothing, all ok",268.66,37.9,,,,7.27,,58.76,,,,,,,,52.63,,,,,,,,,,,,,,,,,,,,,,,,36.28,,,,,,,,,61.91,,,,,,13.91,,APPROVED,Male,22.0,FALSE
420,2022-03-22 00:09:35,19,en,1199210969,2022-03-22 00:05:01,2022-03-22 00:09:35,Y,Y,A2,,,7,,,,,,,,,,,,,,,,,,,,,,,,,,,,,,,,,14,,,,,,,,,,,,,,,,,,,,,,,,,,,,,,,,,4,,,,,,,,,,,,,,,,,,,,,,,,,,,,,,,,,9,,,,,,,,,,,,,,,,,,,,,,,,,,,,,,,,,12,,,,,,,,,,,,,,,,,,,,,,,,,,,,,,,,,0,6.0,5.0,6.0,5.0,5.0,4.0,7.0,7.0,6.0,3.0,5.0,5.0,5.0,5.0,6.0,5.0,7.0,5.0,5.0,5.0,6.0,5.0,6.0,4.0,6.0,6.0,5.0,5.0,7.0,4.0,6.0,6.0,2,1.0,1.0,1.0,6.0,1.0,1.0,5.0,1.0,1.0,1.0,1.0,1.0,1.0,1.0,1.0,5.0,1.0,1.0,1.0,1.0,1.0,1.0,6.0,1.0,1.0,5.0,1.0,1.0,5.0,1.0,1.0,7.0,3,,,,,,,,,,,,,,,,,,,,,,,,,,,,,,,,,11,,,,,,,,,,,,,,,,,,,,,,,,,,,,,,,,,5,,,,,,,,,,,,,,,,,,,,,,,,,,,,,,,,,6,,,,,,,,,,,,,,,,,,,,,,,,,,,,,,,,,13,,,,,,,,,,,,,,,,,,,,,,,,,,,,,,,,,10,,,,,,,,,,,,,,,,,,,,,,,,,,,,,,,,,8,,,,,,,,,,,,,,,,,,,,,,,,,,,,,,,,,1,1.0,1.0,1.0,1.0,1.0,4.0,1.0,1.0,1.0,1.0,1.0,1.0,1.0,1.0,3.0,1.0,1.0,1.0,1.0,1.0,1.0,1.0,4.0,1.0,1.0,3.0,1.0,1.0,7.0,1.0,3.0,1.0,,278.75,14.84,,,,4.83,,34.38,,,,,,,,,,,,,,,,,74.88,,,73.41,,,,,,,,,,,,,,,,,,,,,,,,72.75,,,3.66,,APPROVED,Female,28.0,FALSE
421,2022-03-22 00:12:37,19,en,1950323172,2022-03-22 00:05:34,2022-03-22 00:12:37,Y,Y,A2,,,9,,,,,,,,,,,,,,,,,,,,,,,,,,,,,,,,,12,,,,,,,,,,,,,,,,,,,,,,,,,,,,,,,,,11,,,,,,,,,,,,,,,,,,,,,,,,,,,,,,,,,3,,,,,,,,,,,,,,,,,,,,,,,,,,,,,,,,,2,6.0,6.0,7.0,5.0,6.0,4.0,6.0,7.0,7.0,7.0,5.0,7.0,6.0,6.0,5.0,7.0,7.0,5.0,7.0,4.0,6.0,7.0,5.0,7.0,5.0,7.0,6.0,7.0,7.0,7.0,7.0,5.0,1,5.0,7.0,6.0,7.0,4.0,5.0,6.0,7.0,6.0,5.0,6.0,5.0,5.0,6.0,4.0,6.0,7.0,4.0,5.0,3.0,6.0,6.0,5.0,6.0,3.0,6.0,6.0,5.0,6.0,4.0,5.0,6.0,13,,,,,,,,,,,,,,,,,,,,,,,,,,,,,,,,,14,,,,,,,,,,,,,,,,,,,,,,,,,,,,,,,,,8,,,,,,,,,,,,,,,,,,,,,,,,,,,,,,,,,6,,,,,,,,,,,,,,,,,,,,,,,,,,,,,,,,,7,,,,,,,,,,,,,,,,,,,,,,,,,,,,,,,,,10,,,,,,,,,,,,,,,,,,,,,,,,,,,,,,,,,4,,,,,,,,,,,,,,,,,,,,,,,,,,,,,,,,,5,,,,,,,,,,,,,,,,,,,,,,,,,,,,,,,,,0,1.0,4.0,1.0,1.0,1.0,3.0,3.0,5.0,2.0,1.0,3.0,2.0,1.0,2.0,2.0,1.0,2.0,1.0,1.0,2.0,1.0,2.0,1.0,1.0,2.0,1.0,4.0,1.0,3.0,1.0,3.0,1.0,,427.23,89.68,,,,5.5,,40.71,,,,,,,,,,,,,,110.71,,,85.47,,,,,,,,,,,,,,,,,,,,,,,,,,,91.17,,,3.99,,APPROVED,Male,32.0,FALSE
422,2022-03-22 00:11:33,19,en,1832831147,2022-03-22 00:05:55,2022-03-22 00:11:33,Y,Y,-oth-,College Graduate,,11,,,,,,,,,,,,,,,,,,,,,,,,,,,,,,,,,5,,,,,,,,,,,,,,,,,,,,,,,,,,,,,,,,,1,7.0,7.0,6.0,7.0,5.0,7.0,4.0,7.0,7.0,6.0,5.0,6.0,6.0,6.0,6.0,6.0,7.0,5.0,6.0,6.0,6.0,6.0,6.0,6.0,6.0,7.0,5.0,6.0,7.0,7.0,7.0,3.0,4,,,,,,,,,,,,,,,,,,,,,,,,,,,,,,,,,13,,,,,,,,,,,,,,,,,,,,,,,,,,,,,,,,,6,,,,,,,,,,,,,,,,,,,,,,,,,,,,,,,,,8,,,,,,,,,,,,,,,,,,,,,,,,,,,,,,,,,9,,,,,,,,,,,,,,,,,,,,,,,,,,,,,,,,,3,,,,,,,,,,,,,,,,,,,,,,,,,,,,,,,,,10,,,,,,,,,,,,,,,,,,,,,,,,,,,,,,,,,0,5.0,6.0,6.0,6.0,6.0,5.0,4.0,5.0,6.0,6.0,6.0,4.0,6.0,6.0,5.0,6.0,6.0,5.0,6.0,6.0,4.0,6.0,5.0,6.0,6.0,6.0,4.0,6.0,4.0,5.0,6.0,4.0,14,,,,,,,,,,,,,,,,,,,,,,,,,,,,,,,,,2,6.0,7.0,6.0,6.0,6.0,7.0,6.0,6.0,7.0,7.0,7.0,7.0,6.0,6.0,6.0,6.0,7.0,6.0,6.0,5.0,7.0,6.0,7.0,7.0,6.0,7.0,5.0,6.0,7.0,6.0,7.0,6.0,12,,,,,,,,,,,,,,,,,,,,,,,,,,,,,,,,,7,,,,,,,,,,,,,,,,,,,,,,,,,,,,,,,,,,341.3,36.37,,,,20.46,,34.35,,,,,,,,79.68,,,,,,,,,,,,,,,,,,,,,,,,100.7,,,,,,67.19,,,,,,,,,2.55,,APPROVED,Male,21.0,FALSE
423,2022-03-22 00:11:59,19,en,549199615,2022-03-22 00:06:02,2022-03-22 00:11:59,Y,Y,A1,,,12,,,,,,,,,,,,,,,,,,,,,,,,,,,,,,,,,4,,,,,,,,,,,,,,,,,,,,,,,,,,,,,,,,,11,,,,,,,,,,,,,,,,,,,,,,,,,,,,,,,,,14,,,,,,,,,,,,,,,,,,,,,,,,,,,,,,,,,13,,,,,,,,,,,,,,,,,,,,,,,,,,,,,,,,,9,,,,,,,,,,,,,,,,,,,,,,,,,,,,,,,,,3,,,,,,,,,,,,,,,,,,,,,,,,,,,,,,,,,1,4.0,5.0,3.0,4.0,5.0,3.0,5.0,3.0,4.0,3.0,3.0,5.0,5.0,3.0,5.0,3.0,5.0,4.0,3.0,3.0,4.0,5.0,3.0,5.0,5.0,4.0,4.0,6.0,4.0,4.0,4.0,1.0,2,5.0,2.0,5.0,4.0,3.0,6.0,4.0,2.0,4.0,3.0,5.0,5.0,5.0,4.0,4.0,5.0,5.0,4.0,5.0,4.0,4.0,4.0,6.0,4.0,3.0,6.0,4.0,4.0,5.0,5.0,6.0,2.0,7,,,,,,,,,,,,,,,,,,,,,,,,,,,,,,,,,5,,,,,,,,,,,,,,,,,,,,,,,,,,,,,,,,,8,,,,,,,,,,,,,,,,,,,,,,,,,,,,,,,,,6,,,,,,,,,,,,,,,,,,,,,,,,,,,,,,,,,0,4.0,4.0,4.0,4.0,3.0,5.0,4.0,6.0,5.0,3.0,4.0,5.0,4.0,4.0,5.0,4.0,6.0,4.0,4.0,3.0,3.0,5.0,6.0,4.0,5.0,6.0,6.0,5.0,4.0,4.0,6.0,7.0,10,,,,,,,,,,,,,,,,,,,,,,,,,,,,,,,,,,360.33,73.46,,,,7.54,,50.15,,,,,,,,,,,,,,,,,,,,,,,85.48,,,64.26,,,,,,,,,,,,,,,75.12,,,,,,4.32,,APPROVED,Female,27.0,FALSE
424,2022-03-22 00:13:37,19,en,1486232997,2022-03-22 00:06:02,2022-03-22 00:13:37,Y,Y,A1,,,10,,,,,,,,,,,,,,,,,,,,,,,,,,,,,,,,,0,3.0,1.0,4.0,4.0,4.0,5.0,2.0,6.0,4.0,6.0,4.0,4.0,3.0,2.0,4.0,5.0,5.0,3.0,5.0,4.0,3.0,4.0,5.0,4.0,4.0,6.0,3.0,5.0,4.0,3.0,6.0,2.0,4,,,,,,,,,,,,,,,,,,,,,,,,,,,,,,,,,8,,,,,,,,,,,,,,,,,,,,,,,,,,,,,,,,,9,,,,,,,,,,,,,,,,,,,,,,,,,,,,,,,,,3,,,,,,,,,,,,,,,,,,,,,,,,,,,,,,,,,5,,,,,,,,,,,,,,,,,,,,,,,,,,,,,,,,,2,3.0,6.0,5.0,3.0,5.0,3.0,5.0,6.0,7.0,4.0,3.0,4.0,4.0,5.0,4.0,5.0,5.0,5.0,5.0,4.0,2.0,5.0,2.0,6.0,4.0,1.0,4.0,4.0,3.0,4.0,4.0,1.0,7,,,,,,,,,,,,,,,,,,,,,,,,,,,,,,,,,1,4.0,1.0,3.0,4.0,5.0,5.0,5.0,2.0,2.0,4.0,4.0,3.0,4.0,4.0,4.0,4.0,5.0,3.0,3.0,4.0,3.0,3.0,6.0,3.0,3.0,6.0,4.0,3.0,6.0,4.0,5.0,3.0,11,,,,,,,,,,,,,,,,,,,,,,,,,,,,,,,,,6,,,,,,,,,,,,,,,,,,,,,,,,,,,,,,,,,14,,,,,,,,,,,,,,,,,,,,,,,,,,,,,,,,,13,,,,,,,,,,,,,,,,,,,,,,,,,,,,,,,,,12,,,,,,,,,,,,,,,,,,,,,,,,,,,,,,,,,,458.29,24.52,,,,9.94,,30.47,,,,,62.32,,,,,,,,,,,,,,,,,,83.17,,,,,,242.82,,,,,,,,,,,,,,,,,,5.05,,APPROVED,Male,22.0,FALSE
425,2022-03-22 00:11:51,19,en,2122257750,2022-03-22 00:06:07,2022-03-22 00:11:51,Y,Y,A2,,,13,,,,,,,,,,,,,,,,,,,,,,,,,,,,,,,,,10,,,,,,,,,,,,,,,,,,,,,,,,,,,,,,,,,11,,,,,,,,,,,,,,,,,,,,,,,,,,,,,,,,,8,,,,,,,,,,,,,,,,,,,,,,,,,,,,,,,,,4,,,,,,,,,,,,,,,,,,,,,,,,,,,,,,,,,5,,,,,,,,,,,,,,,,,,,,,,,,,,,,,,,,,12,,,,,,,,,,,,,,,,,,,,,,,,,,,,,,,,,3,,,,,,,,,,,,,,,,,,,,,,,,,,,,,,,,,0,2.0,2.0,2.0,2.0,2.0,2.0,2.0,3.0,4.0,2.0,2.0,2.0,2.0,2.0,2.0,1.0,3.0,2.0,2.0,2.0,2.0,3.0,4.0,2.0,2.0,4.0,2.0,2.0,2.0,2.0,3.0,2.0,2,4.0,5.0,4.0,2.0,2.0,3.0,3.0,3.0,4.0,3.0,3.0,4.0,3.0,5.0,3.0,2.0,4.0,4.0,3.0,2.0,3.0,3.0,3.0,3.0,4.0,4.0,3.0,4.0,3.0,3.0,3.0,3.0,1,5.0,6.0,4.0,5.0,5.0,5.0,4.0,6.0,6.0,4.0,5.0,5.0,5.0,4.0,4.0,5.0,4.0,4.0,5.0,4.0,5.0,4.0,4.0,5.0,5.0,4.0,4.0,5.0,6.0,5.0,6.0,4.0,6,,,,,,,,,,,,,,,,,,,,,,,,,,,,,,,,,14,,,,,,,,,,,,,,,,,,,,,,,,,,,,,,,,,9,,,,,,,,,,,,,,,,,,,,,,,,,,,,,,,,,7,,,,,,,,,,,,,,,,,,,,,,,,,,,,,,,,,,347.8,21.71,,,,7.25,,45.46,,,,,,,,,,,,,,,,,,,,,,,,,,103.06,,,86.72,,,79.86,,,,,,,,,,,,,,,3.74,,APPROVED,Female,23.0,FALSE
426,2022-03-22 00:11:00,19,en,1933095578,2022-03-22 00:06:09,2022-03-22 00:11:00,Y,Y,A1,,,2,5.0,6.0,5.0,3.0,2.0,2.0,6.0,1.0,6.0,4.0,4.0,4.0,3.0,4.0,5.0,2.0,5.0,2.0,4.0,3.0,2.0,2.0,1.0,2.0,3.0,1.0,3.0,5.0,4.0,2.0,1.0,1.0,3,,,,,,,,,,,,,,,,,,,,,,,,,,,,,,,,,0,6.0,6.0,6.0,6.0,6.0,3.0,2.0,6.0,5.0,5.0,6.0,6.0,3.0,5.0,6.0,4.0,5.0,5.0,5.0,6.0,4.0,4.0,4.0,5.0,6.0,2.0,5.0,5.0,6.0,6.0,4.0,3.0,6,,,,,,,,,,,,,,,,,,,,,,,,,,,,,,,,,10,,,,,,,,,,,,,,,,,,,,,,,,,,,,,,,,,1,3.0,5.0,3.0,3.0,3.0,2.0,6.0,2.0,5.0,5.0,3.0,2.0,4.0,4.0,3.0,4.0,4.0,4.0,5.0,5.0,3.0,4.0,3.0,4.0,5.0,4.0,4.0,3.0,5.0,3.0,4.0,6.0,12,,,,,,,,,,,,,,,,,,,,,,,,,,,,,,,,,8,,,,,,,,,,,,,,,,,,,,,,,,,,,,,,,,,13,,,,,,,,,,,,,,,,,,,,,,,,,,,,,,,,,7,,,,,,,,,,,,,,,,,,,,,,,,,,,,,,,,,4,,,,,,,,,,,,,,,,,,,,,,,,,,,,,,,,,9,,,,,,,,,,,,,,,,,,,,,,,,,,,,,,,,,14,,,,,,,,,,,,,,,,,,,,,,,,,,,,,,,,,5,,,,,,,,,,,,,,,,,,,,,,,,,,,,,,,,,11,,,,,,,,,,,,,,,,,,,,,,,,,,,,,,,,,,295.0,12.34,,,,5.9,,35.84,,74.88,,,,,,89.55,,,,,,,,,73.08,,,,,,,,,,,,,,,,,,,,,,,,,,,,,,3.41,,APPROVED,Male,22.0,FALSE
429,2022-03-22 00:18:51,19,en,1679373288,2022-03-22 00:06:14,2022-03-22 00:18:51,Y,Y,-oth-,high school during a bachelor degree,,8,,,,,,,,,,,,,,,,,,,,,,,,,,,,,,,,,12,,,,,,,,,,,,,,,,,,,,,,,,,,,,,,,,,1,4.0,4.0,4.0,4.0,4.0,3.0,5.0,4.0,4.0,3.0,4.0,4.0,5.0,3.0,3.0,5.0,4.0,4.0,5.0,5.0,4.0,5.0,5.0,5.0,5.0,5.0,3.0,4.0,4.0,5.0,4.0,3.0,5,,,,,,,,,,,,,,,,,,,,,,,,,,,,,,,,,11,,,,,,,,,,,,,,,,,,,,,,,,,,,,,,,,,9,,,,,,,,,,,,,,,,,,,,,,,,,,,,,,,,,7,,,,,,,,,,,,,,,,,,,,,,,,,,,,,,,,,13,,,,,,,,,,,,,,,,,,,,,,,,,,,,,,,,,3,,,,,,,,,,,,,,,,,,,,,,,,,,,,,,,,,10,,,,,,,,,,,,,,,,,,,,,,,,,,,,,,,,,14,,,,,,,,,,,,,,,,,,,,,,,,,,,,,,,,,6,,,,,,,,,,,,,,,,,,,,,,,,,,,,,,,,,2,3.0,3.0,3.0,3.0,2.0,3.0,6.0,4.0,3.0,2.0,4.0,3.0,2.0,3.0,3.0,3.0,4.0,3.0,3.0,2.0,3.0,4.0,3.0,3.0,3.0,4.0,3.0,3.0,4.0,3.0,3.0,6.0,4,,,,,,,,,,,,,,,,,,,,,,,,,,,,,,,,,0,4.0,4.0,4.0,4.0,4.0,3.0,5.0,5.0,5.0,4.0,5.0,4.0,5.0,4.0,5.0,4.0,5.0,4.0,5.0,3.0,4.0,4.0,3.0,4.0,4.0,4.0,5.0,5.0,3.0,4.0,4.0,1.0,,761.19,19.85,,,,30.53,,282.94,,,,,,,,84.88,,,,,,,,,,,,,,,,,,,,,,,,,,,,,,197.0,,,,,,140.8,,,5.19,,APPROVED,Male,19.0,FALSE
430,2022-03-22 00:13:57,19,en,950873931,2022-03-22 00:06:16,2022-03-22 00:13:57,Y,Y,A1,,,2,5.0,6.0,7.0,5.0,4.0,6.0,5.0,6.0,6.0,4.0,5.0,3.0,5.0,6.0,6.0,6.0,5.0,4.0,5.0,6.0,3.0,5.0,5.0,6.0,6.0,5.0,4.0,5.0,5.0,5.0,5.0,1.0,10,,,,,,,,,,,,,,,,,,,,,,,,,,,,,,,,,0,4.0,6.0,5.0,3.0,5.0,2.0,7.0,6.0,6.0,2.0,2.0,3.0,4.0,3.0,3.0,4.0,5.0,2.0,4.0,4.0,1.0,5.0,2.0,3.0,6.0,2.0,2.0,4.0,2.0,5.0,3.0,3.0,11,,,,,,,,,,,,,,,,,,,,,,,,,,,,,,,,,4,,,,,,,,,,,,,,,,,,,,,,,,,,,,,,,,,3,,,,,,,,,,,,,,,,,,,,,,,,,,,,,,,,,6,,,,,,,,,,,,,,,,,,,,,,,,,,,,,,,,,14,,,,,,,,,,,,,,,,,,,,,,,,,,,,,,,,,5,,,,,,,,,,,,,,,,,,,,,,,,,,,,,,,,,1,2.0,5.0,2.0,5.0,1.0,1.0,7.0,1.0,3.0,1.0,1.0,3.0,2.0,3.0,5.0,2.0,5.0,1.0,2.0,2.0,1.0,2.0,1.0,2.0,1.0,1.0,4.0,1.0,1.0,2.0,2.0,3.0,9,,,,,,,,,,,,,,,,,,,,,,,,,,,,,,,,,8,,,,,,,,,,,,,,,,,,,,,,,,,,,,,,,,,7,,,,,,,,,,,,,,,,,,,,,,,,,,,,,,,,,13,,,,,,,,,,,,,,,,,,,,,,,,,,,,,,,,,12,,,,,,,,,,,,,,,,,,,,,,,,,,,,,,,,,,464.28,19.64,,,,11.89,,34.63,,127.45,,,,,,160.27,,,,,,,,,,,,,,,,,,,,,107.17,,,,,,,,,,,,,,,,,,3.23,,APPROVED,Female,21.0,FALSE
431,2022-03-22 00:10:30,19,en,585000135,2022-03-22 00:06:18,2022-03-22 00:10:30,Y,Y,A1,,,14,,,,,,,,,,,,,,,,,,,,,,,,,,,,,,,,,13,,,,,,,,,,,,,,,,,,,,,,,,,,,,,,,,,8,,,,,,,,,,,,,,,,,,,,,,,,,,,,,,,,,9,,,,,,,,,,,,,,,,,,,,,,,,,,,,,,,,,2,3.0,4.0,3.0,6.0,3.0,5.0,4.0,3.0,4.0,5.0,3.0,6.0,1.0,2.0,3.0,2.0,3.0,4.0,4.0,6.0,5.0,1.0,2.0,2.0,5.0,2.0,4.0,1.0,4.0,4.0,5.0,5.0,3,,,,,,,,,,,,,,,,,,,,,,,,,,,,,,,,,10,,,,,,,,,,,,,,,,,,,,,,,,,,,,,,,,,0,2.0,4.0,1.0,1.0,2.0,1.0,6.0,2.0,1.0,1.0,1.0,3.0,2.0,3.0,2.0,1.0,1.0,1.0,2.0,1.0,1.0,2.0,1.0,1.0,2.0,3.0,4.0,1.0,2.0,1.0,2.0,1.0,12,,,,,,,,,,,,,,,,,,,,,,,,,,,,,,,,,7,,,,,,,,,,,,,,,,,,,,,,,,,,,,,,,,,6,,,,,,,,,,,,,,,,,,,,,,,,,,,,,,,,,1,3.0,5.0,4.0,3.0,4.0,4.0,7.0,5.0,3.0,2.0,4.0,3.0,3.0,7.0,5.0,3.0,5.0,3.0,3.0,5.0,2.0,6.0,3.0,6.0,4.0,5.0,4.0,4.0,3.0,3.0,4.0,5.0,11,,,,,,,,,,,,,,,,,,,,,,,,,,,,,,,,,5,,,,,,,,,,,,,,,,,,,,,,,,,,,,,,,,,4,,,,,,,,,,,,,,,,,,,,,,,,,,,,,,,,,,256.77,33.83,,,,8.51,,52.93,,,,,,,,,,,,,,51.87,,,,,,,,,59.38,,,,,,,,,,,,46.56,,,,,,,,,,,,3.69,,APPROVED,Male,22.0,FALSE
434,2022-03-22 00:14:58,19,en,547495673,2022-03-22 00:06:35,2022-03-22 00:14:58,Y,Y,A1,,,3,,,,,,,,,,,,,,,,,,,,,,,,,,,,,,,,,2,5.0,5.0,5.0,6.0,4.0,5.0,3.0,5.0,5.0,4.0,4.0,6.0,6.0,4.0,4.0,5.0,6.0,6.0,4.0,4.0,5.0,4.0,6.0,7.0,4.0,4.0,4.0,7.0,5.0,5.0,5.0,2.0,11,,,,,,,,,,,,,,,,,,,,,,,,,,,,,,,,,1,5.0,3.0,5.0,5.0,4.0,6.0,5.0,5.0,5.0,6.0,5.0,5.0,4.0,6.0,3.0,4.0,7.0,5.0,6.0,3.0,5.0,4.0,5.0,6.0,4.0,5.0,6.0,5.0,4.0,4.0,5.0,4.0,6,,,,,,,,,,,,,,,,,,,,,,,,,,,,,,,,,12,,,,,,,,,,,,,,,,,,,,,,,,,,,,,,,,,7,,,,,,,,,,,,,,,,,,,,,,,,,,,,,,,,,0,4.0,5.0,3.0,4.0,3.0,4.0,4.0,3.0,3.0,5.0,4.0,4.0,3.0,4.0,4.0,2.0,4.0,4.0,3.0,3.0,3.0,2.0,4.0,4.0,3.0,5.0,3.0,4.0,3.0,4.0,3.0,3.0,4,,,,,,,,,,,,,,,,,,,,,,,,,,,,,,,,,10,,,,,,,,,,,,,,,,,,,,,,,,,,,,,,,,,5,,,,,,,,,,,,,,,,,,,,,,,,,,,,,,,,,14,,,,,,,,,,,,,,,,,,,,,,,,,,,,,,,,,9,,,,,,,,,,,,,,,,,,,,,,,,,,,,,,,,,13,,,,,,,,,,,,,,,,,,,,,,,,,,,,,,,,,8,,,,,,,,,,,,,,,,,,,,,,,,,,,,,,,,,,509.68,32.58,,,,10.64,,21.87,,,,,76.24,,,,,,242.68,,,,,,,,,,,,117.76,,,,,,,,,,,,,,,,,,,,,,,,7.91,,APPROVED,Female,26.0,FALSE
435,2022-03-22 00:13:28,19,en,1791181274,2022-03-22 00:06:39,2022-03-22 00:13:28,Y,Y,A2,,,3,,,,,,,,,,,,,,,,,,,,,,,,,,,,,,,,,14,,,,,,,,,,,,,,,,,,,,,,,,,,,,,,,,,6,,,,,,,,,,,,,,,,,,,,,,,,,,,,,,,,,2,6.0,7.0,6.0,4.0,7.0,5.0,6.0,4.0,7.0,5.0,5.0,6.0,6.0,6.0,6.0,5.0,5.0,6.0,5.0,5.0,5.0,5.0,5.0,5.0,6.0,5.0,5.0,6.0,7.0,6.0,4.0,4.0,10,,,,,,,,,,,,,,,,,,,,,,,,,,,,,,,,,0,3.0,3.0,3.0,1.0,5.0,1.0,6.0,1.0,6.0,1.0,3.0,4.0,3.0,1.0,1.0,1.0,1.0,3.0,3.0,3.0,1.0,3.0,1.0,1.0,1.0,4.0,1.0,4.0,2.0,3.0,2.0,6.0,12,,,,,,,,,,,,,,,,,,,,,,,,,,,,,,,,,7,,,,,,,,,,,,,,,,,,,,,,,,,,,,,,,,,9,,,,,,,,,,,,,,,,,,,,,,,,,,,,,,,,,5,,,,,,,,,,,,,,,,,,,,,,,,,,,,,,,,,1,6.0,7.0,6.0,4.0,5.0,5.0,3.0,5.0,6.0,4.0,7.0,5.0,4.0,4.0,4.0,4.0,5.0,3.0,4.0,5.0,5.0,4.0,4.0,4.0,5.0,6.0,5.0,5.0,6.0,3.0,3.0,4.0,11,,,,,,,,,,,,,,,,,,,,,,,,,,,,,,,,,13,,,,,,,,,,,,,,,,,,,,,,,,,,,,,,,,,4,,,,,,,,,,,,,,,,,,,,,,,,,,,,,,,,,8,,,,,,,,,,,,,,,,,,,,,,,,,,,,,,,,,,413.28,53.04,,,,9.61,,34.83,,,,,,,,,,,83.91,,,,,,115.75,,,,,,,,,,,,,,,111.52,,,,,,,,,,,,,,,4.62,,APPROVED,Male,48.0,FALSE
436,2022-03-22 00:15:01,19,en,24539432,2022-03-22 00:06:54,2022-03-22 00:15:01,Y,Y,-oth-,High School,,1,3.0,7.0,2.0,2.0,2.0,2.0,6.0,3.0,6.0,5.0,3.0,5.0,4.0,3.0,5.0,3.0,6.0,3.0,3.0,3.0,3.0,2.0,2.0,3.0,3.0,4.0,5.0,4.0,6.0,3.0,5.0,1.0,6,,,,,,,,,,,,,,,,,,,,,,,,,,,,,,,,,8,,,,,,,,,,,,,,,,,,,,,,,,,,,,,,,,,5,,,,,,,,,,,,,,,,,,,,,,,,,,,,,,,,,12,,,,,,,,,,,,,,,,,,,,,,,,,,,,,,,,,14,,,,,,,,,,,,,,,,,,,,,,,,,,,,,,,,,7,,,,,,,,,,,,,,,,,,,,,,,,,,,,,,,,,11,,,,,,,,,,,,,,,,,,,,,,,,,,,,,,,,,9,,,,,,,,,,,,,,,,,,,,,,,,,,,,,,,,,10,,,,,,,,,,,,,,,,,,,,,,,,,,,,,,,,,4,,,,,,,,,,,,,,,,,,,,,,,,,,,,,,,,,3,,,,,,,,,,,,,,,,,,,,,,,,,,,,,,,,,2,4.0,5.0,5.0,6.0,5.0,6.0,3.0,6.0,5.0,6.0,5.0,5.0,5.0,2.0,5.0,5.0,6.0,5.0,6.0,4.0,4.0,5.0,6.0,5.0,5.0,7.0,2.0,6.0,3.0,3.0,6.0,6.0,0,3.0,6.0,4.0,2.0,2.0,3.0,1.0,5.0,5.0,2.0,5.0,2.0,2.0,2.0,6.0,1.0,6.0,2.0,3.0,3.0,3.0,3.0,5.0,3.0,3.0,6.0,2.0,2.0,4.0,2.0,3.0,7.0,13,,,,,,,,,,,,,,,,,,,,,,,,,,,,,,,,,,488.49,51.0,,,,96.69,,54.27,,73.96,,,,,,,,,,,,,,,,,,,,,,,,,,,,,,,,,,,,81.17,,,128.28,,,,,,3.12,,APPROVED,Male,20.0,FALSE
437,2022-03-22 00:16:45,19,en,1903118408,2022-03-22 00:06:55,2022-03-22 00:16:45,Y,Y,A1,,,10,,,,,,,,,,,,,,,,,,,,,,,,,,,,,,,,,0,6.0,7.0,5.0,4.0,6.0,5.0,1.0,5.0,6.0,5.0,6.0,4.0,6.0,6.0,6.0,7.0,6.0,5.0,6.0,4.0,4.0,7.0,6.0,6.0,6.0,7.0,2.0,6.0,4.0,5.0,7.0,2.0,5,,,,,,,,,,,,,,,,,,,,,,,,,,,,,,,,,3,,,,,,,,,,,,,,,,,,,,,,,,,,,,,,,,,12,,,,,,,,,,,,,,,,,,,,,,,,,,,,,,,,,14,,,,,,,,,,,,,,,,,,,,,,,,,,,,,,,,,1,6.0,6.0,5.0,1.0,5.0,5.0,6.0,6.0,7.0,5.0,3.0,4.0,6.0,5.0,7.0,5.0,5.0,4.0,6.0,6.0,2.0,7.0,3.0,5.0,5.0,5.0,1.0,6.0,5.0,5.0,5.0,7.0,6,,,,,,,,,,,,,,,,,,,,,,,,,,,,,,,,,2,2.0,4.0,3.0,2.0,2.0,1.0,5.0,1.0,4.0,3.0,2.0,4.0,3.0,1.0,5.0,2.0,5.0,3.0,3.0,3.0,4.0,3.0,5.0,3.0,4.0,6.0,5.0,2.0,6.0,3.0,4.0,2.0,8,,,,,,,,,,,,,,,,,,,,,,,,,,,,,,,,,4,,,,,,,,,,,,,,,,,,,,,,,,,,,,,,,,,11,,,,,,,,,,,,,,,,,,,,,,,,,,,,,,,,,7,,,,,,,,,,,,,,,,,,,,,,,,,,,,,,,,,9,,,,,,,,,,,,,,,,,,,,,,,,,,,,,,,,,13,,,,,,,,,,,,,,,,,,,,,,,,,,,,,,,,,,592.75,18.43,,,,73.3,,72.1,,,,,194.76,,,,,,,,,,,,,,,126.29,,,,,,104.07,,,,,,,,,,,,,,,,,,,,,3.8,,APPROVED,Male,19.0,FALSE
438,2022-03-22 00:18:17,19,en,1686594063,2022-03-22 00:07:21,2022-03-22 00:18:17,Y,Y,A1,,,5,,,,,,,,,,,,,,,,,,,,,,,,,,,,,,,,,13,,,,,,,,,,,,,,,,,,,,,,,,,,,,,,,,,0,4.0,6.0,2.0,1.0,6.0,2.0,2.0,5.0,6.0,3.0,3.0,2.0,1.0,3.0,2.0,3.0,4.0,2.0,4.0,4.0,2.0,4.0,6.0,4.0,5.0,2.0,5.0,6.0,2.0,3.0,3.0,3.0,14,,,,,,,,,,,,,,,,,,,,,,,,,,,,,,,,,7,,,,,,,,,,,,,,,,,,,,,,,,,,,,,,,,,1,2.0,4.0,1.0,2.0,2.0,1.0,7.0,1.0,4.0,1.0,2.0,1.0,1.0,2.0,1.0,2.0,2.0,2.0,1.0,1.0,2.0,1.0,4.0,2.0,1.0,4.0,5.0,1.0,2.0,2.0,1.0,6.0,3,,,,,,,,,,,,,,,,,,,,,,,,,,,,,,,,,9,,,,,,,,,,,,,,,,,,,,,,,,,,,,,,,,,10,,,,,,,,,,,,,,,,,,,,,,,,,,,,,,,,,8,,,,,,,,,,,,,,,,,,,,,,,,,,,,,,,,,11,,,,,,,,,,,,,,,,,,,,,,,,,,,,,,,,,12,,,,,,,,,,,,,,,,,,,,,,,,,,,,,,,,,6,,,,,,,,,,,,,,,,,,,,,,,,,,,,,,,,,4,,,,,,,,,,,,,,,,,,,,,,,,,,,,,,,,,2,6.0,7.0,6.0,6.0,7.0,5.0,4.0,7.0,7.0,7.0,5.0,7.0,6.0,6.0,6.0,6.0,6.0,6.0,6.0,6.0,5.0,7.0,6.0,6.0,6.0,5.0,3.0,7.0,6.0,6.0,6.0,1.0,This survey was very engaging and awesome to participate in.,659.41,126.53,,,,10.83,,126.58,,,,,,,,142.38,,,,,,,,,105.12,,,,,,,,,,,,,,,,,,,,,,,,,,,102.8,,,45.17,,APPROVED,Male,24.0,FALSE
439,2022-03-22 00:22:02,19,en,561133257,2022-03-22 00:15:30,2022-03-22 00:22:02,Y,Y,A2,,,13,,,,,,,,,,,,,,,,,,,,,,,,,,,,,,,,,9,,,,,,,,,,,,,,,,,,,,,,,,,,,,,,,,,3,,,,,,,,,,,,,,,,,,,,,,,,,,,,,,,,,8,,,,,,,,,,,,,,,,,,,,,,,,,,,,,,,,,4,,,,,,,,,,,,,,,,,,,,,,,,,,,,,,,,,7,,,,,,,,,,,,,,,,,,,,,,,,,,,,,,,,,5,,,,,,,,,,,,,,,,,,,,,,,,,,,,,,,,,12,,,,,,,,,,,,,,,,,,,,,,,,,,,,,,,,,14,,,,,,,,,,,,,,,,,,,,,,,,,,,,,,,,,11,,,,,,,,,,,,,,,,,,,,,,,,,,,,,,,,,10,,,,,,,,,,,,,,,,,,,,,,,,,,,,,,,,,0,5.0,6.0,5.0,4.0,5.0,4.0,5.0,5.0,5.0,4.0,5.0,5.0,5.0,4.0,5.0,5.0,5.0,4.0,5.0,5.0,5.0,6.0,4.0,5.0,5.0,5.0,4.0,5.0,4.0,4.0,4.0,5.0,6,,,,,,,,,,,,,,,,,,,,,,,,,,,,,,,,,1,5.0,5.0,4.0,3.0,3.0,3.0,4.0,4.0,5.0,4.0,5.0,3.0,5.0,3.0,4.0,3.0,5.0,3.0,3.0,4.0,4.0,3.0,5.0,3.0,3.0,5.0,4.0,3.0,4.0,4.0,5.0,7.0,2,5.0,6.0,5.0,5.0,4.0,4.0,4.0,5.0,5.0,5.0,4.0,4.0,4.0,4.0,4.0,5.0,6.0,5.0,5.0,5.0,4.0,5.0,5.0,5.0,4.0,5.0,4.0,4.0,4.0,4.0,4.0,7.0,,528.73,22.82,,,,5.29,,87.34,,,,,,,,,,,,,,,,,,,,,,,,,,,,,,,,,,,75.24,,,,,,270.18,,,58.64,,,9.22,,APPROVED,Male,39.0,FALSE
442,2022-03-22 00:25:44,19,en,126170467,2022-03-22 00:19:16,2022-03-22 00:25:44,Y,Y,A1,,,9,,,,,,,,,,,,,,,,,,,,,,,,,,,,,,,,,1,5.0,3.0,5.0,6.0,5.0,6.0,4.0,7.0,2.0,3.0,6.0,4.0,5.0,3.0,3.0,6.0,5.0,5.0,5.0,3.0,4.0,5.0,6.0,5.0,4.0,6.0,3.0,6.0,4.0,4.0,6.0,2.0,14,,,,,,,,,,,,,,,,,,,,,,,,,,,,,,,,,6,,,,,,,,,,,,,,,,,,,,,,,,,,,,,,,,,4,,,,,,,,,,,,,,,,,,,,,,,,,,,,,,,,,13,,,,,,,,,,,,,,,,,,,,,,,,,,,,,,,,,5,,,,,,,,,,,,,,,,,,,,,,,,,,,,,,,,,3,,,,,,,,,,,,,,,,,,,,,,,,,,,,,,,,,0,1.0,3.0,1.0,2.0,1.0,1.0,1.0,1.0,3.0,1.0,2.0,2.0,1.0,1.0,1.0,1.0,2.0,1.0,2.0,1.0,1.0,1.0,1.0,1.0,1.0,1.0,4.0,1.0,1.0,1.0,1.0,2.0,11,,,,,,,,,,,,,,,,,,,,,,,,,,,,,,,,,12,,,,,,,,,,,,,,,,,,,,,,,,,,,,,,,,,8,,,,,,,,,,,,,,,,,,,,,,,,,,,,,,,,,2,4.0,5.0,3.0,5.0,4.0,3.0,3.0,5.0,6.0,3.0,3.0,3.0,3.0,3.0,4.0,4.0,5.0,4.0,3.0,3.0,3.0,3.0,3.0,3.0,3.0,6.0,4.0,3.0,7.0,3.0,5.0,6.0,7,,,,,,,,,,,,,,,,,,,,,,,,,,,,,,,,,10,,,,,,,,,,,,,,,,,,,,,,,,,,,,,,,,,,391.2,106.48,,,,12.46,,59.15,,,,,63.62,,,,,,,,,,,,,,,,,,,,,71.08,,,,,,,,,,,,73.66,,,,,,,,,4.75,,APPROVED,Male,22.0,FALSE
446,2022-03-22 00:26:41,19,en,1900044647,2022-03-22 00:19:21,2022-03-22 00:26:41,Y,Y,-oth-,High school,,0,2.0,5.0,1.0,1.0,2.0,2.0,7.0,2.0,2.0,2.0,2.0,1.0,2.0,3.0,4.0,1.0,4.0,2.0,2.0,1.0,2.0,2.0,1.0,1.0,2.0,1.0,2.0,1.0,1.0,1.0,1.0,1.0,12,,,,,,,,,,,,,,,,,,,,,,,,,,,,,,,,,2,5.0,4.0,5.0,4.0,5.0,3.0,7.0,6.0,5.0,4.0,5.0,5.0,5.0,4.0,3.0,5.0,5.0,4.0,5.0,4.0,3.0,5.0,2.0,4.0,4.0,3.0,4.0,5.0,3.0,5.0,4.0,3.0,6,,,,,,,,,,,,,,,,,,,,,,,,,,,,,,,,,4,,,,,,,,,,,,,,,,,,,,,,,,,,,,,,,,,14,,,,,,,,,,,,,,,,,,,,,,,,,,,,,,,,,8,,,,,,,,,,,,,,,,,,,,,,,,,,,,,,,,,1,5.0,2.0,5.0,3.0,3.0,5.0,5.0,3.0,4.0,4.0,3.0,5.0,5.0,4.0,5.0,6.0,6.0,6.0,6.0,5.0,3.0,6.0,4.0,6.0,3.0,3.0,4.0,5.0,5.0,5.0,4.0,1.0,9,,,,,,,,,,,,,,,,,,,,,,,,,,,,,,,,,10,,,,,,,,,,,,,,,,,,,,,,,,,,,,,,,,,11,,,,,,,,,,,,,,,,,,,,,,,,,,,,,,,,,3,,,,,,,,,,,,,,,,,,,,,,,,,,,,,,,,,13,,,,,,,,,,,,,,,,,,,,,,,,,,,,,,,,,5,,,,,,,,,,,,,,,,,,,,,,,,,,,,,,,,,7,,,,,,,,,,,,,,,,,,,,,,,,,,,,,,,,,,389.81,64.93,,,,12.7,,52.29,,76.22,,,,,,82.97,,,,,,,,,,,,,,,97.07,,,,,,,,,,,,,,,,,,,,,,,,3.63,,APPROVED,Male,21.0,FALSE
449,2022-03-22 00:27:07,19,en,1778609274,2022-03-22 00:19:22,2022-03-22 00:27:07,Y,Y,A1,,,6,,,,,,,,,,,,,,,,,,,,,,,,,,,,,,,,,9,,,,,,,,,,,,,,,,,,,,,,,,,,,,,,,,,0,5.0,6.0,6.0,4.0,4.0,3.0,6.0,4.0,6.0,5.0,5.0,6.0,6.0,4.0,5.0,3.0,6.0,4.0,6.0,6.0,5.0,5.0,3.0,6.0,7.0,3.0,4.0,6.0,7.0,4.0,6.0,3.0,12,,,,,,,,,,,,,,,,,,,,,,,,,,,,,,,,,8,,,,,,,,,,,,,,,,,,,,,,,,,,,,,,,,,7,,,,,,,,,,,,,,,,,,,,,,,,,,,,,,,,,1,2.0,4.0,2.0,6.0,1.0,6.0,3.0,4.0,4.0,2.0,3.0,5.0,2.0,4.0,4.0,3.0,4.0,2.0,3.0,2.0,4.0,2.0,5.0,4.0,3.0,6.0,4.0,4.0,3.0,6.0,6.0,7.0,14,,,,,,,,,,,,,,,,,,,,,,,,,,,,,,,,,3,,,,,,,,,,,,,,,,,,,,,,,,,,,,,,,,,2,4.0,5.0,5.0,3.0,6.0,4.0,6.0,4.0,3.0,4.0,4.0,6.0,5.0,4.0,6.0,2.0,5.0,4.0,6.0,4.0,4.0,5.0,2.0,5.0,3.0,3.0,5.0,4.0,4.0,4.0,4.0,3.0,13,,,,,,,,,,,,,,,,,,,,,,,,,,,,,,,,,5,,,,,,,,,,,,,,,,,,,,,,,,,,,,,,,,,10,,,,,,,,,,,,,,,,,,,,,,,,,,,,,,,,,4,,,,,,,,,,,,,,,,,,,,,,,,,,,,,,,,,11,,,,,,,,,,,,,,,,,,,,,,,,,,,,,,,,,,392.41,24.48,,,,34.14,,40.2,,,,,,,,100.84,,,,,,,,,,,,103.91,,,,,,,,,86.32,,,,,,,,,,,,,,,,,,2.52,,APPROVED,Female,31.0,FALSE
450,2022-03-22 00:25:09,19,en,1960983671,2022-03-22 00:19:23,2022-03-22 00:25:09,Y,Y,A1,,,11,,,,,,,,,,,,,,,,,,,,,,,,,,,,,,,,,5,,,,,,,,,,,,,,,,,,,,,,,,,,,,,,,,,7,,,,,,,,,,,,,,,,,,,,,,,,,,,,,,,,,1,3.0,5.0,3.0,2.0,2.0,3.0,4.0,4.0,6.0,3.0,2.0,3.0,3.0,4.0,6.0,4.0,5.0,3.0,2.0,2.0,3.0,2.0,2.0,2.0,3.0,2.0,2.0,2.0,3.0,3.0,4.0,4.0,10,,,,,,,,,,,,,,,,,,,,,,,,,,,,,,,,,9,,,,,,,,,,,,,,,,,,,,,,,,,,,,,,,,,2,2.0,5.0,2.0,3.0,2.0,2.0,2.0,6.0,6.0,2.0,2.0,2.0,2.0,2.0,2.0,2.0,6.0,2.0,2.0,2.0,2.0,2.0,2.0,2.0,2.0,2.0,5.0,2.0,2.0,2.0,4.0,7.0,12,,,,,,,,,,,,,,,,,,,,,,,,,,,,,,,,,3,,,,,,,,,,,,,,,,,,,,,,,,,,,,,,,,,8,,,,,,,,,,,,,,,,,,,,,,,,,,,,,,,,,0,2.0,6.0,3.0,3.0,2.0,2.0,4.0,5.0,7.0,3.0,2.0,5.0,2.0,3.0,5.0,3.0,5.0,2.0,3.0,3.0,2.0,3.0,2.0,2.0,2.0,1.0,5.0,2.0,2.0,2.0,5.0,4.0,6,,,,,,,,,,,,,,,,,,,,,,,,,,,,,,,,,14,,,,,,,,,,,,,,,,,,,,,,,,,,,,,,,,,4,,,,,,,,,,,,,,,,,,,,,,,,,,,,,,,,,13,,,,,,,,,,,,,,,,,,,,,,,,,,,,,,,,,,278.38,43.35,,,,12.03,,37.01,,,,,,,,,,,60.85,,,,,,,,,49.29,,,,,,,,,,,,72.24,,,,,,,,,,,,,,,3.61,,APPROVED,Male,21.0,FALSE
451,2022-03-22 00:25:31,19,en,847650,2022-03-22 00:19:23,2022-03-22 00:25:31,Y,Y,A1,,,1,1.0,7.0,4.0,5.0,7.0,1.0,7.0,7.0,7.0,1.0,1.0,2.0,1.0,3.0,5.0,3.0,2.0,1.0,1.0,1.0,1.0,5.0,1.0,6.0,1.0,7.0,6.0,7.0,1.0,1.0,5.0,1.0,4,,,,,,,,,,,,,,,,,,,,,,,,,,,,,,,,,13,,,,,,,,,,,,,,,,,,,,,,,,,,,,,,,,,8,,,,,,,,,,,,,,,,,,,,,,,,,,,,,,,,,10,,,,,,,,,,,,,,,,,,,,,,,,,,,,,,,,,6,,,,,,,,,,,,,,,,,,,,,,,,,,,,,,,,,3,,,,,,,,,,,,,,,,,,,,,,,,,,,,,,,,,0,1.0,6.0,1.0,2.0,1.0,1.0,7.0,5.0,7.0,1.0,1.0,3.0,1.0,1.0,1.0,1.0,1.0,1.0,1.0,1.0,1.0,1.0,1.0,1.0,1.0,6.0,1.0,1.0,1.0,1.0,1.0,1.0,2,6.0,7.0,4.0,7.0,1.0,7.0,1.0,1.0,6.0,6.0,1.0,7.0,5.0,2.0,7.0,7.0,6.0,6.0,2.0,1.0,7.0,7.0,7.0,7.0,1.0,7.0,4.0,7.0,7.0,5.0,7.0,2.0,5,,,,,,,,,,,,,,,,,,,,,,,,,,,,,,,,,12,,,,,,,,,,,,,,,,,,,,,,,,,,,,,,,,,14,,,,,,,,,,,,,,,,,,,,,,,,,,,,,,,,,7,,,,,,,,,,,,,,,,,,,,,,,,,,,,,,,,,11,,,,,,,,,,,,,,,,,,,,,,,,,,,,,,,,,9,,,,,,,,,,,,,,,,,,,,,,,,,,,,,,,,,,368.44,29.2,,,,16.98,,39.79,,127.35,,,,,,,,,,,,,,,,,,,,,87.88,,,64.25,,,,,,,,,,,,,,,,,,,,,2.99,,APPROVED,Female,23.0,FALSE
453,2022-03-22 00:28:32,19,en,1749379918,2022-03-22 00:19:26,2022-03-22 00:28:32,Y,Y,A1,,,2,5.0,6.0,5.0,4.0,5.0,4.0,4.0,5.0,6.0,4.0,4.0,4.0,6.0,5.0,5.0,5.0,5.0,4.0,6.0,4.0,1.0,6.0,4.0,6.0,6.0,6.0,4.0,4.0,6.0,1.0,5.0,1.0,14,,,,,,,,,,,,,,,,,,,,,,,,,,,,,,,,,6,,,,,,,,,,,,,,,,,,,,,,,,,,,,,,,,,7,,,,,,,,,,,,,,,,,,,,,,,,,,,,,,,,,4,,,,,,,,,,,,,,,,,,,,,,,,,,,,,,,,,11,,,,,,,,,,,,,,,,,,,,,,,,,,,,,,,,,8,,,,,,,,,,,,,,,,,,,,,,,,,,,,,,,,,3,,,,,,,,,,,,,,,,,,,,,,,,,,,,,,,,,9,,,,,,,,,,,,,,,,,,,,,,,,,,,,,,,,,12,,,,,,,,,,,,,,,,,,,,,,,,,,,,,,,,,10,,,,,,,,,,,,,,,,,,,,,,,,,,,,,,,,,0,4.0,1.0,4.0,3.0,3.0,3.0,4.0,3.0,4.0,3.0,3.0,4.0,3.0,3.0,3.0,4.0,4.0,3.0,4.0,3.0,3.0,3.0,4.0,4.0,3.0,4.0,1.0,4.0,4.0,3.0,4.0,5.0,13,,,,,,,,,,,,,,,,,,,,,,,,,,,,,,,,,1,5.0,5.0,5.0,4.0,4.0,5.0,4.0,5.0,5.0,4.0,3.0,4.0,4.0,5.0,5.0,4.0,5.0,4.0,4.0,4.0,5.0,5.0,5.0,4.0,4.0,7.0,1.0,5.0,5.0,1.0,7.0,7.0,5,,,,,,,,,,,,,,,,,,,,,,,,,,,,,,,,,I have none thank you,548.72,27.24,,,,15.26,,79.69,,133.56,,,,,,,,,,,,,,,,,,,,,,,,,,,,,,,,,149.73,,,,,,120.28,,,,,,22.96,,APPROVED,Male,45.0,FALSE
454,2022-03-22 00:27:47,19,en,205444965,2022-03-22 00:19:27,2022-03-22 00:27:47,Y,Y,A1,,,12,,,,,,,,,,,,,,,,,,,,,,,,,,,,,,,,,5,,,,,,,,,,,,,,,,,,,,,,,,,,,,,,,,,7,,,,,,,,,,,,,,,,,,,,,,,,,,,,,,,,,10,,,,,,,,,,,,,,,,,,,,,,,,,,,,,,,,,9,,,,,,,,,,,,,,,,,,,,,,,,,,,,,,,,,6,,,,,,,,,,,,,,,,,,,,,,,,,,,,,,,,,14,,,,,,,,,,,,,,,,,,,,,,,,,,,,,,,,,8,,,,,,,,,,,,,,,,,,,,,,,,,,,,,,,,,1,1.0,1.0,2.0,3.0,2.0,1.0,7.0,4.0,1.0,2.0,1.0,2.0,2.0,1.0,2.0,2.0,4.0,3.0,2.0,1.0,2.0,2.0,4.0,1.0,1.0,1.0,3.0,1.0,1.0,1.0,1.0,2.0,2,3.0,5.0,4.0,4.0,4.0,3.0,7.0,6.0,4.0,3.0,4.0,4.0,3.0,2.0,5.0,3.0,5.0,3.0,4.0,2.0,4.0,4.0,3.0,3.0,2.0,5.0,6.0,4.0,4.0,2.0,2.0,3.0,11,,,,,,,,,,,,,,,,,,,,,,,,,,,,,,,,,13,,,,,,,,,,,,,,,,,,,,,,,,,,,,,,,,,3,,,,,,,,,,,,,,,,,,,,,,,,,,,,,,,,,0,4.0,3.0,5.0,4.0,4.0,6.0,5.0,3.0,2.0,4.0,3.0,5.0,4.0,4.0,3.0,3.0,5.0,4.0,4.0,4.0,5.0,5.0,6.0,4.0,3.0,5.0,3.0,5.0,4.0,4.0,5.0,7.0,4,,,,,,,,,,,,,,,,,,,,,,,,,,,,,,,,,,289.62,4.59,,,,7.98,,11.3,,,,,,,,,,,,,,,,,,,,,,,,,,67.75,,,82.32,,,,,,,,,,,,110.36,,,,,,5.32,,APPROVED,Male,31.0,FALSE
455,2022-03-22 00:29:21,19,en,411032803,2022-03-22 00:19:30,2022-03-22 00:29:21,Y,Y,A1,,,2,6.0,6.0,5.0,2.0,6.0,2.0,6.0,6.0,6.0,3.0,2.0,6.0,6.0,6.0,7.0,1.0,6.0,5.0,5.0,4.0,5.0,6.0,1.0,6.0,6.0,5.0,6.0,7.0,5.0,5.0,3.0,1.0,10,,,,,,,,,,,,,,,,,,,,,,,,,,,,,,,,,7,,,,,,,,,,,,,,,,,,,,,,,,,,,,,,,,,6,,,,,,,,,,,,,,,,,,,,,,,,,,,,,,,,,5,,,,,,,,,,,,,,,,,,,,,,,,,,,,,,,,,9,,,,,,,,,,,,,,,,,,,,,,,,,,,,,,,,,14,,,,,,,,,,,,,,,,,,,,,,,,,,,,,,,,,3,,,,,,,,,,,,,,,,,,,,,,,,,,,,,,,,,0,2.0,2.0,2.0,2.0,2.0,1.0,6.0,1.0,2.0,2.0,2.0,5.0,2.0,2.0,2.0,2.0,2.0,2.0,1.0,3.0,2.0,1.0,1.0,1.0,2.0,5.0,2.0,3.0,6.0,2.0,2.0,2.0,12,,,,,,,,,,,,,,,,,,,,,,,,,,,,,,,,,4,,,,,,,,,,,,,,,,,,,,,,,,,,,,,,,,,13,,,,,,,,,,,,,,,,,,,,,,,,,,,,,,,,,8,,,,,,,,,,,,,,,,,,,,,,,,,,,,,,,,,1,5.0,2.0,5.0,5.0,3.0,5.0,3.0,2.0,6.0,5.0,4.0,6.0,5.0,6.0,5.0,6.0,7.0,5.0,5.0,3.0,5.0,5.0,5.0,3.0,4.0,5.0,5.0,5.0,6.0,4.0,6.0,7.0,11,,,,,,,,,,,,,,,,,,,,,,,,,,,,,,,,,,525.41,24.61,,,,70.71,,78.63,,97.05,,,,,,,,,,,,,,,,,,,,,,,,144.78,,,,,,,,,,,,,,,105.01,,,,,,4.62,,APPROVED,Male,19.0,FALSE
456,2022-03-22 00:28:57,19,en,1460424417,2022-03-22 00:19:30,2022-03-22 00:28:57,Y,Y,A1,,,5,,,,,,,,,,,,,,,,,,,,,,,,,,,,,,,,,12,,,,,,,,,,,,,,,,,,,,,,,,,,,,,,,,,9,,,,,,,,,,,,,,,,,,,,,,,,,,,,,,,,,14,,,,,,,,,,,,,,,,,,,,,,,,,,,,,,,,,2,2.0,6.0,5.0,2.0,2.0,2.0,7.0,6.0,3.0,2.0,3.0,3.0,3.0,1.0,6.0,2.0,5.0,1.0,5.0,1.0,3.0,3.0,1.0,5.0,3.0,2.0,6.0,3.0,5.0,2.0,2.0,5.0,8,,,,,,,,,,,,,,,,,,,,,,,,,,,,,,,,,7,,,,,,,,,,,,,,,,,,,,,,,,,,,,,,,,,10,,,,,,,,,,,,,,,,,,,,,,,,,,,,,,,,,13,,,,,,,,,,,,,,,,,,,,,,,,,,,,,,,,,4,,,,,,,,,,,,,,,,,,,,,,,,,,,,,,,,,3,,,,,,,,,,,,,,,,,,,,,,,,,,,,,,,,,1,7.0,7.0,6.0,6.0,7.0,6.0,2.0,6.0,5.0,4.0,3.0,6.0,6.0,4.0,7.0,6.0,7.0,5.0,6.0,6.0,5.0,6.0,5.0,5.0,6.0,7.0,5.0,6.0,6.0,7.0,7.0,5.0,0,5.0,6.0,6.0,3.0,5.0,3.0,7.0,2.0,7.0,5.0,3.0,5.0,6.0,4.0,6.0,5.0,6.0,3.0,6.0,5.0,4.0,6.0,3.0,5.0,6.0,2.0,1.0,7.0,6.0,5.0,5.0,6.0,11,,,,,,,,,,,,,,,,,,,,,,,,,,,,,,,,,6,,,,,,,,,,,,,,,,,,,,,,,,,,,,,,,,,,566.34,117.18,,,,24.62,,36.58,,,,,,,,,,,,,,121.55,,,,,,,,,,,,,,,,,,,,,111.1,,,151.26,,,,,,,,,4.05,,APPROVED,Male,21.0,FALSE
457,2022-03-22 00:30:02,19,en,217519300,2022-03-22 00:19:30,2022-03-22 00:30:02,Y,Y,A1,,,5,,,,,,,,,,,,,,,,,,,,,,,,,,,,,,,,,4,,,,,,,,,,,,,,,,,,,,,,,,,,,,,,,,,11,,,,,,,,,,,,,,,,,,,,,,,,,,,,,,,,,1,5.0,6.0,6.0,6.0,5.0,3.0,5.0,4.0,5.0,6.0,6.0,4.0,5.0,5.0,6.0,5.0,6.0,5.0,4.0,6.0,4.0,6.0,5.0,6.0,5.0,7.0,6.0,5.0,6.0,4.0,6.0,4.0,2,3.0,3.0,3.0,4.0,3.0,4.0,3.0,4.0,3.0,4.0,2.0,2.0,4.0,2.0,2.0,3.0,2.0,2.0,2.0,3.0,3.0,3.0,6.0,3.0,3.0,3.0,3.0,4.0,3.0,4.0,2.0,5.0,10,,,,,,,,,,,,,,,,,,,,,,,,,,,,,,,,,9,,,,,,,,,,,,,,,,,,,,,,,,,,,,,,,,,14,,,,,,,,,,,,,,,,,,,,,,,,,,,,,,,,,6,,,,,,,,,,,,,,,,,,,,,,,,,,,,,,,,,3,,,,,,,,,,,,,,,,,,,,,,,,,,,,,,,,,8,,,,,,,,,,,,,,,,,,,,,,,,,,,,,,,,,13,,,,,,,,,,,,,,,,,,,,,,,,,,,,,,,,,0,1.0,6.0,1.0,1.0,6.0,2.0,7.0,5.0,3.0,2.0,2.0,3.0,1.0,4.0,2.0,2.0,5.0,1.0,3.0,2.0,2.0,3.0,2.0,1.0,6.0,3.0,4.0,2.0,4.0,2.0,1.0,6.0,12,,,,,,,,,,,,,,,,,,,,,,,,,,,,,,,,,7,,,,,,,,,,,,,,,,,,,,,,,,,,,,,,,,,,632.73,368.31,,,,101.39,,21.48,,,,,,,,,,,40.38,,,40.55,,,,,,,,,,,,,,,,,,,,,,,,57.65,,,,,,,,,2.97,,APPROVED,Male,23.0,FALSE
458,2022-03-22 00:24:04,19,en,1702562628,2022-03-22 00:19:30,2022-03-22 00:24:04,Y,Y,-oth-,,,11,,,,,,,,,,,,,,,,,,,,,,,,,,,,,,,,,5,,,,,,,,,,,,,,,,,,,,,,,,,,,,,,,,,3,,,,,,,,,,,,,,,,,,,,,,,,,,,,,,,,,9,,,,,,,,,,,,,,,,,,,,,,,,,,,,,,,,,13,,,,,,,,,,,,,,,,,,,,,,,,,,,,,,,,,0,7.0,7.0,7.0,6.0,7.0,7.0,6.0,7.0,7.0,7.0,7.0,7.0,7.0,7.0,7.0,7.0,7.0,7.0,7.0,7.0,7.0,7.0,6.0,7.0,7.0,7.0,6.0,7.0,7.0,7.0,7.0,6.0,10,,,,,,,,,,,,,,,,,,,,,,,,,,,,,,,,,8,,,,,,,,,,,,,,,,,,,,,,,,,,,,,,,,,14,,,,,,,,,,,,,,,,,,,,,,,,,,,,,,,,,7,,,,,,,,,,,,,,,,,,,,,,,,,,,,,,,,,4,,,,,,,,,,,,,,,,,,,,,,,,,,,,,,,,,2,5.0,5.0,5.0,6.0,6.0,4.0,5.0,4.0,5.0,5.0,6.0,5.0,5.0,6.0,5.0,4.0,5.0,5.0,6.0,5.0,5.0,5.0,4.0,6.0,5.0,4.0,5.0,5.0,4.0,5.0,5.0,5.0,12,,,,,,,,,,,,,,,,,,,,,,,,,,,,,,,,,6,,,,,,,,,,,,,,,,,,,,,,,,,,,,,,,,,1,4.0,4.0,4.0,3.0,4.0,3.0,4.0,3.0,5.0,5.0,5.0,4.0,4.0,4.0,4.0,3.0,3.0,4.0,4.0,4.0,3.0,4.0,3.0,4.0,4.0,3.0,4.0,4.0,4.0,4.0,5.0,1.0,,257.75,25.52,,,,12.09,,25.77,,,,,,,,,,,,,,,,,65.3,,,,,,,,,,,,,,,,,,63.58,,,,,,,,,62.02,,,3.47,,APPROVED,Male,24.0,FALSE
461,2022-03-22 00:26:15,19,en,1940416544,2022-03-22 00:19:41,2022-03-22 00:26:15,Y,Y,A3,,,2,6.0,6.0,6.0,7.0,6.0,6.0,4.0,6.0,5.0,6.0,6.0,4.0,6.0,6.0,6.0,7.0,4.0,4.0,6.0,5.0,3.0,6.0,6.0,5.0,6.0,4.0,3.0,5.0,5.0,6.0,6.0,1.0,10,,,,,,,,,,,,,,,,,,,,,,,,,,,,,,,,,4,,,,,,,,,,,,,,,,,,,,,,,,,,,,,,,,,9,,,,,,,,,,,,,,,,,,,,,,,,,,,,,,,,,12,,,,,,,,,,,,,,,,,,,,,,,,,,,,,,,,,5,,,,,,,,,,,,,,,,,,,,,,,,,,,,,,,,,8,,,,,,,,,,,,,,,,,,,,,,,,,,,,,,,,,7,,,,,,,,,,,,,,,,,,,,,,,,,,,,,,,,,6,,,,,,,,,,,,,,,,,,,,,,,,,,,,,,,,,11,,,,,,,,,,,,,,,,,,,,,,,,,,,,,,,,,13,,,,,,,,,,,,,,,,,,,,,,,,,,,,,,,,,1,5.0,6.0,3.0,3.0,4.0,3.0,4.0,2.0,3.0,4.0,4.0,2.0,4.0,3.0,5.0,3.0,3.0,3.0,4.0,5.0,2.0,5.0,2.0,4.0,5.0,3.0,5.0,5.0,3.0,4.0,4.0,5.0,3,,,,,,,,,,,,,,,,,,,,,,,,,,,,,,,,,0,2.0,3.0,3.0,3.0,5.0,5.0,4.0,5.0,5.0,2.0,4.0,4.0,4.0,5.0,5.0,4.0,6.0,2.0,3.0,3.0,4.0,5.0,5.0,3.0,3.0,5.0,4.0,3.0,4.0,4.0,5.0,7.0,14,,,,,,,,,,,,,,,,,,,,,,,,,,,,,,,,,,260.57,9.61,,,,4.73,,26.15,,81.4,,,,,,,,,,,,,,,,,,,,,,,,,,,,,,,,,63.92,,,,,,72.57,,,,,,2.19,,APPROVED,Male,31.0,FALSE
462,2022-03-22 00:32:14,19,en,1204626130,2022-03-22 00:19:41,2022-03-22 00:32:14,Y,Y,A1,,,12,,,,,,,,,,,,,,,,,,,,,,,,,,,,,,,,,4,,,,,,,,,,,,,,,,,,,,,,,,,,,,,,,,,1,5.0,6.0,5.0,6.0,7.0,7.0,2.0,7.0,6.0,6.0,5.0,6.0,6.0,6.0,5.0,6.0,7.0,6.0,6.0,5.0,5.0,5.0,6.0,7.0,7.0,7.0,1.0,6.0,5.0,6.0,6.0,3.0,11,,,,,,,,,,,,,,,,,,,,,,,,,,,,,,,,,0,3.0,5.0,5.0,2.0,2.0,3.0,7.0,3.0,6.0,3.0,5.0,6.0,3.0,6.0,6.0,2.0,6.0,5.0,2.0,3.0,5.0,5.0,3.0,4.0,2.0,5.0,2.0,6.0,4.0,5.0,4.0,5.0,5,,,,,,,,,,,,,,,,,,,,,,,,,,,,,,,,,14,,,,,,,,,,,,,,,,,,,,,,,,,,,,,,,,,7,,,,,,,,,,,,,,,,,,,,,,,,,,,,,,,,,2,1.0,2.0,3.0,6.0,1.0,4.0,2.0,2.0,2.0,2.0,2.0,2.0,2.0,3.0,3.0,5.0,1.0,2.0,3.0,2.0,3.0,1.0,5.0,1.0,1.0,5.0,6.0,1.0,3.0,3.0,2.0,2.0,10,,,,,,,,,,,,,,,,,,,,,,,,,,,,,,,,,8,,,,,,,,,,,,,,,,,,,,,,,,,,,,,,,,,6,,,,,,,,,,,,,,,,,,,,,,,,,,,,,,,,,9,,,,,,,,,,,,,,,,,,,,,,,,,,,,,,,,,3,,,,,,,,,,,,,,,,,,,,,,,,,,,,,,,,,13,,,,,,,,,,,,,,,,,,,,,,,,,,,,,,,,,,752.26,165.25,,,,18.27,,59.17,,,,,,,,80.33,,,,,,282.0,,,,,,,,,,,,143.09,,,,,,,,,,,,,,,,,,,,,4.15,,APPROVED,Male,22.0,FALSE
463,2022-03-22 00:24:12,19,en,776535991,2022-03-22 00:19:41,2022-03-22 00:24:12,Y,Y,A1,,,11,,,,,,,,,,,,,,,,,,,,,,,,,,,,,,,,,0,5.0,5.0,5.0,5.0,4.0,5.0,4.0,4.0,5.0,4.0,5.0,5.0,5.0,5.0,4.0,5.0,6.0,5.0,5.0,5.0,4.0,5.0,6.0,5.0,4.0,6.0,2.0,5.0,6.0,5.0,5.0,2.0,5,,,,,,,,,,,,,,,,,,,,,,,,,,,,,,,,,13,,,,,,,,,,,,,,,,,,,,,,,,,,,,,,,,,12,,,,,,,,,,,,,,,,,,,,,,,,,,,,,,,,,10,,,,,,,,,,,,,,,,,,,,,,,,,,,,,,,,,6,,,,,,,,,,,,,,,,,,,,,,,,,,,,,,,,,1,1.0,1.0,2.0,1.0,2.0,2.0,7.0,1.0,2.0,1.0,2.0,2.0,3.0,1.0,2.0,1.0,2.0,2.0,2.0,2.0,1.0,2.0,1.0,2.0,2.0,2.0,2.0,2.0,1.0,2.0,2.0,1.0,9,,,,,,,,,,,,,,,,,,,,,,,,,,,,,,,,,7,,,,,,,,,,,,,,,,,,,,,,,,,,,,,,,,,14,,,,,,,,,,,,,,,,,,,,,,,,,,,,,,,,,8,,,,,,,,,,,,,,,,,,,,,,,,,,,,,,,,,3,,,,,,,,,,,,,,,,,,,,,,,,,,,,,,,,,2,1.0,5.0,2.0,2.0,1.0,2.0,5.0,2.0,3.0,2.0,2.0,2.0,1.0,2.0,1.0,2.0,2.0,2.0,1.0,2.0,1.0,2.0,2.0,2.0,2.0,3.0,5.0,2.0,1.0,1.0,2.0,7.0,4,,,,,,,,,,,,,,,,,,,,,,,,,,,,,,,,,,270.7,25.97,,,,10.89,,36.01,,,,,67.27,,,,,,,,,,,,,,,,,,62.78,,,,,,,,,,,,,,,,,,65.24,,,,,,2.54,,APPROVED,Female,45.0,FALSE
464,2022-03-22 00:34:22,19,en,1720531861,2022-03-22 00:19:41,2022-03-22 00:34:22,Y,Y,A1,,,10,,,,,,,,,,,,,,,,,,,,,,,,,,,,,,,,,1,5.0,3.0,6.0,6.0,5.0,6.0,2.0,7.0,4.0,5.0,5.0,4.0,5.0,3.0,4.0,7.0,4.0,5.0,5.0,4.0,4.0,5.0,7.0,4.0,6.0,6.0,2.0,5.0,5.0,5.0,5.0,2.0,0,7.0,7.0,7.0,5.0,5.0,3.0,6.0,7.0,7.0,5.0,5.0,4.0,5.0,6.0,6.0,5.0,7.0,3.0,6.0,4.0,5.0,5.0,3.0,7.0,6.0,4.0,4.0,4.0,4.0,5.0,4.0,3.0,2,5.0,7.0,5.0,4.0,4.0,2.0,4.0,5.0,7.0,6.0,3.0,4.0,6.0,7.0,7.0,4.0,7.0,4.0,6.0,4.0,5.0,6.0,3.0,6.0,4.0,4.0,5.0,5.0,4.0,5.0,5.0,4.0,8,,,,,,,,,,,,,,,,,,,,,,,,,,,,,,,,,6,,,,,,,,,,,,,,,,,,,,,,,,,,,,,,,,,3,,,,,,,,,,,,,,,,,,,,,,,,,,,,,,,,,14,,,,,,,,,,,,,,,,,,,,,,,,,,,,,,,,,11,,,,,,,,,,,,,,,,,,,,,,,,,,,,,,,,,7,,,,,,,,,,,,,,,,,,,,,,,,,,,,,,,,,9,,,,,,,,,,,,,,,,,,,,,,,,,,,,,,,,,5,,,,,,,,,,,,,,,,,,,,,,,,,,,,,,,,,13,,,,,,,,,,,,,,,,,,,,,,,,,,,,,,,,,12,,,,,,,,,,,,,,,,,,,,,,,,,,,,,,,,,4,,,,,,,,,,,,,,,,,,,,,,,,,,,,,,,,,,879.77,66.53,,,,28.95,,48.21,,,,,203.11,,,207.46,,,320.46,,,,,,,,,,,,,,,,,,,,,,,,,,,,,,,,,,,,5.05,,APPROVED,Female,25.0,FALSE
467,2022-03-22 00:25:51,19,en,2042544558,2022-03-22 00:19:44,2022-03-22 00:25:51,Y,Y,A2,,,0,5.0,5.0,5.0,5.0,4.0,3.0,4.0,4.0,5.0,4.0,3.0,3.0,4.0,3.0,4.0,3.0,3.0,3.0,4.0,4.0,4.0,3.0,3.0,3.0,4.0,3.0,5.0,4.0,4.0,3.0,3.0,1.0,9,,,,,,,,,,,,,,,,,,,,,,,,,,,,,,,,,10,,,,,,,,,,,,,,,,,,,,,,,,,,,,,,,,,3,,,,,,,,,,,,,,,,,,,,,,,,,,,,,,,,,7,,,,,,,,,,,,,,,,,,,,,,,,,,,,,,,,,12,,,,,,,,,,,,,,,,,,,,,,,,,,,,,,,,,13,,,,,,,,,,,,,,,,,,,,,,,,,,,,,,,,,11,,,,,,,,,,,,,,,,,,,,,,,,,,,,,,,,,8,,,,,,,,,,,,,,,,,,,,,,,,,,,,,,,,,1,2.0,4.0,1.0,3.0,2.0,5.0,6.0,3.0,4.0,1.0,2.0,2.0,2.0,1.0,4.0,4.0,4.0,2.0,4.0,1.0,4.0,2.0,1.0,1.0,4.0,6.0,4.0,4.0,2.0,4.0,3.0,3.0,4,,,,,,,,,,,,,,,,,,,,,,,,,,,,,,,,,5,,,,,,,,,,,,,,,,,,,,,,,,,,,,,,,,,14,,,,,,,,,,,,,,,,,,,,,,,,,,,,,,,,,6,,,,,,,,,,,,,,,,,,,,,,,,,,,,,,,,,2,4.0,7.0,5.0,2.0,5.0,4.0,4.0,6.0,6.0,5.0,5.0,2.0,5.0,6.0,4.0,5.0,5.0,5.0,6.0,6.0,5.0,4.0,2.0,5.0,5.0,2.0,5.0,5.0,5.0,4.0,4.0,1.0,,436.06,24.8,,,,21.93,,153.28,,90.15,,,,,,,,,,,,,,,,,,,,,,,,,,,80.31,,,,,,,,,,,,,,,62.67,,,2.92,,APPROVED,Male,38.0,FALSE
468,2022-03-22 00:30:36,19,en,1132471766,2022-03-22 00:19:48,2022-03-22 00:30:36,Y,Y,A1,,,12,,,,,,,,,,,,,,,,,,,,,,,,,,,,,,,,,11,,,,,,,,,,,,,,,,,,,,,,,,,,,,,,,,,3,,,,,,,,,,,,,,,,,,,,,,,,,,,,,,,,,7,,,,,,,,,,,,,,,,,,,,,,,,,,,,,,,,,5,,,,,,,,,,,,,,,,,,,,,,,,,,,,,,,,,1,4.0,4.0,5.0,5.0,4.0,2.0,3.0,5.0,6.0,3.0,2.0,5.0,1.0,3.0,3.0,4.0,4.0,4.0,5.0,4.0,5.0,4.0,5.0,5.0,4.0,2.0,4.0,3.0,3.0,4.0,1.0,6.0,0,1.0,1.0,1.0,4.0,1.0,1.0,7.0,6.0,2.0,1.0,1.0,3.0,3.0,2.0,2.0,5.0,2.0,1.0,2.0,1.0,2.0,1.0,4.0,1.0,1.0,2.0,4.0,2.0,1.0,2.0,1.0,7.0,8,,,,,,,,,,,,,,,,,,,,,,,,,,,,,,,,,4,,,,,,,,,,,,,,,,,,,,,,,,,,,,,,,,,6,,,,,,,,,,,,,,,,,,,,,,,,,,,,,,,,,14,,,,,,,,,,,,,,,,,,,,,,,,,,,,,,,,,2,1.0,1.0,1.0,6.0,1.0,5.0,3.0,6.0,1.0,2.0,1.0,1.0,1.0,2.0,1.0,2.0,2.0,1.0,1.0,1.0,1.0,1.0,4.0,1.0,1.0,1.0,2.0,1.0,1.0,1.0,1.0,5.0,10,,,,,,,,,,,,,,,,,,,,,,,,,,,,,,,,,13,,,,,,,,,,,,,,,,,,,,,,,,,,,,,,,,,9,,,,,,,,,,,,,,,,,,,,,,,,,,,,,,,,,,562.95,6.89,,,,18.35,,42.3,,,,,,,,,,,,,,,,,208.0,,,163.66,,,,,,,,,,,,,,,120.17,,,,,,,,,,,,3.58,,APPROVED,Female,26.0,FALSE
469,2022-03-22 00:28:38,19,en,633514262,2022-03-22 00:19:48,2022-03-22 00:28:38,Y,Y,A1,,,10,,,,,,,,,,,,,,,,,,,,,,,,,,,,,,,,,6,,,,,,,,,,,,,,,,,,,,,,,,,,,,,,,,,7,,,,,,,,,,,,,,,,,,,,,,,,,,,,,,,,,14,,,,,,,,,,,,,,,,,,,,,,,,,,,,,,,,,11,,,,,,,,,,,,,,,,,,,,,,,,,,,,,,,,,2,5.0,6.0,5.0,3.0,5.0,3.0,6.0,5.0,7.0,6.0,3.0,4.0,4.0,6.0,6.0,2.0,6.0,4.0,5.0,5.0,4.0,5.0,3.0,6.0,5.0,2.0,2.0,4.0,3.0,5.0,3.0,6.0,3,,,,,,,,,,,,,,,,,,,,,,,,,,,,,,,,,0,3.0,6.0,6.0,4.0,4.0,3.0,6.0,4.0,6.0,5.0,5.0,5.0,3.0,5.0,6.0,3.0,5.0,4.0,5.0,4.0,3.0,5.0,2.0,4.0,5.0,3.0,4.0,4.0,6.0,4.0,4.0,7.0,1,4.0,3.0,4.0,5.0,4.0,6.0,3.0,5.0,4.0,4.0,5.0,3.0,2.0,3.0,3.0,5.0,2.0,2.0,5.0,3.0,3.0,4.0,6.0,2.0,2.0,6.0,4.0,4.0,6.0,3.0,6.0,2.0,8,,,,,,,,,,,,,,,,,,,,,,,,,,,,,,,,,4,,,,,,,,,,,,,,,,,,,,,,,,,,,,,,,,,9,,,,,,,,,,,,,,,,,,,,,,,,,,,,,,,,,5,,,,,,,,,,,,,,,,,,,,,,,,,,,,,,,,,13,,,,,,,,,,,,,,,,,,,,,,,,,,,,,,,,,12,,,,,,,,,,,,,,,,,,,,,,,,,,,,,,,,,,396.44,12.06,,,,7.16,,56.85,,,,,,,,,,,,,,,,,95.48,,,,,,99.02,,,121.9,,,,,,,,,,,,,,,,,,,,,3.97,,APPROVED,Male,23.0,FALSE
471,2022-03-22 00:30:18,19,en,60943931,2022-03-22 00:19:48,2022-03-22 00:30:18,Y,Y,-oth-,High school diploma,,8,,,,,,,,,,,,,,,,,,,,,,,,,,,,,,,,,7,,,,,,,,,,,,,,,,,,,,,,,,,,,,,,,,,1,5.0,6.0,6.0,7.0,7.0,6.0,2.0,7.0,6.0,6.0,5.0,6.0,6.0,6.0,6.0,7.0,7.0,6.0,6.0,6.0,6.0,6.0,5.0,7.0,7.0,5.0,3.0,7.0,5.0,6.0,6.0,3.0,0,1.0,5.0,1.0,2.0,1.0,1.0,7.0,3.0,5.0,1.0,1.0,3.0,2.0,2.0,3.0,1.0,3.0,1.0,2.0,1.0,2.0,1.0,2.0,2.0,1.0,3.0,6.0,1.0,2.0,1.0,4.0,4.0,6,,,,,,,,,,,,,,,,,,,,,,,,,,,,,,,,,11,,,,,,,,,,,,,,,,,,,,,,,,,,,,,,,,,14,,,,,,,,,,,,,,,,,,,,,,,,,,,,,,,,,4,,,,,,,,,,,,,,,,,,,,,,,,,,,,,,,,,12,,,,,,,,,,,,,,,,,,,,,,,,,,,,,,,,,13,,,,,,,,,,,,,,,,,,,,,,,,,,,,,,,,,3,,,,,,,,,,,,,,,,,,,,,,,,,,,,,,,,,2,1.0,3.0,1.0,1.0,2.0,2.0,3.0,2.0,4.0,1.0,1.0,2.0,1.0,3.0,5.0,2.0,5.0,1.0,2.0,1.0,1.0,2.0,1.0,1.0,1.0,2.0,6.0,1.0,1.0,1.0,1.0,5.0,10,,,,,,,,,,,,,,,,,,,,,,,,,,,,,,,,,5,,,,,,,,,,,,,,,,,,,,,,,,,,,,,,,,,9,,,,,,,,,,,,,,,,,,,,,,,,,,,,,,,,,,630.83,90.55,,,,63.25,,60.88,,,,,,,,116.24,,,135.49,,,,,,,,,,,,,,,,,,,,,,,,160.35,,,,,,,,,,,,4.07,,APPROVED,Female,31.0,FALSE
474,2022-03-22 00:25:25,19,en,1028605244,2022-03-22 00:19:50,2022-03-22 00:25:25,Y,Y,A1,,,4,,,,,,,,,,,,,,,,,,,,,,,,,,,,,,,,,11,,,,,,,,,,,,,,,,,,,,,,,,,,,,,,,,,7,,,,,,,,,,,,,,,,,,,,,,,,,,,,,,,,,5,,,,,,,,,,,,,,,,,,,,,,,,,,,,,,,,,1,6.0,4.0,6.0,5.0,5.0,6.0,6.0,6.0,4.0,5.0,6.0,5.0,6.0,6.0,5.0,5.0,6.0,5.0,5.0,5.0,5.0,5.0,6.0,5.0,6.0,5.0,5.0,6.0,6.0,5.0,5.0,5.0,12,,,,,,,,,,,,,,,,,,,,,,,,,,,,,,,,,0,3.0,5.0,5.0,3.0,5.0,3.0,7.0,6.0,6.0,4.0,3.0,5.0,5.0,6.0,6.0,5.0,6.0,3.0,4.0,4.0,4.0,5.0,4.0,5.0,5.0,3.0,5.0,5.0,4.0,2.0,4.0,7.0,8,,,,,,,,,,,,,,,,,,,,,,,,,,,,,,,,,6,,,,,,,,,,,,,,,,,,,,,,,,,,,,,,,,,2,6.0,3.0,6.0,6.0,6.0,6.0,2.0,7.0,4.0,6.0,7.0,6.0,6.0,6.0,5.0,7.0,6.0,7.0,6.0,6.0,6.0,6.0,7.0,7.0,6.0,6.0,2.0,7.0,6.0,7.0,7.0,3.0,14,,,,,,,,,,,,,,,,,,,,,,,,,,,,,,,,,10,,,,,,,,,,,,,,,,,,,,,,,,,,,,,,,,,3,,,,,,,,,,,,,,,,,,,,,,,,,,,,,,,,,13,,,,,,,,,,,,,,,,,,,,,,,,,,,,,,,,,9,,,,,,,,,,,,,,,,,,,,,,,,,,,,,,,,,,333.67,58.65,,,,14.77,,45.26,,,,,,,,,,,,,,67.28,,,,,,74.46,,,,,,,,,69.89,,,,,,,,,,,,,,,,,,3.36,,APPROVED,Male,22.0,FALSE
475,2022-03-22 00:24:34,19,en,1341180639,2022-03-22 00:19:50,2022-03-22 00:24:34,Y,Y,A1,,,8,,,,,,,,,,,,,,,,,,,,,,,,,,,,,,,,,0,5.0,3.0,5.0,5.0,4.0,5.0,3.0,5.0,3.0,5.0,4.0,5.0,5.0,5.0,5.0,4.0,5.0,5.0,5.0,5.0,5.0,5.0,5.0,5.0,5.0,5.0,3.0,5.0,5.0,5.0,5.0,2.0,10,,,,,,,,,,,,,,,,,,,,,,,,,,,,,,,,,4,,,,,,,,,,,,,,,,,,,,,,,,,,,,,,,,,3,,,,,,,,,,,,,,,,,,,,,,,,,,,,,,,,,13,,,,,,,,,,,,,,,,,,,,,,,,,,,,,,,,,1,6.0,6.0,6.0,6.0,6.0,6.0,5.0,6.0,6.0,6.0,6.0,6.0,6.0,6.0,6.0,6.0,6.0,6.0,6.0,6.0,6.0,6.0,6.0,6.0,6.0,6.0,6.0,6.0,6.0,6.0,6.0,5.0,7,,,,,,,,,,,,,,,,,,,,,,,,,,,,,,,,,11,,,,,,,,,,,,,,,,,,,,,,,,,,,,,,,,,5,,,,,,,,,,,,,,,,,,,,,,,,,,,,,,,,,2,2.0,2.0,2.0,2.0,2.0,2.0,2.0,2.0,2.0,2.0,2.0,2.0,2.0,2.0,2.0,2.0,2.0,2.0,2.0,2.0,2.0,2.0,2.0,2.0,2.0,2.0,2.0,2.0,2.0,2.0,2.0,4.0,12,,,,,,,,,,,,,,,,,,,,,,,,,,,,,,,,,14,,,,,,,,,,,,,,,,,,,,,,,,,,,,,,,,,9,,,,,,,,,,,,,,,,,,,,,,,,,,,,,,,,,6,,,,,,,,,,,,,,,,,,,,,,,,,,,,,,,,,,283.15,47.18,,,,14.51,,58.24,,,,,46.67,,,,,,,,,,,,,,,50.5,,,,,,,,,,,,63.07,,,,,,,,,,,,,,,2.98,,APPROVED,Female,23.0,FALSE
476,2022-03-22 00:29:54,19,en,1112056077,2022-03-22 00:19:50,2022-03-22 00:29:54,Y,Y,A1,,,8,,,,,,,,,,,,,,,,,,,,,,,,,,,,,,,,,10,,,,,,,,,,,,,,,,,,,,,,,,,,,,,,,,,4,,,,,,,,,,,,,,,,,,,,,,,,,,,,,,,,,9,,,,,,,,,,,,,,,,,,,,,,,,,,,,,,,,,7,,,,,,,,,,,,,,,,,,,,,,,,,,,,,,,,,3,,,,,,,,,,,,,,,,,,,,,,,,,,,,,,,,,1,3.0,3.0,3.0,4.0,3.0,3.0,2.0,3.0,6.0,3.0,3.0,5.0,3.0,4.0,4.0,3.0,3.0,3.0,2.0,4.0,2.0,4.0,5.0,4.0,3.0,5.0,3.0,3.0,3.0,3.0,3.0,7.0,14,,,,,,,,,,,,,,,,,,,,,,,,,,,,,,,,,11,,,,,,,,,,,,,,,,,,,,,,,,,,,,,,,,,0,1.0,1.0,1.0,3.0,1.0,1.0,7.0,1.0,1.0,1.0,1.0,1.0,2.0,1.0,1.0,1.0,1.0,1.0,1.0,1.0,1.0,1.0,1.0,1.0,1.0,1.0,1.0,1.0,1.0,1.0,1.0,3.0,5,,,,,,,,,,,,,,,,,,,,,,,,,,,,,,,,,13,,,,,,,,,,,,,,,,,,,,,,,,,,,,,,,,,2,4.0,1.0,5.0,5.0,1.0,4.0,4.0,3.0,1.0,5.0,4.0,5.0,4.0,3.0,4.0,5.0,6.0,4.0,4.0,2.0,5.0,2.0,6.0,4.0,2.0,6.0,2.0,1.0,6.0,4.0,5.0,6.0,12,,,,,,,,,,,,,,,,,,,,,,,,,,,,,,,,,6,,,,,,,,,,,,,,,,,,,,,,,,,,,,,,,,,,367.83,14.64,,,,10.38,,85.27,,,,,,,,,,,,,,,,,,,,140.35,,,,,,,,,52.61,,,,,,,,,60.18,,,,,,,,,4.4,,APPROVED,Male,23.0,FALSE
477,2022-03-22 00:29:32,19,en,2067696670,2022-03-22 00:19:53,2022-03-22 00:29:32,Y,Y,A1,,,9,,,,,,,,,,,,,,,,,,,,,,,,,,,,,,,,,14,,,,,,,,,,,,,,,,,,,,,,,,,,,,,,,,,3,,,,,,,,,,,,,,,,,,,,,,,,,,,,,,,,,7,,,,,,,,,,,,,,,,,,,,,,,,,,,,,,,,,10,,,,,,,,,,,,,,,,,,,,,,,,,,,,,,,,,1,7.0,7.0,7.0,5.0,6.0,3.0,6.0,7.0,7.0,5.0,5.0,6.0,5.0,5.0,6.0,5.0,6.0,6.0,6.0,6.0,5.0,6.0,5.0,5.0,6.0,4.0,5.0,5.0,3.0,5.0,5.0,6.0,2,3.0,5.0,3.0,5.0,3.0,2.0,6.0,6.0,5.0,2.0,3.0,2.0,2.0,2.0,5.0,5.0,4.0,2.0,3.0,1.0,2.0,3.0,2.0,3.0,3.0,3.0,2.0,2.0,3.0,3.0,3.0,7.0,0,2.0,1.0,1.0,2.0,2.0,2.0,6.0,2.0,1.0,1.0,1.0,2.0,2.0,1.0,1.0,2.0,2.0,2.0,2.0,1.0,1.0,2.0,4.0,2.0,2.0,1.0,4.0,2.0,2.0,2.0,3.0,1.0,6,,,,,,,,,,,,,,,,,,,,,,,,,,,,,,,,,11,,,,,,,,,,,,,,,,,,,,,,,,,,,,,,,,,5,,,,,,,,,,,,,,,,,,,,,,,,,,,,,,,,,4,,,,,,,,,,,,,,,,,,,,,,,,,,,,,,,,,12,,,,,,,,,,,,,,,,,,,,,,,,,,,,,,,,,8,,,,,,,,,,,,,,,,,,,,,,,,,,,,,,,,,13,,,,,,,,,,,,,,,,,,,,,,,,,,,,,,,,,,462.65,56.88,,,,7.69,,51.86,,,,,,,,,,,,,,,,,131.56,,,89.51,,,121.52,,,,,,,,,,,,,,,,,,,,,,,,3.63,,APPROVED,Female,23.0,FALSE
478,2022-03-22 00:27:16,19,en,893979061,2022-03-22 00:19:55,2022-03-22 00:27:16,Y,Y,A1,,,12,,,,,,,,,,,,,,,,,,,,,,,,,,,,,,,,,11,,,,,,,,,,,,,,,,,,,,,,,,,,,,,,,,,8,,,,,,,,,,,,,,,,,,,,,,,,,,,,,,,,,6,,,,,,,,,,,,,,,,,,,,,,,,,,,,,,,,,10,,,,,,,,,,,,,,,,,,,,,,,,,,,,,,,,,4,,,,,,,,,,,,,,,,,,,,,,,,,,,,,,,,,7,,,,,,,,,,,,,,,,,,,,,,,,,,,,,,,,,9,,,,,,,,,,,,,,,,,,,,,,,,,,,,,,,,,14,,,,,,,,,,,,,,,,,,,,,,,,,,,,,,,,,0,6.0,6.0,5.0,6.0,6.0,4.0,4.0,7.0,6.0,6.0,7.0,6.0,7.0,6.0,7.0,6.0,5.0,5.0,6.0,7.0,7.0,7.0,6.0,7.0,6.0,6.0,6.0,7.0,3.0,5.0,5.0,3.0,5,,,,,,,,,,,,,,,,,,,,,,,,,,,,,,,,,2,6.0,6.0,7.0,7.0,6.0,7.0,4.0,7.0,5.0,6.0,6.0,6.0,7.0,6.0,6.0,6.0,6.0,6.0,7.0,6.0,5.0,5.0,7.0,6.0,7.0,7.0,6.0,7.0,5.0,5.0,7.0,5.0,3,,,,,,,,,,,,,,,,,,,,,,,,,,,,,,,,,13,,,,,,,,,,,,,,,,,,,,,,,,,,,,,,,,,1,4.0,3.0,4.0,4.0,2.0,2.0,4.0,3.0,6.0,4.0,2.0,3.0,3.0,3.0,2.0,6.0,5.0,3.0,4.0,1.0,3.0,4.0,6.0,3.0,3.0,7.0,2.0,3.0,2.0,3.0,6.0,1.0,,328.56,31.7,,,,4.58,,35.57,,,,,,,,,,,,,,,,,,,,,,,,,,,,,79.46,,,,,,89.95,,,,,,,,,84.34,,,2.96,,APPROVED,Male,20.0,FALSE
479,2022-03-22 00:25:57,19,en,2057581965,2022-03-22 00:19:55,2022-03-22 00:25:57,Y,Y,-oth-,High school equivalent,,0,3.0,5.0,4.0,2.0,3.0,1.0,7.0,5.0,4.0,3.0,5.0,1.0,3.0,3.0,5.0,2.0,3.0,2.0,2.0,3.0,3.0,3.0,1.0,3.0,3.0,1.0,6.0,3.0,5.0,3.0,1.0,1.0,11,,,,,,,,,,,,,,,,,,,,,,,,,,,,,,,,,13,,,,,,,,,,,,,,,,,,,,,,,,,,,,,,,,,4,,,,,,,,,,,,,,,,,,,,,,,,,,,,,,,,,7,,,,,,,,,,,,,,,,,,,,,,,,,,,,,,,,,3,,,,,,,,,,,,,,,,,,,,,,,,,,,,,,,,,1,5.0,6.0,4.0,6.0,5.0,5.0,2.0,7.0,5.0,5.0,3.0,6.0,5.0,5.0,5.0,7.0,6.0,6.0,5.0,5.0,4.0,5.0,5.0,5.0,5.0,3.0,1.0,6.0,3.0,4.0,6.0,7.0,6,,,,,,,,,,,,,,,,,,,,,,,,,,,,,,,,,8,,,,,,,,,,,,,,,,,,,,,,,,,,,,,,,,,2,3.0,1.0,3.0,3.0,1.0,1.0,6.0,7.0,3.0,2.0,3.0,2.0,3.0,2.0,5.0,2.0,6.0,2.0,3.0,3.0,1.0,3.0,3.0,1.0,3.0,5.0,1.0,2.0,3.0,2.0,2.0,3.0,10,,,,,,,,,,,,,,,,,,,,,,,,,,,,,,,,,9,,,,,,,,,,,,,,,,,,,,,,,,,,,,,,,,,12,,,,,,,,,,,,,,,,,,,,,,,,,,,,,,,,,5,,,,,,,,,,,,,,,,,,,,,,,,,,,,,,,,,14,,,,,,,,,,,,,,,,,,,,,,,,,,,,,,,,,,255.89,15.33,,,,13.0,,20.55,,65.32,,,,,,,,,,,,,,,,,,70.08,,,,,,,,,66.99,,,,,,,,,,,,,,,,,,4.62,,APPROVED,Female,23.0,FALSE
480,2022-03-22 00:26:22,19,en,1690383408,2022-03-22 00:19:56,2022-03-22 00:26:22,Y,Y,A1,,,6,,,,,,,,,,,,,,,,,,,,,,,,,,,,,,,,,12,,,,,,,,,,,,,,,,,,,,,,,,,,,,,,,,,5,,,,,,,,,,,,,,,,,,,,,,,,,,,,,,,,,7,,,,,,,,,,,,,,,,,,,,,,,,,,,,,,,,,13,,,,,,,,,,,,,,,,,,,,,,,,,,,,,,,,,8,,,,,,,,,,,,,,,,,,,,,,,,,,,,,,,,,2,4.0,5.0,4.0,4.0,4.0,4.0,4.0,6.0,4.0,4.0,3.0,5.0,4.0,4.0,5.0,7.0,5.0,3.0,4.0,4.0,4.0,4.0,6.0,3.0,3.0,3.0,5.0,3.0,4.0,3.0,4.0,7.0,4,,,,,,,,,,,,,,,,,,,,,,,,,,,,,,,,,9,,,,,,,,,,,,,,,,,,,,,,,,,,,,,,,,,3,,,,,,,,,,,,,,,,,,,,,,,,,,,,,,,,,11,,,,,,,,,,,,,,,,,,,,,,,,,,,,,,,,,1,5.0,6.0,6.0,5.0,6.0,6.0,2.0,5.0,7.0,6.0,6.0,6.0,6.0,5.0,6.0,6.0,6.0,6.0,6.0,5.0,6.0,5.0,6.0,6.0,6.0,5.0,6.0,7.0,5.0,6.0,6.0,5.0,0,1.0,6.0,2.0,2.0,2.0,1.0,7.0,1.0,5.0,2.0,2.0,4.0,2.0,5.0,5.0,2.0,5.0,1.0,2.0,2.0,1.0,3.0,1.0,3.0,2.0,2.0,3.0,2.0,1.0,2.0,1.0,6.0,10,,,,,,,,,,,,,,,,,,,,,,,,,,,,,,,,,14,,,,,,,,,,,,,,,,,,,,,,,,,,,,,,,,,,382.91,61.49,,,,20.15,,28.45,,,,,,,,,,,,,,,,,,,,99.35,,,,,,,,,,,,,,,105.62,,,65.48,,,,,,,,,2.37,,APPROVED,Female,30.0,FALSE
481,2022-03-22 00:25:41,19,en,1868885785,2022-03-22 00:19:56,2022-03-22 00:25:40,Y,Y,A1,,,10,,,,,,,,,,,,,,,,,,,,,,,,,,,,,,,,,3,,,,,,,,,,,,,,,,,,,,,,,,,,,,,,,,,5,,,,,,,,,,,,,,,,,,,,,,,,,,,,,,,,,13,,,,,,,,,,,,,,,,,,,,,,,,,,,,,,,,,0,2.0,1.0,2.0,2.0,2.0,2.0,2.0,1.0,2.0,2.0,2.0,2.0,1.0,2.0,2.0,2.0,2.0,2.0,2.0,2.0,1.0,2.0,1.0,2.0,2.0,3.0,1.0,2.0,2.0,2.0,1.0,5.0,8,,,,,,,,,,,,,,,,,,,,,,,,,,,,,,,,,6,,,,,,,,,,,,,,,,,,,,,,,,,,,,,,,,,14,,,,,,,,,,,,,,,,,,,,,,,,,,,,,,,,,12,,,,,,,,,,,,,,,,,,,,,,,,,,,,,,,,,4,,,,,,,,,,,,,,,,,,,,,,,,,,,,,,,,,1,4.0,7.0,6.0,6.0,6.0,6.0,4.0,6.0,6.0,6.0,6.0,6.0,6.0,6.0,6.0,5.0,6.0,5.0,6.0,5.0,6.0,6.0,6.0,5.0,4.0,6.0,5.0,5.0,6.0,5.0,6.0,4.0,9,,,,,,,,,,,,,,,,,,,,,,,,,,,,,,,,,2,4.0,3.0,4.0,4.0,2.0,4.0,3.0,3.0,3.0,3.0,3.0,3.0,4.0,3.0,3.0,3.0,4.0,3.0,4.0,2.0,3.0,4.0,4.0,3.0,3.0,4.0,3.0,4.0,3.0,3.0,4.0,6.0,11,,,,,,,,,,,,,,,,,,,,,,,,,,,,,,,,,7,,,,,,,,,,,,,,,,,,,,,,,,,,,,,,,,,,280.56,18.68,,,,16.19,,72.35,,,,,,,,,,,,,,63.14,,,,,,,,,,,,,,,,,,54.32,,,,,,50.87,,,,,,,,,5.01,,APPROVED,Female,44.0,FALSE
483,2022-03-22 00:27:34,19,en,2067964094,2022-03-22 00:20:22,2022-03-22 00:27:34,Y,Y,A1,,,4,,,,,,,,,,,,,,,,,,,,,,,,,,,,,,,,,5,,,,,,,,,,,,,,,,,,,,,,,,,,,,,,,,,8,,,,,,,,,,,,,,,,,,,,,,,,,,,,,,,,,9,,,,,,,,,,,,,,,,,,,,,,,,,,,,,,,,,6,,,,,,,,,,,,,,,,,,,,,,,,,,,,,,,,,2,5.0,5.0,4.0,4.0,4.0,2.0,5.0,3.0,5.0,3.0,3.0,3.0,5.0,3.0,4.0,3.0,4.0,3.0,3.0,4.0,3.0,5.0,2.0,4.0,4.0,5.0,2.0,4.0,5.0,5.0,4.0,6.0,12,,,,,,,,,,,,,,,,,,,,,,,,,,,,,,,,,0,7.0,7.0,6.0,5.0,6.0,5.0,3.0,7.0,7.0,6.0,5.0,7.0,6.0,6.0,5.0,5.0,7.0,6.0,6.0,5.0,4.0,6.0,5.0,6.0,6.0,5.0,2.0,7.0,6.0,6.0,6.0,1.0,14,,,,,,,,,,,,,,,,,,,,,,,,,,,,,,,,,3,,,,,,,,,,,,,,,,,,,,,,,,,,,,,,,,,7,,,,,,,,,,,,,,,,,,,,,,,,,,,,,,,,,1,3.0,3.0,3.0,4.0,2.0,3.0,5.0,6.0,3.0,3.0,2.0,4.0,2.0,3.0,4.0,3.0,5.0,3.0,3.0,3.0,3.0,3.0,4.0,3.0,2.0,5.0,3.0,3.0,4.0,4.0,3.0,5.0,11,,,,,,,,,,,,,,,,,,,,,,,,,,,,,,,,,10,,,,,,,,,,,,,,,,,,,,,,,,,,,,,,,,,13,,,,,,,,,,,,,,,,,,,,,,,,,,,,,,,,,,480.26,105.04,,,,16.31,,40.33,,,,,,,,,,,,,,,,,111.48,,,,,,115.3,,,,,,,,,,,,88.32,,,,,,,,,,,,3.48,,APPROVED,Male,28.0,FALSE
484,2022-03-22 00:31:21,19,en,144648872,2022-03-22 00:20:34,2022-03-22 00:31:21,Y,Y,-oth-,High School,,2,6.0,6.0,6.0,6.0,6.0,6.0,4.0,6.0,6.0,6.0,6.0,6.0,6.0,6.0,6.0,6.0,6.0,6.0,6.0,6.0,6.0,6.0,6.0,6.0,6.0,6.0,3.0,6.0,6.0,6.0,6.0,1.0,3,,,,,,,,,,,,,,,,,,,,,,,,,,,,,,,,,14,,,,,,,,,,,,,,,,,,,,,,,,,,,,,,,,,9,,,,,,,,,,,,,,,,,,,,,,,,,,,,,,,,,1,3.0,5.0,3.0,4.0,3.0,3.0,3.0,3.0,4.0,3.0,4.0,4.0,3.0,4.0,3.0,3.0,4.0,4.0,4.0,4.0,4.0,3.0,4.0,4.0,4.0,5.0,3.0,4.0,4.0,4.0,5.0,3.0,12,,,,,,,,,,,,,,,,,,,,,,,,,,,,,,,,,8,,,,,,,,,,,,,,,,,,,,,,,,,,,,,,,,,0,5.0,5.0,5.0,5.0,5.0,6.0,5.0,5.0,5.0,5.0,5.0,5.0,5.0,5.0,5.0,5.0,5.0,5.0,5.0,5.0,5.0,5.0,6.0,5.0,5.0,5.0,3.0,5.0,5.0,5.0,5.0,1.0,7,,,,,,,,,,,,,,,,,,,,,,,,,,,,,,,,,5,,,,,,,,,,,,,,,,,,,,,,,,,,,,,,,,,13,,,,,,,,,,,,,,,,,,,,,,,,,,,,,,,,,6,,,,,,,,,,,,,,,,,,,,,,,,,,,,,,,,,11,,,,,,,,,,,,,,,,,,,,,,,,,,,,,,,,,10,,,,,,,,,,,,,,,,,,,,,,,,,,,,,,,,,4,,,,,,,,,,,,,,,,,,,,,,,,,,,,,,,,,,650.75,206.55,,,,115.83,,60.77,,63.19,,,,,,,,,,,,92.67,,,,,,,,,107.97,,,,,,,,,,,,,,,,,,,,,,,,3.77,,APPROVED,Female,32.0,FALSE
486,2022-03-22 00:48:20,19,en,1689940864,2022-03-22 00:21:04,2022-03-22 00:48:20,Y,Y,A1,,,7,,,,,,,,,,,,,,,,,,,,,,,,,,,,,,,,,3,,,,,,,,,,,,,,,,,,,,,,,,,,,,,,,,,14,,,,,,,,,,,,,,,,,,,,,,,,,,,,,,,,,9,,,,,,,,,,,,,,,,,,,,,,,,,,,,,,,,,10,,,,,,,,,,,,,,,,,,,,,,,,,,,,,,,,,13,,,,,,,,,,,,,,,,,,,,,,,,,,,,,,,,,0,6.0,6.0,7.0,6.0,6.0,6.0,1.0,5.0,7.0,5.0,6.0,6.0,7.0,6.0,6.0,5.0,6.0,5.0,6.0,6.0,5.0,6.0,6.0,6.0,7.0,6.0,3.0,7.0,7.0,6.0,7.0,7.0,6,,,,,,,,,,,,,,,,,,,,,,,,,,,,,,,,,8,,,,,,,,,,,,,,,,,,,,,,,,,,,,,,,,,5,,,,,,,,,,,,,,,,,,,,,,,,,,,,,,,,,4,,,,,,,,,,,,,,,,,,,,,,,,,,,,,,,,,12,,,,,,,,,,,,,,,,,,,,,,,,,,,,,,,,,2,4.0,5.0,4.0,4.0,3.0,5.0,6.0,4.0,7.0,4.0,3.0,4.0,5.0,4.0,5.0,3.0,6.0,5.0,5.0,4.0,5.0,5.0,5.0,4.0,5.0,5.0,4.0,5.0,6.0,5.0,5.0,6.0,11,,,,,,,,,,,,,,,,,,,,,,,,,,,,,,,,,1,6.0,7.0,6.0,6.0,7.0,6.0,1.0,6.0,7.0,6.0,7.0,6.0,6.0,6.0,6.0,6.0,7.0,6.0,6.0,5.0,6.0,7.0,6.0,6.0,6.0,7.0,6.0,7.0,7.0,6.0,7.0,1.0,"Thank you, very interesting.",1637.76,270.34,,,,7.16,,1092.13,,,,,,,,,,,,,,,,,,,,135.23,,,,,,,,,,,,,,,,,,62.65,,,,,,57.47,,,12.78,,APPROVED,Male,34.0,FALSE
487,2022-03-22 00:26:40,19,en,1984381994,2022-03-22 00:21:07,2022-03-22 00:26:40,Y,Y,A1,,,2,3.0,5.0,3.0,1.0,2.0,1.0,3.0,1.0,5.0,2.0,1.0,2.0,2.0,1.0,5.0,2.0,1.0,1.0,2.0,2.0,2.0,1.0,1.0,1.0,1.0,1.0,6.0,1.0,1.0,2.0,1.0,1.0,13,,,,,,,,,,,,,,,,,,,,,,,,,,,,,,,,,1,3.0,1.0,4.0,6.0,5.0,6.0,4.0,6.0,4.0,4.0,4.0,5.0,3.0,3.0,2.0,6.0,5.0,4.0,5.0,2.0,4.0,5.0,3.0,5.0,5.0,2.0,7.0,5.0,2.0,5.0,2.0,3.0,12,,,,,,,,,,,,,,,,,,,,,,,,,,,,,,,,,9,,,,,,,,,,,,,,,,,,,,,,,,,,,,,,,,,5,,,,,,,,,,,,,,,,,,,,,,,,,,,,,,,,,3,,,,,,,,,,,,,,,,,,,,,,,,,,,,,,,,,10,,,,,,,,,,,,,,,,,,,,,,,,,,,,,,,,,7,,,,,,,,,,,,,,,,,,,,,,,,,,,,,,,,,4,,,,,,,,,,,,,,,,,,,,,,,,,,,,,,,,,8,,,,,,,,,,,,,,,,,,,,,,,,,,,,,,,,,1,7.0,7.0,7.0,3.0,7.0,5.0,4.0,7.0,7.0,6.0,2.0,7.0,7.0,2.0,7.0,5.0,7.0,6.0,7.0,6.0,6.0,7.0,1.0,7.0,7.0,3.0,5.0,7.0,7.0,7.0,7.0,5.0,14,,,,,,,,,,,,,,,,,,,,,,,,,,,,,,,,,11,,,,,,,,,,,,,,,,,,,,,,,,,,,,,,,,,6,,,,,,,,,,,,,,,,,,,,,,,,,,,,,,,,,,311.64,24.51,,,,11.51,,16.81,,61.43,,,,,,98.09,,,,,,,,,,,,,,,,,,,,,,,,,,,96.44,,,,,,,,,,,,2.85,,APPROVED,Female,23.0,FALSE
488,2022-03-22 00:29:34,19,en,490062045,2022-03-22 00:21:17,2022-03-22 00:29:34,Y,Y,A2,,,2,6.0,6.0,5.0,2.0,6.0,5.0,5.0,5.0,5.0,6.0,6.0,6.0,6.0,6.0,6.0,5.0,6.0,5.0,5.0,6.0,6.0,6.0,6.0,6.0,5.0,6.0,5.0,5.0,5.0,6.0,6.0,1.0,7,,,,,,,,,,,,,,,,,,,,,,,,,,,,,,,,,14,,,,,,,,,,,,,,,,,,,,,,,,,,,,,,,,,10,,,,,,,,,,,,,,,,,,,,,,,,,,,,,,,,,3,,,,,,,,,,,,,,,,,,,,,,,,,,,,,,,,,12,,,,,,,,,,,,,,,,,,,,,,,,,,,,,,,,,6,,,,,,,,,,,,,,,,,,,,,,,,,,,,,,,,,1,3.0,5.0,4.0,4.0,3.0,5.0,2.0,3.0,3.0,3.0,2.0,3.0,3.0,2.0,2.0,2.0,5.0,3.0,3.0,2.0,2.0,5.0,3.0,3.0,3.0,3.0,2.0,2.0,5.0,2.0,4.0,1.0,8,,,,,,,,,,,,,,,,,,,,,,,,,,,,,,,,,5,,,,,,,,,,,,,,,,,,,,,,,,,,,,,,,,,0,3.0,5.0,3.0,4.0,4.0,4.0,5.0,6.0,5.0,5.0,5.0,3.0,5.0,3.0,4.0,3.0,5.0,5.0,3.0,4.0,3.0,3.0,5.0,3.0,3.0,2.0,5.0,5.0,5.0,4.0,3.0,4.0,9,,,,,,,,,,,,,,,,,,,,,,,,,,,,,,,,,11,,,,,,,,,,,,,,,,,,,,,,,,,,,,,,,,,13,,,,,,,,,,,,,,,,,,,,,,,,,,,,,,,,,4,,,,,,,,,,,,,,,,,,,,,,,,,,,,,,,,,,499.84,72.54,,,,8.27,,23.38,,84.88,,,,,,,,,,,,,,,,,,,,,115.84,,,,,,,,,188.81,,,,,,,,,,,,,,,6.12,,APPROVED,Male,35.0,FALSE
490,2022-03-22 00:25:33,19,en,1765847538,2022-03-22 00:21:21,2022-03-22 00:25:33,Y,Y,A2,,,9,,,,,,,,,,,,,,,,,,,,,,,,,,,,,,,,,4,,,,,,,,,,,,,,,,,,,,,,,,,,,,,,,,,2,4.0,6.0,5.0,5.0,6.0,3.0,6.0,3.0,5.0,3.0,5.0,6.0,5.0,5.0,4.0,7.0,4.0,5.0,5.0,5.0,4.0,5.0,5.0,5.0,6.0,5.0,6.0,5.0,4.0,4.0,5.0,3.0,8,,,,,,,,,,,,,,,,,,,,,,,,,,,,,,,,,7,,,,,,,,,,,,,,,,,,,,,,,,,,,,,,,,,11,,,,,,,,,,,,,,,,,,,,,,,,,,,,,,,,,13,,,,,,,,,,,,,,,,,,,,,,,,,,,,,,,,,14,,,,,,,,,,,,,,,,,,,,,,,,,,,,,,,,,5,,,,,,,,,,,,,,,,,,,,,,,,,,,,,,,,,1,3.0,4.0,4.0,5.0,4.0,3.0,3.0,5.0,4.0,4.0,4.0,3.0,5.0,4.0,5.0,3.0,5.0,3.0,4.0,5.0,4.0,3.0,3.0,4.0,4.0,4.0,4.0,4.0,5.0,3.0,3.0,3.0,10,,,,,,,,,,,,,,,,,,,,,,,,,,,,,,,,,6,,,,,,,,,,,,,,,,,,,,,,,,,,,,,,,,,12,,,,,,,,,,,,,,,,,,,,,,,,,,,,,,,,,0,4.0,4.0,4.0,5.0,5.0,5.0,5.0,3.0,5.0,5.0,4.0,4.0,5.0,5.0,4.0,4.0,5.0,4.0,6.0,4.0,3.0,4.0,6.0,5.0,4.0,5.0,5.0,3.0,5.0,4.0,4.0,7.0,3,,,,,,,,,,,,,,,,,,,,,,,,,,,,,,,,,,255.43,44.09,,,,11.62,,9.76,,,,,,,,44.21,,,,,,,,,,,,,,,,,,,,,48.47,,,,,,,,,,,,93.88,,,,,,3.4,,APPROVED,Male,28.0,FALSE
491,2022-03-22 00:26:46,19,en,1572225233,2022-03-22 00:21:23,2022-03-22 00:26:46,Y,Y,A3,,,1,7.0,6.0,7.0,7.0,7.0,7.0,5.0,6.0,5.0,5.0,7.0,7.0,3.0,6.0,3.0,7.0,6.0,6.0,7.0,7.0,7.0,7.0,1.0,4.0,7.0,5.0,4.0,3.0,5.0,2.0,6.0,1.0,5,,,,,,,,,,,,,,,,,,,,,,,,,,,,,,,,,10,,,,,,,,,,,,,,,,,,,,,,,,,,,,,,,,,13,,,,,,,,,,,,,,,,,,,,,,,,,,,,,,,,,8,,,,,,,,,,,,,,,,,,,,,,,,,,,,,,,,,2,7.0,7.0,7.0,7.0,7.0,7.0,7.0,7.0,7.0,7.0,7.0,7.0,7.0,7.0,7.0,7.0,7.0,7.0,7.0,7.0,7.0,7.0,7.0,7.0,7.0,7.0,7.0,7.0,7.0,7.0,7.0,6.0,4,,,,,,,,,,,,,,,,,,,,,,,,,,,,,,,,,6,,,,,,,,,,,,,,,,,,,,,,,,,,,,,,,,,0,2.0,1.0,1.0,7.0,3.0,1.0,1.0,1.0,1.0,1.0,7.0,1.0,1.0,2.0,2.0,2.0,7.0,2.0,3.0,1.0,2.0,1.0,1.0,2.0,1.0,7.0,1.0,4.0,2.0,2.0,7.0,2.0,9,,,,,,,,,,,,,,,,,,,,,,,,,,,,,,,,,12,,,,,,,,,,,,,,,,,,,,,,,,,,,,,,,,,14,,,,,,,,,,,,,,,,,,,,,,,,,,,,,,,,,11,,,,,,,,,,,,,,,,,,,,,,,,,,,,,,,,,3,,,,,,,,,,,,,,,,,,,,,,,,,,,,,,,,,7,,,,,,,,,,,,,,,,,,,,,,,,,,,,,,,,,,326.74,66.49,,,,7.65,,55.34,,62.76,,,,,,,,,,,,,,,39.79,,,,,,,,,90.42,,,,,,,,,,,,,,,,,,,,,4.29,,APPROVED,Female,24.0,FALSE
492,2022-03-22 00:27:55,19,en,224298118,2022-03-22 00:21:33,2022-03-22 00:27:55,Y,Y,A1,,,2,6.0,7.0,7.0,6.0,6.0,6.0,7.0,6.0,7.0,6.0,6.0,6.0,6.0,7.0,7.0,7.0,7.0,4.0,7.0,5.0,4.0,7.0,1.0,7.0,7.0,4.0,4.0,7.0,5.0,7.0,7.0,1.0,7,,,,,,,,,,,,,,,,,,,,,,,,,,,,,,,,,0,4.0,7.0,3.0,3.0,5.0,4.0,7.0,2.0,5.0,3.0,3.0,4.0,3.0,5.0,4.0,2.0,6.0,3.0,4.0,5.0,4.0,3.0,5.0,5.0,5.0,4.0,6.0,4.0,3.0,3.0,2.0,3.0,10,,,,,,,,,,,,,,,,,,,,,,,,,,,,,,,,,9,,,,,,,,,,,,,,,,,,,,,,,,,,,,,,,,,1,4.0,7.0,5.0,4.0,7.0,2.0,6.0,6.0,7.0,4.0,4.0,3.0,5.0,5.0,5.0,4.0,5.0,2.0,4.0,4.0,3.0,4.0,2.0,5.0,7.0,4.0,4.0,6.0,2.0,4.0,4.0,6.0,3,,,,,,,,,,,,,,,,,,,,,,,,,,,,,,,,,12,,,,,,,,,,,,,,,,,,,,,,,,,,,,,,,,,4,,,,,,,,,,,,,,,,,,,,,,,,,,,,,,,,,6,,,,,,,,,,,,,,,,,,,,,,,,,,,,,,,,,14,,,,,,,,,,,,,,,,,,,,,,,,,,,,,,,,,13,,,,,,,,,,,,,,,,,,,,,,,,,,,,,,,,,8,,,,,,,,,,,,,,,,,,,,,,,,,,,,,,,,,11,,,,,,,,,,,,,,,,,,,,,,,,,,,,,,,,,5,,,,,,,,,,,,,,,,,,,,,,,,,,,,,,,,,,378.66,16.22,,,,9.6,,38.42,,86.04,,,,,,125.99,,,,,,,,,99.0,,,,,,,,,,,,,,,,,,,,,,,,,,,,,,3.39,,APPROVED,Female,22.0,FALSE
493,2022-03-22 00:31:18,19,en,1841255423,2022-03-22 00:21:34,2022-03-22 00:31:18,Y,Y,-oth-,HIGHSCHOOL DEGREE,,7,,,,,,,,,,,,,,,,,,,,,,,,,,,,,,,,,3,,,,,,,,,,,,,,,,,,,,,,,,,,,,,,,,,11,,,,,,,,,,,,,,,,,,,,,,,,,,,,,,,,,10,,,,,,,,,,,,,,,,,,,,,,,,,,,,,,,,,2,5.0,6.0,6.0,4.0,6.0,3.0,5.0,3.0,7.0,4.0,2.0,6.0,7.0,6.0,7.0,3.0,7.0,7.0,6.0,6.0,3.0,6.0,5.0,6.0,6.0,7.0,2.0,5.0,4.0,6.0,7.0,5.0,5,,,,,,,,,,,,,,,,,,,,,,,,,,,,,,,,,12,,,,,,,,,,,,,,,,,,,,,,,,,,,,,,,,,0,3.0,2.0,2.0,3.0,3.0,3.0,6.0,5.0,4.0,2.0,3.0,3.0,4.0,3.0,3.0,5.0,5.0,3.0,4.0,3.0,3.0,3.0,3.0,4.0,3.0,5.0,2.0,3.0,4.0,3.0,4.0,1.0,14,,,,,,,,,,,,,,,,,,,,,,,,,,,,,,,,,4,,,,,,,,,,,,,,,,,,,,,,,,,,,,,,,,,9,,,,,,,,,,,,,,,,,,,,,,,,,,,,,,,,,13,,,,,,,,,,,,,,,,,,,,,,,,,,,,,,,,,1,6.0,7.0,6.0,4.0,7.0,6.0,4.0,6.0,7.0,6.0,4.0,7.0,7.0,6.0,7.0,6.0,7.0,6.0,6.0,5.0,4.0,6.0,4.0,6.0,6.0,4.0,2.0,7.0,4.0,6.0,7.0,6.0,8,,,,,,,,,,,,,,,,,,,,,,,,,,,,,,,,,6,,,,,,,,,,,,,,,,,,,,,,,,,,,,,,,,,,586.04,38.7,,,,35.86,,74.96,,,,,,,,,,,,,,115.85,,,,,,,,,191.18,,,,,,,,,,,,,,,102.99,,,,,,,,,26.5,,APPROVED,Female,20.0,FALSE
494,2022-03-22 00:26:31,19,en,1077054922,2022-03-22 00:21:37,2022-03-22 00:26:31,Y,Y,A1,,,6,,,,,,,,,,,,,,,,,,,,,,,,,,,,,,,,,2,7.0,6.0,4.0,4.0,5.0,5.0,4.0,4.0,2.0,7.0,6.0,6.0,6.0,4.0,4.0,3.0,6.0,3.0,7.0,6.0,6.0,5.0,5.0,3.0,5.0,5.0,5.0,5.0,5.0,5.0,5.0,2.0,14,,,,,,,,,,,,,,,,,,,,,,,,,,,,,,,,,5,,,,,,,,,,,,,,,,,,,,,,,,,,,,,,,,,4,,,,,,,,,,,,,,,,,,,,,,,,,,,,,,,,,1,6.0,6.0,6.0,6.0,6.0,6.0,5.0,7.0,4.0,4.0,4.0,3.0,7.0,5.0,4.0,5.0,6.0,6.0,5.0,4.0,4.0,5.0,4.0,7.0,7.0,6.0,5.0,3.0,6.0,6.0,3.0,6.0,13,,,,,,,,,,,,,,,,,,,,,,,,,,,,,,,,,7,,,,,,,,,,,,,,,,,,,,,,,,,,,,,,,,,0,4.0,4.0,5.0,4.0,3.0,5.0,4.0,3.0,7.0,5.0,4.0,3.0,3.0,2.0,4.0,1.0,6.0,3.0,5.0,6.0,5.0,3.0,4.0,3.0,4.0,4.0,2.0,3.0,4.0,6.0,5.0,2.0,8,,,,,,,,,,,,,,,,,,,,,,,,,,,,,,,,,12,,,,,,,,,,,,,,,,,,,,,,,,,,,,,,,,,11,,,,,,,,,,,,,,,,,,,,,,,,,,,,,,,,,10,,,,,,,,,,,,,,,,,,,,,,,,,,,,,,,,,9,,,,,,,,,,,,,,,,,,,,,,,,,,,,,,,,,3,,,,,,,,,,,,,,,,,,,,,,,,,,,,,,,,,,297.82,78.44,,,,8.5,,41.46,,,,,38.65,,,,,,,,,,,,43.35,,,,,,,,,83.85,,,,,,,,,,,,,,,,,,,,,3.57,,TIMED-OUT,Male,20.0,FALSE
495,2022-03-22 00:25:41,19,en,1462779050,2022-03-22 00:21:37,2022-03-22 00:25:41,Y,Y,A1,,,2,3.0,2.0,1.0,2.0,3.0,2.0,4.0,4.0,3.0,2.0,2.0,1.0,3.0,2.0,2.0,1.0,2.0,1.0,2.0,2.0,1.0,4.0,1.0,2.0,2.0,1.0,3.0,2.0,3.0,2.0,1.0,1.0,8,,,,,,,,,,,,,,,,,,,,,,,,,,,,,,,,,11,,,,,,,,,,,,,,,,,,,,,,,,,,,,,,,,,6,,,,,,,,,,,,,,,,,,,,,,,,,,,,,,,,,14,,,,,,,,,,,,,,,,,,,,,,,,,,,,,,,,,12,,,,,,,,,,,,,,,,,,,,,,,,,,,,,,,,,0,3.0,7.0,6.0,3.0,3.0,4.0,2.0,4.0,5.0,5.0,3.0,5.0,6.0,4.0,6.0,5.0,5.0,6.0,4.0,5.0,4.0,5.0,1.0,5.0,6.0,2.0,2.0,5.0,2.0,4.0,3.0,7.0,13,,,,,,,,,,,,,,,,,,,,,,,,,,,,,,,,,9,,,,,,,,,,,,,,,,,,,,,,,,,,,,,,,,,3,,,,,,,,,,,,,,,,,,,,,,,,,,,,,,,,,10,,,,,,,,,,,,,,,,,,,,,,,,,,,,,,,,,5,,,,,,,,,,,,,,,,,,,,,,,,,,,,,,,,,7,,,,,,,,,,,,,,,,,,,,,,,,,,,,,,,,,4,,,,,,,,,,,,,,,,,,,,,,,,,,,,,,,,,1,3.0,3.0,4.0,1.0,3.0,1.0,5.0,3.0,4.0,2.0,2.0,2.0,4.0,3.0,4.0,1.0,3.0,3.0,1.0,3.0,2.0,3.0,1.0,3.0,1.0,2.0,1.0,3.0,2.0,2.0,2.0,1.0,,245.86,17.25,,,,12.25,,25.04,,59.45,,,,,,,,,,,,,,,,,,68.71,,,,,,,,,,,,,,,,,,,,,,,,59.0,,,4.16,,APPROVED,Male,21.0,FALSE
496,2022-03-22 00:28:24,19,en,1272583080,2022-03-22 00:21:55,2022-03-22 00:28:24,Y,Y,A1,,,7,,,,,,,,,,,,,,,,,,,,,,,,,,,,,,,,,2,7.0,5.0,6.0,6.0,5.0,7.0,3.0,7.0,3.0,5.0,5.0,7.0,7.0,6.0,7.0,6.0,6.0,5.0,6.0,6.0,6.0,7.0,6.0,6.0,6.0,6.0,6.0,7.0,5.0,6.0,7.0,2.0,4,,,,,,,,,,,,,,,,,,,,,,,,,,,,,,,,,6,,,,,,,,,,,,,,,,,,,,,,,,,,,,,,,,,8,,,,,,,,,,,,,,,,,,,,,,,,,,,,,,,,,3,,,,,,,,,,,,,,,,,,,,,,,,,,,,,,,,,9,,,,,,,,,,,,,,,,,,,,,,,,,,,,,,,,,10,,,,,,,,,,,,,,,,,,,,,,,,,,,,,,,,,5,,,,,,,,,,,,,,,,,,,,,,,,,,,,,,,,,12,,,,,,,,,,,,,,,,,,,,,,,,,,,,,,,,,1,6.0,7.0,6.0,5.0,6.0,6.0,6.0,3.0,7.0,6.0,6.0,5.0,6.0,5.0,5.0,5.0,6.0,6.0,6.0,6.0,5.0,6.0,2.0,6.0,6.0,5.0,5.0,6.0,5.0,6.0,5.0,4.0,14,,,,,,,,,,,,,,,,,,,,,,,,,,,,,,,,,13,,,,,,,,,,,,,,,,,,,,,,,,,,,,,,,,,11,,,,,,,,,,,,,,,,,,,,,,,,,,,,,,,,,0,5.0,6.0,3.0,5.0,3.0,6.0,6.0,6.0,6.0,3.0,6.0,5.0,4.0,4.0,5.0,5.0,6.0,3.0,5.0,3.0,2.0,5.0,3.0,5.0,3.0,6.0,5.0,3.0,5.0,6.0,6.0,1.0,,392.03,17.29,,,,12.58,,61.49,,,,,98.93,,,,,,,,,,,,,,,,,,,,,,,,,,,82.19,,,,,,,,,,,,111.19,,,8.36,,APPROVED,Male,29.0,FALSE
497,2022-03-22 00:27:49,19,en,2082885441,2022-03-22 00:21:56,2022-03-22 00:27:49,Y,Y,A1,,,9,,,,,,,,,,,,,,,,,,,,,,,,,,,,,,,,,0,7.0,6.0,7.0,5.0,7.0,7.0,4.0,7.0,7.0,7.0,7.0,7.0,7.0,7.0,7.0,7.0,7.0,7.0,7.0,7.0,7.0,7.0,7.0,7.0,7.0,7.0,1.0,7.0,7.0,7.0,7.0,2.0,14,,,,,,,,,,,,,,,,,,,,,,,,,,,,,,,,,6,,,,,,,,,,,,,,,,,,,,,,,,,,,,,,,,,2,1.0,2.0,2.0,1.0,1.0,1.0,1.0,5.0,1.0,1.0,1.0,1.0,1.0,1.0,1.0,2.0,5.0,1.0,2.0,2.0,2.0,3.0,1.0,1.0,1.0,6.0,6.0,1.0,1.0,1.0,4.0,5.0,13,,,,,,,,,,,,,,,,,,,,,,,,,,,,,,,,,1,7.0,6.0,6.0,7.0,7.0,6.0,7.0,7.0,7.0,6.0,7.0,7.0,5.0,2.0,7.0,7.0,7.0,7.0,7.0,5.0,5.0,7.0,7.0,7.0,7.0,5.0,4.0,6.0,2.0,7.0,6.0,7.0,12,,,,,,,,,,,,,,,,,,,,,,,,,,,,,,,,,5,,,,,,,,,,,,,,,,,,,,,,,,,,,,,,,,,10,,,,,,,,,,,,,,,,,,,,,,,,,,,,,,,,,4,,,,,,,,,,,,,,,,,,,,,,,,,,,,,,,,,3,,,,,,,,,,,,,,,,,,,,,,,,,,,,,,,,,11,,,,,,,,,,,,,,,,,,,,,,,,,,,,,,,,,8,,,,,,,,,,,,,,,,,,,,,,,,,,,,,,,,,7,,,,,,,,,,,,,,,,,,,,,,,,,,,,,,,,,,354.86,21.46,,,,8.5,,47.23,,,,,88.96,,,,,,,,,91.35,,,,,,91.95,,,,,,,,,,,,,,,,,,,,,,,,,,,5.41,,APPROVED,Female,19.0,FALSE
498,2022-03-22 00:30:03,19,en,810554795,2022-03-22 00:22:00,2022-03-22 00:30:03,Y,Y,A1,,,3,,,,,,,,,,,,,,,,,,,,,,,,,,,,,,,,,4,,,,,,,,,,,,,,,,,,,,,,,,,,,,,,,,,11,,,,,,,,,,,,,,,,,,,,,,,,,,,,,,,,,10,,,,,,,,,,,,,,,,,,,,,,,,,,,,,,,,,7,,,,,,,,,,,,,,,,,,,,,,,,,,,,,,,,,9,,,,,,,,,,,,,,,,,,,,,,,,,,,,,,,,,1,5.0,3.0,5.0,3.0,5.0,3.0,4.0,5.0,4.0,5.0,3.0,5.0,4.0,3.0,5.0,3.0,5.0,3.0,3.0,3.0,3.0,4.0,3.0,5.0,5.0,3.0,3.0,5.0,5.0,3.0,3.0,7.0,2,1.0,1.0,1.0,1.0,1.0,1.0,1.0,1.0,1.0,1.0,1.0,1.0,1.0,1.0,1.0,1.0,1.0,1.0,1.0,1.0,1.0,1.0,1.0,1.0,1.0,1.0,1.0,1.0,1.0,1.0,1.0,1.0,13,,,,,,,,,,,,,,,,,,,,,,,,,,,,,,,,,0,1.0,2.0,1.0,1.0,1.0,1.0,7.0,1.0,1.0,1.0,1.0,1.0,1.0,1.0,2.0,1.0,1.0,1.0,1.0,1.0,1.0,1.0,1.0,1.0,1.0,1.0,1.0,1.0,1.0,1.0,1.0,3.0,12,,,,,,,,,,,,,,,,,,,,,,,,,,,,,,,,,8,,,,,,,,,,,,,,,,,,,,,,,,,,,,,,,,,5,,,,,,,,,,,,,,,,,,,,,,,,,,,,,,,,,6,,,,,,,,,,,,,,,,,,,,,,,,,,,,,,,,,14,,,,,,,,,,,,,,,,,,,,,,,,,,,,,,,,,,486.54,38.27,,,,5.93,,73.56,,,,,,,,,,,,,,,,,,,,152.43,,,143.95,,,,,,68.94,,,,,,,,,,,,,,,,,,3.46,,APPROVED,Female,27.0,FALSE
499,2022-03-22 00:30:01,19,en,401838767,2022-03-22 00:22:32,2022-03-22 00:30:01,Y,Y,A1,,,14,,,,,,,,,,,,,,,,,,,,,,,,,,,,,,,,,3,,,,,,,,,,,,,,,,,,,,,,,,,,,,,,,,,7,,,,,,,,,,,,,,,,,,,,,,,,,,,,,,,,,11,,,,,,,,,,,,,,,,,,,,,,,,,,,,,,,,,13,,,,,,,,,,,,,,,,,,,,,,,,,,,,,,,,,8,,,,,,,,,,,,,,,,,,,,,,,,,,,,,,,,,5,,,,,,,,,,,,,,,,,,,,,,,,,,,,,,,,,2,5.0,5.0,3.0,5.0,3.0,6.0,5.0,5.0,3.0,7.0,2.0,6.0,7.0,6.0,6.0,3.0,6.0,6.0,7.0,6.0,4.0,6.0,5.0,7.0,2.0,1.0,5.0,5.0,3.0,3.0,7.0,1.0,1,5.0,1.0,5.0,6.0,1.0,5.0,5.0,2.0,5.0,2.0,7.0,5.0,5.0,4.0,2.0,4.0,4.0,2.0,6.0,1.0,2.0,6.0,6.0,3.0,4.0,7.0,4.0,6.0,3.0,7.0,6.0,2.0,10,,,,,,,,,,,,,,,,,,,,,,,,,,,,,,,,,9,,,,,,,,,,,,,,,,,,,,,,,,,,,,,,,,,12,,,,,,,,,,,,,,,,,,,,,,,,,,,,,,,,,0,2.0,6.0,5.0,1.0,5.0,2.0,7.0,5.0,3.0,1.0,1.0,1.0,3.0,2.0,5.0,2.0,4.0,1.0,1.0,1.0,1.0,1.0,1.0,1.0,5.0,3.0,6.0,1.0,5.0,2.0,1.0,6.0,6,,,,,,,,,,,,,,,,,,,,,,,,,,,,,,,,,4,,,,,,,,,,,,,,,,,,,,,,,,,,,,,,,,,,451.97,90.0,,,,6.72,,35.25,,,,,,,,,,,,,,,,,,,,,,,88.97,,,109.55,,,,,,,,,,,,117.58,,,,,,,,,3.9,,APPROVED,Male,27.0,FALSE
500,2022-03-22 00:28:22,19,en,438262282,2022-03-22 00:22:40,2022-03-22 00:28:22,Y,Y,A1,,,4,,,,,,,,,,,,,,,,,,,,,,,,,,,,,,,,,3,,,,,,,,,,,,,,,,,,,,,,,,,,,,,,,,,13,,,,,,,,,,,,,,,,,,,,,,,,,,,,,,,,,6,,,,,,,,,,,,,,,,,,,,,,,,,,,,,,,,,2,2.0,2.0,1.0,2.0,2.0,2.0,5.0,4.0,3.0,2.0,2.0,2.0,3.0,3.0,5.0,3.0,3.0,3.0,3.0,1.0,2.0,1.0,3.0,2.0,2.0,3.0,5.0,3.0,6.0,2.0,3.0,5.0,9,,,,,,,,,,,,,,,,,,,,,,,,,,,,,,,,,11,,,,,,,,,,,,,,,,,,,,,,,,,,,,,,,,,12,,,,,,,,,,,,,,,,,,,,,,,,,,,,,,,,,10,,,,,,,,,,,,,,,,,,,,,,,,,,,,,,,,,7,,,,,,,,,,,,,,,,,,,,,,,,,,,,,,,,,8,,,,,,,,,,,,,,,,,,,,,,,,,,,,,,,,,5,,,,,,,,,,,,,,,,,,,,,,,,,,,,,,,,,14,,,,,,,,,,,,,,,,,,,,,,,,,,,,,,,,,1,3.0,4.0,3.0,3.0,2.0,4.0,4.0,4.0,3.0,4.0,3.0,4.0,3.0,4.0,4.0,3.0,3.0,6.0,2.0,4.0,2.0,3.0,4.0,4.0,3.0,4.0,6.0,3.0,4.0,4.0,4.0,7.0,0,7.0,5.0,5.0,7.0,7.0,7.0,6.0,7.0,6.0,5.0,6.0,6.0,5.0,5.0,6.0,6.0,7.0,6.0,7.0,7.0,3.0,6.0,7.0,6.0,6.0,6.0,5.0,6.0,4.0,4.0,6.0,1.0,,345.05,22.05,,,,13.34,,35.28,,,,,,,,,,,,,,61.65,,,,,,,,,,,,,,,,,,,,,,,,,,,108.5,,,95.47,,,8.76,,APPROVED,Male,27.0,FALSE
501,2022-03-22 00:28:16,19,en,109766859,2022-03-22 00:22:43,2022-03-22 00:28:16,Y,Y,A1,,,4,,,,,,,,,,,,,,,,,,,,,,,,,,,,,,,,,7,,,,,,,,,,,,,,,,,,,,,,,,,,,,,,,,,3,,,,,,,,,,,,,,,,,,,,,,,,,,,,,,,,,14,,,,,,,,,,,,,,,,,,,,,,,,,,,,,,,,,8,,,,,,,,,,,,,,,,,,,,,,,,,,,,,,,,,1,6.0,6.0,6.0,5.0,6.0,6.0,4.0,6.0,6.0,4.0,5.0,6.0,5.0,6.0,4.0,5.0,5.0,6.0,6.0,4.0,6.0,5.0,6.0,6.0,6.0,6.0,2.0,6.0,5.0,4.0,6.0,6.0,12,,,,,,,,,,,,,,,,,,,,,,,,,,,,,,,,,0,4.0,3.0,2.0,4.0,2.0,3.0,2.0,2.0,3.0,3.0,3.0,2.0,4.0,2.0,1.0,2.0,4.0,2.0,3.0,2.0,3.0,4.0,4.0,4.0,3.0,3.0,2.0,3.0,3.0,2.0,4.0,1.0,6,,,,,,,,,,,,,,,,,,,,,,,,,,,,,,,,,10,,,,,,,,,,,,,,,,,,,,,,,,,,,,,,,,,13,,,,,,,,,,,,,,,,,,,,,,,,,,,,,,,,,11,,,,,,,,,,,,,,,,,,,,,,,,,,,,,,,,,5,,,,,,,,,,,,,,,,,,,,,,,,,,,,,,,,,2,6.0,6.0,4.0,6.0,4.0,4.0,4.0,5.0,6.0,4.0,4.0,6.0,6.0,6.0,6.0,5.0,6.0,6.0,5.0,4.0,4.0,6.0,5.0,5.0,4.0,6.0,4.0,6.0,6.0,2.0,7.0,7.0,9,,,,,,,,,,,,,,,,,,,,,,,,,,,,,,,,,,336.67,31.34,,,,6.16,,59.82,,,,,,,,,,,,,,,,,70.77,,,,,,93.72,,,,,,,,,,,,,,,,,,69.83,,,,,,5.03,,APPROVED,Male,27.0,FALSE
502,2022-03-22 00:30:07,19,en,1632188851,2022-03-22 00:22:56,2022-03-22 00:30:07,Y,Y,A2,,,6,,,,,,,,,,,,,,,,,,,,,,,,,,,,,,,,,8,,,,,,,,,,,,,,,,,,,,,,,,,,,,,,,,,3,,,,,,,,,,,,,,,,,,,,,,,,,,,,,,,,,9,,,,,,,,,,,,,,,,,,,,,,,,,,,,,,,,,13,,,,,,,,,,,,,,,,,,,,,,,,,,,,,,,,,14,,,,,,,,,,,,,,,,,,,,,,,,,,,,,,,,,5,,,,,,,,,,,,,,,,,,,,,,,,,,,,,,,,,7,,,,,,,,,,,,,,,,,,,,,,,,,,,,,,,,,12,,,,,,,,,,,,,,,,,,,,,,,,,,,,,,,,,1,7.0,7.0,7.0,1.0,6.0,1.0,7.0,1.0,7.0,6.0,7.0,1.0,7.0,7.0,7.0,3.0,7.0,1.0,6.0,4.0,1.0,1.0,1.0,6.0,7.0,1.0,7.0,7.0,1.0,1.0,1.0,3.0,10,,,,,,,,,,,,,,,,,,,,,,,,,,,,,,,,,11,,,,,,,,,,,,,,,,,,,,,,,,,,,,,,,,,2,1.0,1.0,1.0,3.0,1.0,3.0,6.0,1.0,2.0,2.0,1.0,3.0,5.0,1.0,1.0,2.0,1.0,2.0,1.0,1.0,1.0,2.0,1.0,1.0,1.0,3.0,5.0,1.0,1.0,1.0,2.0,6.0,0,7.0,1.0,4.0,7.0,4.0,7.0,1.0,7.0,5.0,4.0,4.0,6.0,4.0,4.0,4.0,4.0,7.0,5.0,5.0,4.0,1.0,4.0,7.0,4.0,4.0,7.0,1.0,4.0,4.0,4.0,7.0,7.0,4,,,,,,,,,,,,,,,,,,,,,,,,,,,,,,,,,,435.51,49.95,,,,13.94,,52.51,,,,,,,,,,,,,,,,,,,,,,,,,,,,,101.89,,,,,,,,,95.3,,,118.02,,,,,,3.9,,APPROVED,Male,22.0,FALSE
503,2022-03-22 00:33:17,19,en,507239826,2022-03-22 00:23:34,2022-03-22 00:33:17,Y,Y,-oth-,matric,,11,,,,,,,,,,,,,,,,,,,,,,,,,,,,,,,,,13,,,,,,,,,,,,,,,,,,,,,,,,,,,,,,,,,7,,,,,,,,,,,,,,,,,,,,,,,,,,,,,,,,,1,5.0,7.0,7.0,6.0,6.0,6.0,5.0,6.0,5.0,5.0,7.0,6.0,7.0,7.0,6.0,6.0,7.0,7.0,5.0,6.0,5.0,6.0,6.0,6.0,7.0,7.0,7.0,7.0,6.0,4.0,6.0,4.0,9,,,,,,,,,,,,,,,,,,,,,,,,,,,,,,,,,8,,,,,,,,,,,,,,,,,,,,,,,,,,,,,,,,,0,2.0,6.0,4.0,1.0,4.0,5.0,5.0,6.0,6.0,4.0,4.0,4.0,5.0,2.0,4.0,2.0,5.0,3.0,4.0,5.0,2.0,4.0,6.0,4.0,2.0,5.0,3.0,4.0,4.0,1.0,6.0,7.0,5,,,,,,,,,,,,,,,,,,,,,,,,,,,,,,,,,6,,,,,,,,,,,,,,,,,,,,,,,,,,,,,,,,,12,,,,,,,,,,,,,,,,,,,,,,,,,,,,,,,,,10,,,,,,,,,,,,,,,,,,,,,,,,,,,,,,,,,4,,,,,,,,,,,,,,,,,,,,,,,,,,,,,,,,,3,,,,,,,,,,,,,,,,,,,,,,,,,,,,,,,,,2,2.0,7.0,2.0,2.0,1.0,4.0,4.0,5.0,7.0,1.0,3.0,1.0,1.0,4.0,4.0,3.0,7.0,1.0,2.0,3.0,1.0,1.0,5.0,2.0,1.0,5.0,2.0,3.0,2.0,2.0,5.0,7.0,14,,,,,,,,,,,,,,,,,,,,,,,,,,,,,,,,,"it was very interesting and fun , also a bit tricky but I enjoyed doing it , cheers.
",588.03,29.72,,,,24.96,,61.78,,,,,,,,,,,125.36,,,,,,,,,201.1,,,,,,,,,,,,,,,,,,,,,92.75,,,,,,52.36,,APPROVED,Male,19.0,FALSE
505,2022-03-22 00:35:40,19,en,1143194602,2022-03-22 00:30:23,2022-03-22 00:35:40,Y,Y,-oth-,currently finishing bachelor (3rd year),,10,,,,,,,,,,,,,,,,,,,,,,,,,,,,,,,,,13,,,,,,,,,,,,,,,,,,,,,,,,,,,,,,,,,9,,,,,,,,,,,,,,,,,,,,,,,,,,,,,,,,,3,,,,,,,,,,,,,,,,,,,,,,,,,,,,,,,,,4,,,,,,,,,,,,,,,,,,,,,,,,,,,,,,,,,5,,,,,,,,,,,,,,,,,,,,,,,,,,,,,,,,,14,,,,,,,,,,,,,,,,,,,,,,,,,,,,,,,,,8,,,,,,,,,,,,,,,,,,,,,,,,,,,,,,,,,11,,,,,,,,,,,,,,,,,,,,,,,,,,,,,,,,,7,,,,,,,,,,,,,,,,,,,,,,,,,,,,,,,,,1,6.0,6.0,5.0,2.0,2.0,2.0,4.0,6.0,6.0,3.0,2.0,7.0,2.0,4.0,5.0,5.0,7.0,6.0,4.0,2.0,4.0,6.0,2.0,3.0,4.0,6.0,6.0,2.0,6.0,4.0,5.0,4.0,6,,,,,,,,,,,,,,,,,,,,,,,,,,,,,,,,,12,,,,,,,,,,,,,,,,,,,,,,,,,,,,,,,,,2,1.0,1.0,2.0,3.0,2.0,6.0,6.0,1.0,2.0,2.0,1.0,6.0,2.0,2.0,2.0,1.0,3.0,2.0,2.0,1.0,1.0,1.0,6.0,1.0,2.0,4.0,2.0,2.0,7.0,2.0,2.0,7.0,0,6.0,7.0,4.0,4.0,3.0,5.0,6.0,4.0,5.0,4.0,5.0,4.0,4.0,5.0,3.0,2.0,6.0,3.0,3.0,2.0,3.0,4.0,2.0,5.0,4.0,4.0,5.0,3.0,7.0,3.0,2.0,1.0,,318.94,34.02,,,,22.2,,28.01,,,,,,,,,,,,,,,,,,,,,,,,,,,,,,,,114.07,,,,,,,,,52.49,,,64.8,,,3.35,,RETURNED,CONSENT REVOKED,20.0,FALSE
506,2022-03-22 00:54:31,19,en,183186510,2022-03-22 00:30:53,2022-03-22 00:54:31,Y,Y,A1,,,10,,,,,,,,,,,,,,,,,,,,,,,,,,,,,,,,,7,,,,,,,,,,,,,,,,,,,,,,,,,,,,,,,,,0,5.0,6.0,5.0,4.0,5.0,5.0,6.0,6.0,5.0,5.0,5.0,5.0,5.0,5.0,5.0,5.0,6.0,5.0,5.0,4.0,5.0,5.0,5.0,5.0,5.0,5.0,2.0,6.0,5.0,4.0,6.0,3.0,12,,,,,,,,,,,,,,,,,,,,,,,,,,,,,,,,,1,2.0,2.0,3.0,3.0,3.0,3.0,3.0,5.0,5.0,3.0,3.0,3.0,3.0,3.0,5.0,3.0,3.0,3.0,3.0,4.0,3.0,3.0,3.0,3.0,3.0,4.0,2.0,2.0,3.0,3.0,3.0,5.0,5,,,,,,,,,,,,,,,,,,,,,,,,,,,,,,,,,6,,,,,,,,,,,,,,,,,,,,,,,,,,,,,,,,,14,,,,,,,,,,,,,,,,,,,,,,,,,,,,,,,,,3,,,,,,,,,,,,,,,,,,,,,,,,,,,,,,,,,8,,,,,,,,,,,,,,,,,,,,,,,,,,,,,,,,,4,,,,,,,,,,,,,,,,,,,,,,,,,,,,,,,,,2,5.0,5.0,5.0,4.0,5.0,3.0,5.0,5.0,5.0,5.0,5.0,5.0,5.0,5.0,6.0,4.0,6.0,5.0,4.0,4.0,5.0,5.0,2.0,4.0,5.0,4.0,2.0,5.0,4.0,3.0,4.0,5.0,13,,,,,,,,,,,,,,,,,,,,,,,,,,,,,,,,,11,,,,,,,,,,,,,,,,,,,,,,,,,,,,,,,,,9,,,,,,,,,,,,,,,,,,,,,,,,,,,,,,,,,,1420.31,261.56,,,,5.1,,107.87,,,,,,,,536.89,,,,,,323.32,,,,,,,,,,,,,,,,,,,,,182.33,,,,,,,,,,,,3.24,,APPROVED,Male,23.0,FALSE
507,2022-03-22 00:36:52,19,en,1980582141,2022-03-22 00:30:55,2022-03-22 00:36:52,Y,Y,A1,,,4,,,,,,,,,,,,,,,,,,,,,,,,,,,,,,,,,0,6.0,2.0,7.0,6.0,4.0,7.0,4.0,6.0,4.0,4.0,5.0,6.0,4.0,5.0,6.0,6.0,6.0,5.0,6.0,4.0,4.0,5.0,6.0,4.0,7.0,6.0,4.0,4.0,5.0,4.0,6.0,2.0,6,,,,,,,,,,,,,,,,,,,,,,,,,,,,,,,,,1,1.0,1.0,2.0,2.0,4.0,1.0,3.0,5.0,2.0,4.0,3.0,3.0,3.0,2.0,4.0,3.0,2.0,2.0,1.0,2.0,3.0,3.0,1.0,3.0,2.0,4.0,2.0,3.0,3.0,3.0,1.0,4.0,11,,,,,,,,,,,,,,,,,,,,,,,,,,,,,,,,,9,,,,,,,,,,,,,,,,,,,,,,,,,,,,,,,,,3,,,,,,,,,,,,,,,,,,,,,,,,,,,,,,,,,13,,,,,,,,,,,,,,,,,,,,,,,,,,,,,,,,,8,,,,,,,,,,,,,,,,,,,,,,,,,,,,,,,,,10,,,,,,,,,,,,,,,,,,,,,,,,,,,,,,,,,12,,,,,,,,,,,,,,,,,,,,,,,,,,,,,,,,,14,,,,,,,,,,,,,,,,,,,,,,,,,,,,,,,,,7,,,,,,,,,,,,,,,,,,,,,,,,,,,,,,,,,5,,,,,,,,,,,,,,,,,,,,,,,,,,,,,,,,,2,1.0,1.0,2.0,2.0,1.0,2.0,1.0,1.0,1.0,1.0,1.0,2.0,2.0,1.0,1.0,1.0,2.0,1.0,2.0,1.0,2.0,1.0,2.0,2.0,1.0,3.0,1.0,2.0,1.0,1.0,1.0,1.0,,358.4,123.4,,,,8.34,,52.12,,,,,76.97,,,,,,56.17,,,,,,,,,,,,,,,,,,,,,,,,,,,,,,,,,38.11,,,3.29,,APPROVED,Male,22.0,FALSE
508,2022-03-22 00:35:02,19,en,1395548091,2022-03-22 00:30:55,2022-03-22 00:35:02,Y,Y,A1,,,11,,,,,,,,,,,,,,,,,,,,,,,,,,,,,,,,,4,,,,,,,,,,,,,,,,,,,,,,,,,,,,,,,,,2,2.0,6.0,5.0,1.0,4.0,2.0,6.0,6.0,5.0,5.0,3.0,1.0,1.0,5.0,1.0,1.0,5.0,4.0,3.0,4.0,1.0,1.0,1.0,1.0,6.0,3.0,2.0,6.0,4.0,5.0,2.0,3.0,7,,,,,,,,,,,,,,,,,,,,,,,,,,,,,,,,,3,,,,,,,,,,,,,,,,,,,,,,,,,,,,,,,,,5,,,,,,,,,,,,,,,,,,,,,,,,,,,,,,,,,10,,,,,,,,,,,,,,,,,,,,,,,,,,,,,,,,,14,,,,,,,,,,,,,,,,,,,,,,,,,,,,,,,,,8,,,,,,,,,,,,,,,,,,,,,,,,,,,,,,,,,13,,,,,,,,,,,,,,,,,,,,,,,,,,,,,,,,,6,,,,,,,,,,,,,,,,,,,,,,,,,,,,,,,,,0,3.0,5.0,3.0,3.0,4.0,4.0,6.0,5.0,5.0,2.0,3.0,4.0,3.0,1.0,2.0,3.0,4.0,2.0,3.0,2.0,2.0,3.0,3.0,3.0,2.0,4.0,2.0,4.0,2.0,4.0,4.0,5.0,12,,,,,,,,,,,,,,,,,,,,,,,,,,,,,,,,,1,3.0,4.0,3.0,6.0,1.0,6.0,1.0,2.0,4.0,4.0,1.0,5.0,5.0,4.0,6.0,6.0,6.0,5.0,4.0,2.0,5.0,4.0,5.0,4.0,2.0,6.0,5.0,5.0,4.0,6.0,4.0,7.0,9,,,,,,,,,,,,,,,,,,,,,,,,,,,,,,,,,,250.41,8.93,,,,37.11,,14.36,,,,,,,,63.53,,,,,,,,,,,,,,,,,,,,,,,,,,,53.36,,,,,,70.67,,,,,,2.45,,APPROVED,Female,24.0,FALSE
509,2022-03-22 00:36:13,19,en,1707728501,2022-03-22 00:30:55,2022-03-22 00:36:13,Y,Y,-oth-,ESO,,0,5.0,5.0,5.0,4.0,4.0,3.0,4.0,4.0,5.0,5.0,5.0,5.0,5.0,4.0,4.0,4.0,5.0,5.0,4.0,5.0,3.0,5.0,4.0,4.0,5.0,3.0,4.0,3.0,5.0,4.0,3.0,1.0,11,,,,,,,,,,,,,,,,,,,,,,,,,,,,,,,,,10,,,,,,,,,,,,,,,,,,,,,,,,,,,,,,,,,7,,,,,,,,,,,,,,,,,,,,,,,,,,,,,,,,,4,,,,,,,,,,,,,,,,,,,,,,,,,,,,,,,,,6,,,,,,,,,,,,,,,,,,,,,,,,,,,,,,,,,12,,,,,,,,,,,,,,,,,,,,,,,,,,,,,,,,,14,,,,,,,,,,,,,,,,,,,,,,,,,,,,,,,,,5,,,,,,,,,,,,,,,,,,,,,,,,,,,,,,,,,2,4.0,4.0,4.0,4.0,4.0,2.0,5.0,3.0,4.0,4.0,4.0,4.0,4.0,4.0,4.0,4.0,3.0,4.0,4.0,4.0,4.0,4.0,2.0,4.0,4.0,3.0,4.0,3.0,3.0,4.0,3.0,3.0,3,,,,,,,,,,,,,,,,,,,,,,,,,,,,,,,,,13,,,,,,,,,,,,,,,,,,,,,,,,,,,,,,,,,9,,,,,,,,,,,,,,,,,,,,,,,,,,,,,,,,,1,1.0,4.0,1.0,4.0,1.0,3.0,3.0,4.0,5.0,1.0,1.0,1.0,1.0,1.0,5.0,4.0,4.0,1.0,1.0,1.0,1.0,1.0,5.0,1.0,1.0,5.0,3.0,1.0,4.0,1.0,4.0,7.0,8,,,,,,,,,,,,,,,,,,,,,,,,,,,,,,,,,,321.56,62.94,,,,10.3,,40.12,,77.88,,,,,,,,,,,,,,,,,,,,,,,,,,,58.61,,,,,,,,,,,,67.7,,,,,,4.01,,APPROVED,Male,29.0,FALSE
510,2022-03-22 00:36:58,19,en,1468557164,2022-03-22 00:30:57,2022-03-22 00:36:58,Y,Y,A1,,,14,,,,,,,,,,,,,,,,,,,,,,,,,,,,,,,,,7,,,,,,,,,,,,,,,,,,,,,,,,,,,,,,,,,9,,,,,,,,,,,,,,,,,,,,,,,,,,,,,,,,,1,4.0,5.0,4.0,3.0,4.0,2.0,7.0,4.0,5.0,3.0,4.0,4.0,4.0,4.0,4.0,3.0,4.0,5.0,4.0,4.0,4.0,4.0,3.0,4.0,5.0,3.0,4.0,3.0,3.0,3.0,2.0,4.0,13,,,,,,,,,,,,,,,,,,,,,,,,,,,,,,,,,8,,,,,,,,,,,,,,,,,,,,,,,,,,,,,,,,,12,,,,,,,,,,,,,,,,,,,,,,,,,,,,,,,,,10,,,,,,,,,,,,,,,,,,,,,,,,,,,,,,,,,3,,,,,,,,,,,,,,,,,,,,,,,,,,,,,,,,,2,3.0,4.0,3.0,2.0,4.0,1.0,7.0,4.0,3.0,3.0,3.0,4.0,2.0,4.0,4.0,2.0,4.0,4.0,2.0,2.0,2.0,3.0,2.0,2.0,4.0,2.0,3.0,2.0,2.0,2.0,2.0,3.0,4,,,,,,,,,,,,,,,,,,,,,,,,,,,,,,,,,0,5.0,4.0,5.0,4.0,5.0,4.0,5.0,5.0,5.0,5.0,4.0,5.0,5.0,4.0,5.0,4.0,5.0,5.0,5.0,4.0,4.0,5.0,4.0,5.0,5.0,4.0,5.0,4.0,4.0,4.0,4.0,5.0,5,,,,,,,,,,,,,,,,,,,,,,,,,,,,,,,,,11,,,,,,,,,,,,,,,,,,,,,,,,,,,,,,,,,6,,,,,,,,,,,,,,,,,,,,,,,,,,,,,,,,,,364.2,21.95,,,,8.75,,35.46,,,,,,,,,,,99.69,,,,,,,,,,,,,,,,,,77.64,,,,,,116.41,,,,,,,,,,,,4.3,,APPROVED,Female,38.0,FALSE
511,2022-03-22 00:35:34,19,en,541300751,2022-03-22 00:30:58,2022-03-22 00:35:34,Y,Y,A1,,,11,,,,,,,,,,,,,,,,,,,,,,,,,,,,,,,,,6,,,,,,,,,,,,,,,,,,,,,,,,,,,,,,,,,4,,,,,,,,,,,,,,,,,,,,,,,,,,,,,,,,,2,6.0,7.0,7.0,7.0,7.0,5.0,2.0,7.0,7.0,6.0,7.0,6.0,7.0,6.0,6.0,7.0,7.0,6.0,6.0,6.0,5.0,6.0,6.0,7.0,7.0,6.0,2.0,6.0,6.0,6.0,7.0,4.0,7,,,,,,,,,,,,,,,,,,,,,,,,,,,,,,,,,13,,,,,,,,,,,,,,,,,,,,,,,,,,,,,,,,,1,5.0,7.0,6.0,6.0,5.0,6.0,2.0,5.0,4.0,6.0,5.0,6.0,6.0,6.0,6.0,5.0,6.0,5.0,5.0,5.0,6.0,5.0,6.0,5.0,6.0,6.0,2.0,6.0,5.0,5.0,5.0,7.0,0,5.0,5.0,5.0,3.0,5.0,3.0,7.0,4.0,7.0,5.0,5.0,5.0,6.0,6.0,4.0,4.0,5.0,5.0,6.0,6.0,5.0,6.0,2.0,5.0,6.0,3.0,2.0,5.0,5.0,6.0,4.0,1.0,10,,,,,,,,,,,,,,,,,,,,,,,,,,,,,,,,,3,,,,,,,,,,,,,,,,,,,,,,,,,,,,,,,,,8,,,,,,,,,,,,,,,,,,,,,,,,,,,,,,,,,14,,,,,,,,,,,,,,,,,,,,,,,,,,,,,,,,,12,,,,,,,,,,,,,,,,,,,,,,,,,,,,,,,,,9,,,,,,,,,,,,,,,,,,,,,,,,,,,,,,,,,5,,,,,,,,,,,,,,,,,,,,,,,,,,,,,,,,,,280.06,13.74,,,,4.19,,27.82,,,,,,,,,,,62.39,,,,,,,,,88.75,,,80.35,,,,,,,,,,,,,,,,,,,,,,,,2.82,,APPROVED,Male,20.0,FALSE
512,2022-03-22 00:39:42,19,en,1826137232,2022-03-22 00:30:58,2022-03-22 00:39:42,Y,Y,A3,,,14,,,,,,,,,,,,,,,,,,,,,,,,,,,,,,,,,2,4.0,3.0,4.0,6.0,4.0,6.0,2.0,6.0,3.0,3.0,4.0,5.0,5.0,4.0,3.0,6.0,4.0,5.0,5.0,4.0,5.0,5.0,6.0,4.0,5.0,5.0,3.0,5.0,3.0,6.0,5.0,2.0,10,,,,,,,,,,,,,,,,,,,,,,,,,,,,,,,,,1,6.0,5.0,6.0,6.0,6.0,5.0,3.0,7.0,5.0,7.0,6.0,6.0,7.0,6.0,6.0,6.0,6.0,5.0,6.0,5.0,5.0,4.0,6.0,6.0,6.0,6.0,4.0,5.0,6.0,5.0,6.0,4.0,6,,,,,,,,,,,,,,,,,,,,,,,,,,,,,,,,,12,,,,,,,,,,,,,,,,,,,,,,,,,,,,,,,,,3,,,,,,,,,,,,,,,,,,,,,,,,,,,,,,,,,8,,,,,,,,,,,,,,,,,,,,,,,,,,,,,,,,,9,,,,,,,,,,,,,,,,,,,,,,,,,,,,,,,,,7,,,,,,,,,,,,,,,,,,,,,,,,,,,,,,,,,11,,,,,,,,,,,,,,,,,,,,,,,,,,,,,,,,,13,,,,,,,,,,,,,,,,,,,,,,,,,,,,,,,,,0,4.0,2.0,4.0,3.0,4.0,2.0,6.0,4.0,5.0,3.0,3.0,5.0,5.0,3.0,5.0,5.0,5.0,3.0,3.0,2.0,2.0,5.0,4.0,3.0,4.0,3.0,5.0,2.0,5.0,3.0,2.0,6.0,5,,,,,,,,,,,,,,,,,,,,,,,,,,,,,,,,,4,,,,,,,,,,,,,,,,,,,,,,,,,,,,,,,,,,526.6,38.02,,,,6.57,,180.98,,,,,87.57,,,,,,85.23,,,,,,,,,,,,,,,,,,,,,,,,,,,123.33,,,,,,,,,4.9,,APPROVED,Female,35.0,FALSE
513,2022-03-22 00:34:15,19,en,1735544334,2022-03-22 00:31:01,2022-03-22 00:34:15,Y,Y,A1,,,5,,,,,,,,,,,,,,,,,,,,,,,,,,,,,,,,,0,7.0,7.0,7.0,7.0,7.0,7.0,1.0,7.0,7.0,7.0,7.0,7.0,7.0,7.0,7.0,7.0,7.0,7.0,7.0,7.0,7.0,7.0,7.0,7.0,7.0,7.0,7.0,7.0,7.0,7.0,7.0,2.0,11,,,,,,,,,,,,,,,,,,,,,,,,,,,,,,,,,7,,,,,,,,,,,,,,,,,,,,,,,,,,,,,,,,,8,,,,,,,,,,,,,,,,,,,,,,,,,,,,,,,,,9,,,,,,,,,,,,,,,,,,,,,,,,,,,,,,,,,6,,,,,,,,,,,,,,,,,,,,,,,,,,,,,,,,,14,,,,,,,,,,,,,,,,,,,,,,,,,,,,,,,,,12,,,,,,,,,,,,,,,,,,,,,,,,,,,,,,,,,3,,,,,,,,,,,,,,,,,,,,,,,,,,,,,,,,,13,,,,,,,,,,,,,,,,,,,,,,,,,,,,,,,,,4,,,,,,,,,,,,,,,,,,,,,,,,,,,,,,,,,10,,,,,,,,,,,,,,,,,,,,,,,,,,,,,,,,,2,1.0,1.0,1.0,1.0,1.0,1.0,4.0,1.0,6.0,1.0,1.0,2.0,1.0,1.0,1.0,1.0,2.0,1.0,1.0,1.0,1.0,1.0,1.0,1.0,1.0,2.0,7.0,1.0,1.0,1.0,6.0,7.0,1,1.0,5.0,1.0,1.0,1.0,1.0,1.0,4.0,2.0,1.0,1.0,3.0,2.0,1.0,1.0,1.0,2.0,1.0,1.0,1.0,1.0,1.0,1.0,1.0,1.0,4.0,4.0,1.0,1.0,1.0,1.0,1.0,,195.93,24.56,,,,5.07,,19.3,,,,,48.03,,,,,,,,,,,,,,,,,,,,,,,,,,,,,,,,,,,,47.34,,,49.23,,,2.4,,APPROVED,Female,24.0,FALSE
514,2022-03-22 00:50:52,19,en,1226211658,2022-03-22 00:31:03,2022-03-22 00:50:52,Y,Y,A2,,,11,,,,,,,,,,,,,,,,,,,,,,,,,,,,,,,,,10,,,,,,,,,,,,,,,,,,,,,,,,,,,,,,,,,1,5.0,5.0,5.0,5.0,5.0,5.0,7.0,6.0,5.0,5.0,5.0,6.0,5.0,5.0,3.0,6.0,5.0,6.0,5.0,5.0,5.0,5.0,1.0,6.0,5.0,5.0,2.0,6.0,5.0,5.0,5.0,3.0,3,,,,,,,,,,,,,,,,,,,,,,,,,,,,,,,,,7,,,,,,,,,,,,,,,,,,,,,,,,,,,,,,,,,2,5.0,5.0,5.0,5.0,6.0,2.0,7.0,5.0,5.0,5.0,5.0,2.0,5.0,3.0,5.0,1.0,5.0,3.0,6.0,5.0,5.0,5.0,5.0,5.0,6.0,2.0,5.0,5.0,6.0,5.0,5.0,6.0,13,,,,,,,,,,,,,,,,,,,,,,,,,,,,,,,,,12,,,,,,,,,,,,,,,,,,,,,,,,,,,,,,,,,6,,,,,,,,,,,,,,,,,,,,,,,,,,,,,,,,,14,,,,,,,,,,,,,,,,,,,,,,,,,,,,,,,,,5,,,,,,,,,,,,,,,,,,,,,,,,,,,,,,,,,9,,,,,,,,,,,,,,,,,,,,,,,,,,,,,,,,,0,2.0,6.0,2.0,2.0,2.0,1.0,7.0,2.0,2.0,2.0,2.0,2.0,2.0,1.0,2.0,2.0,2.0,2.0,2.0,2.0,2.0,2.0,1.0,2.0,2.0,1.0,2.0,3.0,2.0,2.0,2.0,6.0,8,,,,,,,,,,,,,,,,,,,,,,,,,,,,,,,,,4,,,,,,,,,,,,,,,,,,,,,,,,,,,,,,,,,,1192.8,43.84,,,,11.07,,194.41,,,,,,,,464.81,,,,,,,,,135.94,,,,,,,,,,,,,,,,,,,,,339.11,,,,,,,,,3.62,,APPROVED,Male,29.0,FALSE
516,2022-03-22 00:37:46,19,en,243926868,2022-03-22 00:31:05,2022-03-22 00:37:46,Y,Y,A1,,,14,,,,,,,,,,,,,,,,,,,,,,,,,,,,,,,,,12,,,,,,,,,,,,,,,,,,,,,,,,,,,,,,,,,4,,,,,,,,,,,,,,,,,,,,,,,,,,,,,,,,,10,,,,,,,,,,,,,,,,,,,,,,,,,,,,,,,,,13,,,,,,,,,,,,,,,,,,,,,,,,,,,,,,,,,6,,,,,,,,,,,,,,,,,,,,,,,,,,,,,,,,,7,,,,,,,,,,,,,,,,,,,,,,,,,,,,,,,,,11,,,,,,,,,,,,,,,,,,,,,,,,,,,,,,,,,5,,,,,,,,,,,,,,,,,,,,,,,,,,,,,,,,,1,1.0,1.0,1.0,1.0,1.0,1.0,7.0,2.0,2.0,1.0,1.0,4.0,1.0,2.0,3.0,1.0,5.0,1.0,1.0,1.0,2.0,1.0,1.0,1.0,2.0,1.0,3.0,1.0,2.0,1.0,2.0,3.0,9,,,,,,,,,,,,,,,,,,,,,,,,,,,,,,,,,2,5.0,7.0,5.0,6.0,6.0,7.0,2.0,7.0,7.0,6.0,6.0,6.0,6.0,6.0,6.0,6.0,7.0,5.0,6.0,7.0,5.0,7.0,4.0,6.0,7.0,4.0,2.0,7.0,6.0,5.0,7.0,5.0,3,,,,,,,,,,,,,,,,,,,,,,,,,,,,,,,,,8,,,,,,,,,,,,,,,,,,,,,,,,,,,,,,,,,0,3.0,6.0,3.0,2.0,3.0,2.0,7.0,3.0,6.0,2.0,2.0,5.0,4.0,2.0,5.0,2.0,5.0,3.0,3.0,2.0,4.0,4.0,1.0,3.0,3.0,3.0,5.0,4.0,4.0,2.0,2.0,1.0,,404.32,33.74,,,,36.54,,40.46,,,,,,,,,,,,,,,,,,,,,,,,,,,,,88.5,,,,,,76.39,,,,,,,,,125.45,,,3.24,,APPROVED,Male,21.0,FALSE
517,2022-03-22 00:38:18,19,en,1976274952,2022-03-22 00:31:05,2022-03-22 00:38:18,Y,Y,A1,,,8,,,,,,,,,,,,,,,,,,,,,,,,,,,,,,,,,1,4.0,3.0,4.0,5.0,4.0,5.0,5.0,6.0,2.0,4.0,4.0,5.0,4.0,4.0,4.0,4.0,5.0,4.0,4.0,4.0,4.0,5.0,5.0,4.0,5.0,5.0,3.0,4.0,4.0,5.0,4.0,2.0,10,,,,,,,,,,,,,,,,,,,,,,,,,,,,,,,,,13,,,,,,,,,,,,,,,,,,,,,,,,,,,,,,,,,2,4.0,3.0,3.0,4.0,3.0,2.0,6.0,3.0,4.0,4.0,3.0,3.0,3.0,3.0,4.0,3.0,3.0,4.0,4.0,4.0,4.0,4.0,2.0,4.0,4.0,3.0,4.0,4.0,4.0,3.0,2.0,5.0,5,,,,,,,,,,,,,,,,,,,,,,,,,,,,,,,,,3,,,,,,,,,,,,,,,,,,,,,,,,,,,,,,,,,6,,,,,,,,,,,,,,,,,,,,,,,,,,,,,,,,,11,,,,,,,,,,,,,,,,,,,,,,,,,,,,,,,,,14,,,,,,,,,,,,,,,,,,,,,,,,,,,,,,,,,12,,,,,,,,,,,,,,,,,,,,,,,,,,,,,,,,,9,,,,,,,,,,,,,,,,,,,,,,,,,,,,,,,,,0,5.0,5.0,5.0,5.0,5.0,2.0,6.0,4.0,5.0,4.0,3.0,4.0,5.0,4.0,5.0,4.0,5.0,4.0,4.0,4.0,4.0,5.0,4.0,5.0,5.0,5.0,4.0,5.0,3.0,5.0,5.0,6.0,4,,,,,,,,,,,,,,,,,,,,,,,,,,,,,,,,,7,,,,,,,,,,,,,,,,,,,,,,,,,,,,,,,,,,435.55,226.04,,,,7.02,,23.88,,,,,56.19,,,,,,,,,48.91,,,,,,,,,,,,,,,,,,,,,,,,70.24,,,,,,,,,3.27,,APPROVED,Female,27.0,FALSE
518,2022-03-22 00:41:58,19,en,1903805635,2022-03-22 00:31:05,2022-03-22 00:41:58,Y,Y,A1,,,12,,,,,,,,,,,,,,,,,,,,,,,,,,,,,,,,,10,,,,,,,,,,,,,,,,,,,,,,,,,,,,,,,,,1,7.0,5.0,5.0,7.0,5.0,7.0,1.0,7.0,5.0,5.0,5.0,5.0,5.0,4.0,5.0,5.0,4.0,4.0,5.0,6.0,2.0,5.0,7.0,6.0,5.0,7.0,4.0,4.0,6.0,6.0,6.0,3.0,4,,,,,,,,,,,,,,,,,,,,,,,,,,,,,,,,,9,,,,,,,,,,,,,,,,,,,,,,,,,,,,,,,,,3,,,,,,,,,,,,,,,,,,,,,,,,,,,,,,,,,0,2.0,6.0,1.0,5.0,1.0,7.0,6.0,7.0,5.0,1.0,1.0,1.0,1.0,1.0,1.0,4.0,2.0,1.0,1.0,1.0,1.0,1.0,6.0,1.0,2.0,4.0,3.0,1.0,4.0,1.0,7.0,7.0,13,,,,,,,,,,,,,,,,,,,,,,,,,,,,,,,,,11,,,,,,,,,,,,,,,,,,,,,,,,,,,,,,,,,6,,,,,,,,,,,,,,,,,,,,,,,,,,,,,,,,,2,7.0,7.0,4.0,4.0,7.0,6.0,7.0,7.0,7.0,6.0,4.0,7.0,7.0,7.0,7.0,5.0,7.0,7.0,7.0,7.0,7.0,7.0,6.0,7.0,7.0,4.0,7.0,7.0,4.0,7.0,7.0,4.0,8,,,,,,,,,,,,,,,,,,,,,,,,,,,,,,,,,7,,,,,,,,,,,,,,,,,,,,,,,,,,,,,,,,,14,,,,,,,,,,,,,,,,,,,,,,,,,,,,,,,,,5,,,,,,,,,,,,,,,,,,,,,,,,,,,,,,,,,,656.31,41.34,,,,30.28,,59.81,,,,,,,,181.68,,,,,,,,,,,,184.3,,,,,,,,,,,,154.86,,,,,,,,,,,,,,,4.04,,APPROVED,Female,22.0,FALSE
519,2022-03-22 00:38:21,19,en,1768324705,2022-03-22 00:31:06,2022-03-22 00:38:21,Y,Y,A1,,,1,1.0,6.0,3.0,2.0,5.0,1.0,7.0,6.0,6.0,1.0,2.0,1.0,2.0,1.0,6.0,1.0,6.0,1.0,2.0,2.0,1.0,1.0,2.0,1.0,5.0,1.0,7.0,2.0,2.0,2.0,2.0,1.0,0,6.0,2.0,5.0,7.0,6.0,7.0,1.0,7.0,2.0,5.0,6.0,3.0,6.0,2.0,3.0,7.0,3.0,2.0,6.0,6.0,4.0,6.0,7.0,6.0,6.0,7.0,2.0,6.0,2.0,6.0,6.0,2.0,3,,,,,,,,,,,,,,,,,,,,,,,,,,,,,,,,,13,,,,,,,,,,,,,,,,,,,,,,,,,,,,,,,,,14,,,,,,,,,,,,,,,,,,,,,,,,,,,,,,,,,9,,,,,,,,,,,,,,,,,,,,,,,,,,,,,,,,,6,,,,,,,,,,,,,,,,,,,,,,,,,,,,,,,,,8,,,,,,,,,,,,,,,,,,,,,,,,,,,,,,,,,10,,,,,,,,,,,,,,,,,,,,,,,,,,,,,,,,,12,,,,,,,,,,,,,,,,,,,,,,,,,,,,,,,,,11,,,,,,,,,,,,,,,,,,,,,,,,,,,,,,,,,2,6.0,7.0,6.0,5.0,6.0,2.0,6.0,7.0,6.0,5.0,3.0,1.0,6.0,4.0,6.0,5.0,6.0,6.0,5.0,6.0,1.0,5.0,2.0,6.0,6.0,5.0,5.0,5.0,7.0,6.0,1.0,5.0,5,,,,,,,,,,,,,,,,,,,,,,,,,,,,,,,,,4,,,,,,,,,,,,,,,,,,,,,,,,,,,,,,,,,7,,,,,,,,,,,,,,,,,,,,,,,,,,,,,,,,,,394.14,31.59,,,,6.04,,3.68,,106.46,,,117.84,,,,,,,,,,,,,,,,,,,,,,,,,,,,,,124.37,,,,,,,,,,,,4.16,,APPROVED,Male,26.0,FALSE
520,2022-03-22 00:48:27,19,en,1832642848,2022-03-22 00:31:06,2022-03-22 00:48:27,Y,Y,A1,,,2,4.0,5.0,4.0,4.0,2.0,2.0,4.0,5.0,5.0,1.0,2.0,4.0,1.0,2.0,3.0,4.0,3.0,1.0,3.0,2.0,1.0,2.0,4.0,1.0,1.0,4.0,1.0,1.0,2.0,1.0,4.0,1.0,9,,,,,,,,,,,,,,,,,,,,,,,,,,,,,,,,,3,,,,,,,,,,,,,,,,,,,,,,,,,,,,,,,,,5,,,,,,,,,,,,,,,,,,,,,,,,,,,,,,,,,4,,,,,,,,,,,,,,,,,,,,,,,,,,,,,,,,,11,,,,,,,,,,,,,,,,,,,,,,,,,,,,,,,,,8,,,,,,,,,,,,,,,,,,,,,,,,,,,,,,,,,14,,,,,,,,,,,,,,,,,,,,,,,,,,,,,,,,,12,,,,,,,,,,,,,,,,,,,,,,,,,,,,,,,,,2,1.0,7.0,1.0,2.0,2.0,1.0,4.0,1.0,1.0,1.0,1.0,2.0,4.0,5.0,4.0,1.0,7.0,1.0,3.0,1.0,1.0,1.0,2.0,1.0,3.0,1.0,5.0,1.0,1.0,1.0,1.0,3.0,13,,,,,,,,,,,,,,,,,,,,,,,,,,,,,,,,,7,,,,,,,,,,,,,,,,,,,,,,,,,,,,,,,,,6,,,,,,,,,,,,,,,,,,,,,,,,,,,,,,,,,10,,,,,,,,,,,,,,,,,,,,,,,,,,,,,,,,,2,1.0,3.0,1.0,1.0,1.0,1.0,1.0,1.0,1.0,1.0,1.0,1.0,1.0,1.0,1.0,1.0,2.0,1.0,1.0,1.0,1.0,1.0,1.0,1.0,1.0,1.0,1.0,1.0,1.0,1.0,1.0,1.0,I wish there was a better design for these charts in the professional realm,1411.57,89.62,,,,22.86,,781.97,,150.14,,,,,,,,,,,,,,,,,,,,,,,,,,,184.39,,,,,,,,,,,,,,,149.18,,,33.41,,APPROVED,Female,21.0,FALSE
522,2022-03-22 00:46:25,19,en,1069314198,2022-03-22 00:31:09,2022-03-22 00:46:25,Y,Y,-oth-,national certificate,,1,3.0,5.0,4.0,4.0,4.0,3.0,6.0,3.0,5.0,2.0,3.0,3.0,4.0,2.0,5.0,2.0,5.0,3.0,3.0,2.0,3.0,3.0,2.0,3.0,3.0,5.0,2.0,2.0,2.0,3.0,4.0,1.0,14,,,,,,,,,,,,,,,,,,,,,,,,,,,,,,,,,11,,,,,,,,,,,,,,,,,,,,,,,,,,,,,,,,,7,,,,,,,,,,,,,,,,,,,,,,,,,,,,,,,,,2,5.0,4.0,5.0,5.0,4.0,5.0,5.0,5.0,4.0,4.0,4.0,6.0,5.0,5.0,6.0,5.0,6.0,6.0,5.0,4.0,4.0,5.0,3.0,4.0,5.0,6.0,2.0,6.0,5.0,4.0,5.0,5.0,10,,,,,,,,,,,,,,,,,,,,,,,,,,,,,,,,,12,,,,,,,,,,,,,,,,,,,,,,,,,,,,,,,,,9,,,,,,,,,,,,,,,,,,,,,,,,,,,,,,,,,4,,,,,,,,,,,,,,,,,,,,,,,,,,,,,,,,,6,,,,,,,,,,,,,,,,,,,,,,,,,,,,,,,,,13,,,,,,,,,,,,,,,,,,,,,,,,,,,,,,,,,8,,,,,,,,,,,,,,,,,,,,,,,,,,,,,,,,,3,,,,,,,,,,,,,,,,,,,,,,,,,,,,,,,,,5,,,,,,,,,,,,,,,,,,,,,,,,,,,,,,,,,0,3.0,5.0,2.0,5.0,3.0,5.0,5.0,4.0,5.0,3.0,4.0,5.0,2.0,5.0,5.0,2.0,2.0,2.0,3.0,3.0,4.0,4.0,2.0,3.0,3.0,2.0,4.0,3.0,3.0,4.0,4.0,1.0,"it was unorthodox 
",919.05,56.97,,,,65.62,,56.45,,80.15,,,,,,,,,,,,95.46,,,,,,,,,,,,,,,,,,,,,,,,,,,,,,532.18,,,32.22,,APPROVED,Male,19.0,FALSE
523,2022-03-22 00:42:18,19,en,1416316517,2022-03-22 00:31:10,2022-03-22 00:42:18,Y,Y,-oth-,High school diploma,,4,,,,,,,,,,,,,,,,,,,,,,,,,,,,,,,,,11,,,,,,,,,,,,,,,,,,,,,,,,,,,,,,,,,9,,,,,,,,,,,,,,,,,,,,,,,,,,,,,,,,,2,6.0,6.0,6.0,4.0,6.0,5.0,5.0,6.0,6.0,4.0,7.0,4.0,5.0,6.0,6.0,4.0,7.0,6.0,6.0,5.0,4.0,6.0,4.0,6.0,7.0,6.0,1.0,5.0,5.0,4.0,5.0,4.0,12,,,,,,,,,,,,,,,,,,,,,,,,,,,,,,,,,1,4.0,5.0,5.0,5.0,5.0,1.0,7.0,7.0,2.0,2.0,2.0,5.0,3.0,5.0,5.0,4.0,6.0,5.0,5.0,3.0,3.0,5.0,3.0,4.0,6.0,5.0,1.0,4.0,1.0,4.0,4.0,6.0,13,,,,,,,,,,,,,,,,,,,,,,,,,,,,,,,,,0,4.0,5.0,2.0,2.0,2.0,1.0,6.0,1.0,6.0,1.0,1.0,5.0,5.0,6.0,6.0,2.0,7.0,5.0,1.0,3.0,1.0,4.0,3.0,3.0,2.0,3.0,4.0,1.0,1.0,3.0,2.0,1.0,3,,,,,,,,,,,,,,,,,,,,,,,,,,,,,,,,,10,,,,,,,,,,,,,,,,,,,,,,,,,,,,,,,,,6,,,,,,,,,,,,,,,,,,,,,,,,,,,,,,,,,8,,,,,,,,,,,,,,,,,,,,,,,,,,,,,,,,,5,,,,,,,,,,,,,,,,,,,,,,,,,,,,,,,,,14,,,,,,,,,,,,,,,,,,,,,,,,,,,,,,,,,7,,,,,,,,,,,,,,,,,,,,,,,,,,,,,,,,,,672.51,31.75,,,,24.74,,20.49,,,,,,,,,,,340.73,,,,,,123.63,,,,,,114.9,,,,,,,,,,,,,,,,,,,,,,,,16.27,,APPROVED,Male,30.0,FALSE
524,2022-03-22 00:34:46,19,en,121152447,2022-03-22 00:31:13,2022-03-22 00:34:46,Y,Y,A1,,,9,,,,,,,,,,,,,,,,,,,,,,,,,,,,,,,,,0,6.0,5.0,6.0,5.0,6.0,6.0,2.0,6.0,6.0,7.0,6.0,6.0,5.0,6.0,6.0,5.0,6.0,6.0,6.0,6.0,7.0,6.0,5.0,6.0,7.0,6.0,6.0,6.0,6.0,2.0,5.0,2.0,14,,,,,,,,,,,,,,,,,,,,,,,,,,,,,,,,,6,,,,,,,,,,,,,,,,,,,,,,,,,,,,,,,,,12,,,,,,,,,,,,,,,,,,,,,,,,,,,,,,,,,1,2.0,3.0,2.0,1.0,1.0,2.0,2.0,1.0,2.0,1.0,2.0,3.0,1.0,1.0,2.0,2.0,2.0,2.0,2.0,1.0,2.0,2.0,2.0,2.0,3.0,2.0,2.0,2.0,2.0,2.0,3.0,6.0,8,,,,,,,,,,,,,,,,,,,,,,,,,,,,,,,,,4,,,,,,,,,,,,,,,,,,,,,,,,,,,,,,,,,2,3.0,3.0,2.0,3.0,3.0,3.0,3.0,3.0,4.0,3.0,3.0,4.0,3.0,4.0,3.0,3.0,3.0,3.0,3.0,4.0,2.0,3.0,3.0,3.0,3.0,3.0,3.0,4.0,2.0,4.0,3.0,2.0,10,,,,,,,,,,,,,,,,,,,,,,,,,,,,,,,,,11,,,,,,,,,,,,,,,,,,,,,,,,,,,,,,,,,13,,,,,,,,,,,,,,,,,,,,,,,,,,,,,,,,,3,,,,,,,,,,,,,,,,,,,,,,,,,,,,,,,,,7,,,,,,,,,,,,,,,,,,,,,,,,,,,,,,,,,5,,,,,,,,,,,,,,,,,,,,,,,,,,,,,,,,,,216.41,17.41,,,,4.19,,46.12,,,,,64.88,,,,,,,,,,,,39.24,,,,,,,,,40.88,,,,,,,,,,,,,,,,,,,,,3.69,,APPROVED,Male,23.0,FALSE
525,2022-03-22 00:36:45,19,en,612751265,2022-03-22 00:31:13,2022-03-22 00:36:45,Y,Y,A1,,,0,6.0,6.0,6.0,6.0,4.0,4.0,4.0,6.0,6.0,5.0,3.0,5.0,5.0,5.0,4.0,6.0,6.0,5.0,5.0,4.0,4.0,5.0,3.0,6.0,5.0,4.0,4.0,5.0,4.0,6.0,5.0,1.0,3,,,,,,,,,,,,,,,,,,,,,,,,,,,,,,,,,4,,,,,,,,,,,,,,,,,,,,,,,,,,,,,,,,,11,,,,,,,,,,,,,,,,,,,,,,,,,,,,,,,,,5,,,,,,,,,,,,,,,,,,,,,,,,,,,,,,,,,1,6.0,6.0,5.0,4.0,5.0,5.0,4.0,5.0,6.0,5.0,4.0,6.0,6.0,5.0,5.0,5.0,6.0,5.0,6.0,5.0,4.0,6.0,4.0,6.0,6.0,5.0,4.0,6.0,5.0,5.0,5.0,6.0,14,,,,,,,,,,,,,,,,,,,,,,,,,,,,,,,,,2,3.0,3.0,3.0,4.0,3.0,3.0,6.0,5.0,4.0,2.0,2.0,3.0,3.0,2.0,3.0,4.0,3.0,3.0,4.0,3.0,3.0,4.0,4.0,3.0,2.0,4.0,2.0,3.0,2.0,3.0,3.0,1.0,9,,,,,,,,,,,,,,,,,,,,,,,,,,,,,,,,,10,,,,,,,,,,,,,,,,,,,,,,,,,,,,,,,,,6,,,,,,,,,,,,,,,,,,,,,,,,,,,,,,,,,8,,,,,,,,,,,,,,,,,,,,,,,,,,,,,,,,,13,,,,,,,,,,,,,,,,,,,,,,,,,,,,,,,,,7,,,,,,,,,,,,,,,,,,,,,,,,,,,,,,,,,12,,,,,,,,,,,,,,,,,,,,,,,,,,,,,,,,,,333.87,25.25,,,,7.53,,34.06,,113.94,,,,,,,,,,,,,,,71.46,,,,,,79.17,,,,,,,,,,,,,,,,,,,,,,,,2.46,,APPROVED,Female,21.0,FALSE
527,2022-03-22 00:39:15,19,en,1987978463,2022-03-22 00:31:14,2022-03-22 00:39:15,Y,Y,A1,,,4,,,,,,,,,,,,,,,,,,,,,,,,,,,,,,,,,13,,,,,,,,,,,,,,,,,,,,,,,,,,,,,,,,,10,,,,,,,,,,,,,,,,,,,,,,,,,,,,,,,,,6,,,,,,,,,,,,,,,,,,,,,,,,,,,,,,,,,5,,,,,,,,,,,,,,,,,,,,,,,,,,,,,,,,,2,5.0,7.0,6.0,3.0,4.0,2.0,7.0,5.0,6.0,4.0,2.0,6.0,4.0,6.0,4.0,2.0,6.0,4.0,5.0,3.0,5.0,4.0,2.0,4.0,5.0,2.0,6.0,3.0,3.0,3.0,2.0,6.0,1,1.0,1.0,1.0,1.0,1.0,1.0,1.0,1.0,4.0,1.0,1.0,1.0,1.0,1.0,1.0,1.0,1.0,1.0,1.0,1.0,1.0,1.0,1.0,1.0,1.0,1.0,1.0,1.0,1.0,1.0,1.0,7.0,3,,,,,,,,,,,,,,,,,,,,,,,,,,,,,,,,,12,,,,,,,,,,,,,,,,,,,,,,,,,,,,,,,,,14,,,,,,,,,,,,,,,,,,,,,,,,,,,,,,,,,11,,,,,,,,,,,,,,,,,,,,,,,,,,,,,,,,,0,3.0,6.0,4.0,3.0,4.0,3.0,3.0,2.0,6.0,4.0,2.0,5.0,3.0,5.0,5.0,3.0,6.0,3.0,2.0,3.0,3.0,5.0,2.0,3.0,5.0,2.0,6.0,3.0,2.0,4.0,4.0,5.0,8,,,,,,,,,,,,,,,,,,,,,,,,,,,,,,,,,9,,,,,,,,,,,,,,,,,,,,,,,,,,,,,,,,,7,,,,,,,,,,,,,,,,,,,,,,,,,,,,,,,,,I didn't really like any of the images,484.5,215.79,,,,6.5,,31.07,,,,,,,,,,,,,,,,,84.61,,,40.66,,,,,,,,,,,,,,,83.41,,,,,,,,,,,,22.46,,APPROVED,Male,23.0,FALSE
528,2022-03-22 00:38:41,19,en,439739484,2022-03-22 00:31:28,2022-03-22 00:38:41,Y,Y,A1,,,3,,,,,,,,,,,,,,,,,,,,,,,,,,,,,,,,,6,,,,,,,,,,,,,,,,,,,,,,,,,,,,,,,,,11,,,,,,,,,,,,,,,,,,,,,,,,,,,,,,,,,4,,,,,,,,,,,,,,,,,,,,,,,,,,,,,,,,,9,,,,,,,,,,,,,,,,,,,,,,,,,,,,,,,,,14,,,,,,,,,,,,,,,,,,,,,,,,,,,,,,,,,0,1.0,6.0,3.0,1.0,6.0,2.0,1.0,1.0,5.0,3.0,3.0,3.0,3.0,5.0,4.0,5.0,7.0,4.0,5.0,4.0,4.0,6.0,1.0,2.0,1.0,4.0,3.0,3.0,2.0,2.0,6.0,7.0,7,,,,,,,,,,,,,,,,,,,,,,,,,,,,,,,,,10,,,,,,,,,,,,,,,,,,,,,,,,,,,,,,,,,8,,,,,,,,,,,,,,,,,,,,,,,,,,,,,,,,,2,2.0,6.0,1.0,6.0,5.0,6.0,6.0,7.0,2.0,3.0,2.0,5.0,5.0,6.0,5.0,7.0,6.0,3.0,6.0,6.0,2.0,6.0,5.0,6.0,4.0,5.0,5.0,7.0,5.0,1.0,7.0,4.0,1,3.0,5.0,6.0,3.0,4.0,3.0,5.0,7.0,4.0,4.0,3.0,1.0,5.0,3.0,2.0,4.0,2.0,6.0,6.0,5.0,4.0,6.0,2.0,3.0,5.0,1.0,1.0,7.0,4.0,2.0,2.0,5.0,5,,,,,,,,,,,,,,,,,,,,,,,,,,,,,,,,,12,,,,,,,,,,,,,,,,,,,,,,,,,,,,,,,,,13,,,,,,,,,,,,,,,,,,,,,,,,,,,,,,,,,,436.37,14.33,,,,5.39,,45.93,,,,,,,,,,,,,,,,,,,,225.95,,,,,,,,,,,,65.64,,,75.28,,,,,,,,,,,,3.85,,APPROVED,Female,24.0,FALSE
529,2022-03-22 00:36:51,19,en,111394991,2022-03-22 00:31:46,2022-03-22 00:36:51,Y,Y,A2,,,2,5.0,7.0,6.0,6.0,6.0,5.0,4.0,7.0,6.0,5.0,4.0,5.0,6.0,6.0,6.0,6.0,6.0,6.0,6.0,6.0,5.0,6.0,6.0,4.0,6.0,6.0,5.0,6.0,6.0,6.0,7.0,1.0,5,,,,,,,,,,,,,,,,,,,,,,,,,,,,,,,,,8,,,,,,,,,,,,,,,,,,,,,,,,,,,,,,,,,7,,,,,,,,,,,,,,,,,,,,,,,,,,,,,,,,,12,,,,,,,,,,,,,,,,,,,,,,,,,,,,,,,,,10,,,,,,,,,,,,,,,,,,,,,,,,,,,,,,,,,1,5.0,6.0,6.0,5.0,6.0,5.0,5.0,5.0,6.0,6.0,3.0,5.0,5.0,6.0,6.0,6.0,6.0,6.0,6.0,5.0,4.0,6.0,3.0,4.0,6.0,6.0,5.0,5.0,5.0,5.0,6.0,7.0,14,,,,,,,,,,,,,,,,,,,,,,,,,,,,,,,,,13,,,,,,,,,,,,,,,,,,,,,,,,,,,,,,,,,9,,,,,,,,,,,,,,,,,,,,,,,,,,,,,,,,,0,5.0,6.0,6.0,5.0,5.0,6.0,5.0,6.0,6.0,5.0,5.0,5.0,6.0,5.0,6.0,5.0,5.0,5.0,5.0,5.0,5.0,6.0,3.0,4.0,6.0,6.0,3.0,5.0,5.0,5.0,6.0,4.0,6,,,,,,,,,,,,,,,,,,,,,,,,,,,,,,,,,4,,,,,,,,,,,,,,,,,,,,,,,,,,,,,,,,,3,,,,,,,,,,,,,,,,,,,,,,,,,,,,,,,,,11,,,,,,,,,,,,,,,,,,,,,,,,,,,,,,,,,,309.47,32.54,,,,73.71,,33.29,,74.68,,,,,,,,,,,,,,,,,,38.66,,,,,,,,,,,,53.71,,,,,,,,,,,,,,,2.88,,APPROVED,Male,26.0,FALSE
531,2022-03-22 00:41:37,19,en,1831625192,2022-03-22 00:34:09,2022-03-22 00:41:37,Y,Y,A1,,,4,,,,,,,,,,,,,,,,,,,,,,,,,,,,,,,,,9,,,,,,,,,,,,,,,,,,,,,,,,,,,,,,,,,11,,,,,,,,,,,,,,,,,,,,,,,,,,,,,,,,,10,,,,,,,,,,,,,,,,,,,,,,,,,,,,,,,,,14,,,,,,,,,,,,,,,,,,,,,,,,,,,,,,,,,0,5.0,6.0,6.0,4.0,5.0,4.0,4.0,6.0,7.0,6.0,6.0,5.0,6.0,5.0,5.0,6.0,6.0,6.0,5.0,6.0,4.0,6.0,4.0,6.0,7.0,3.0,6.0,5.0,4.0,6.0,4.0,6.0,6,,,,,,,,,,,,,,,,,,,,,,,,,,,,,,,,,13,,,,,,,,,,,,,,,,,,,,,,,,,,,,,,,,,7,,,,,,,,,,,,,,,,,,,,,,,,,,,,,,,,,12,,,,,,,,,,,,,,,,,,,,,,,,,,,,,,,,,8,,,,,,,,,,,,,,,,,,,,,,,,,,,,,,,,,3,,,,,,,,,,,,,,,,,,,,,,,,,,,,,,,,,5,,,,,,,,,,,,,,,,,,,,,,,,,,,,,,,,,2,4.0,5.0,4.0,5.0,4.0,5.0,2.0,6.0,7.0,3.0,3.0,6.0,4.0,5.0,7.0,5.0,6.0,4.0,4.0,3.0,4.0,6.0,6.0,4.0,5.0,4.0,7.0,4.0,5.0,4.0,6.0,7.0,1,2.0,4.0,2.0,2.0,3.0,3.0,5.0,1.0,2.0,2.0,2.0,3.0,3.0,2.0,3.0,2.0,5.0,2.0,3.0,2.0,2.0,3.0,2.0,2.0,3.0,2.0,4.0,2.0,3.0,4.0,2.0,1.0,Thank you for this colorful survey. :),451.11,43.62,,,,11.08,,33.74,,,,,,,,,,,,,,,,,98.07,,,,,,,,,,,,,,,,,,,,,,,,127.7,,,91.69,,,45.21,,APPROVED,Female,30.0,FALSE
532,2022-03-22 00:40:48,19,en,1114648598,2022-03-22 00:35:00,2022-03-22 00:40:48,Y,Y,A1,,,11,,,,,,,,,,,,,,,,,,,,,,,,,,,,,,,,,12,,,,,,,,,,,,,,,,,,,,,,,,,,,,,,,,,6,,,,,,,,,,,,,,,,,,,,,,,,,,,,,,,,,13,,,,,,,,,,,,,,,,,,,,,,,,,,,,,,,,,0,4.0,5.0,5.0,6.0,3.0,5.0,2.0,6.0,5.0,3.0,4.0,5.0,2.0,3.0,3.0,6.0,4.0,4.0,4.0,3.0,4.0,6.0,6.0,4.0,3.0,6.0,4.0,5.0,3.0,5.0,4.0,5.0,3,,,,,,,,,,,,,,,,,,,,,,,,,,,,,,,,,1,1.0,1.0,1.0,3.0,1.0,2.0,7.0,5.0,3.0,1.0,1.0,2.0,2.0,1.0,2.0,4.0,3.0,1.0,1.0,1.0,2.0,1.0,1.0,1.0,2.0,2.0,1.0,1.0,2.0,1.0,2.0,7.0,9,,,,,,,,,,,,,,,,,,,,,,,,,,,,,,,,,10,,,,,,,,,,,,,,,,,,,,,,,,,,,,,,,,,7,,,,,,,,,,,,,,,,,,,,,,,,,,,,,,,,,5,,,,,,,,,,,,,,,,,,,,,,,,,,,,,,,,,2,2.0,5.0,5.0,5.0,6.0,5.0,5.0,6.0,6.0,3.0,2.0,1.0,5.0,2.0,3.0,5.0,2.0,2.0,4.0,3.0,2.0,4.0,2.0,6.0,6.0,4.0,1.0,5.0,2.0,3.0,3.0,5.0,4,,,,,,,,,,,,,,,,,,,,,,,,,,,,,,,,,8,,,,,,,,,,,,,,,,,,,,,,,,,,,,,,,,,14,,,,,,,,,,,,,,,,,,,,,,,,,,,,,,,,,,351.89,49.53,,,,8.17,,36.27,,,,,,,,,,,,,,86.88,,,,,,85.84,,,,,,,,,,,,,,,81.47,,,,,,,,,,,,3.73,,APPROVED,Female,20.0,FALSE
533,2022-03-22 00:40:19,19,en,2106004954,2022-03-22 00:35:41,2022-03-22 00:40:19,Y,Y,A1,,,13,,,,,,,,,,,,,,,,,,,,,,,,,,,,,,,,,8,,,,,,,,,,,,,,,,,,,,,,,,,,,,,,,,,9,,,,,,,,,,,,,,,,,,,,,,,,,,,,,,,,,4,,,,,,,,,,,,,,,,,,,,,,,,,,,,,,,,,6,,,,,,,,,,,,,,,,,,,,,,,,,,,,,,,,,1,6.0,5.0,5.0,6.0,6.0,5.0,5.0,5.0,5.0,5.0,5.0,5.0,5.0,6.0,6.0,5.0,6.0,5.0,5.0,5.0,6.0,5.0,4.0,6.0,6.0,5.0,3.0,5.0,6.0,5.0,6.0,6.0,2,5.0,5.0,5.0,5.0,5.0,5.0,4.0,6.0,5.0,5.0,5.0,5.0,6.0,5.0,5.0,6.0,5.0,5.0,5.0,5.0,5.0,5.0,6.0,5.0,5.0,5.0,5.0,5.0,5.0,5.0,5.0,7.0,10,,,,,,,,,,,,,,,,,,,,,,,,,,,,,,,,,14,,,,,,,,,,,,,,,,,,,,,,,,,,,,,,,,,7,,,,,,,,,,,,,,,,,,,,,,,,,,,,,,,,,3,,,,,,,,,,,,,,,,,,,,,,,,,,,,,,,,,5,,,,,,,,,,,,,,,,,,,,,,,,,,,,,,,,,12,,,,,,,,,,,,,,,,,,,,,,,,,,,,,,,,,11,,,,,,,,,,,,,,,,,,,,,,,,,,,,,,,,,0,3.0,2.0,2.0,4.0,2.0,3.0,2.0,4.0,4.0,3.0,2.0,3.0,4.0,3.0,4.0,2.0,4.0,4.0,2.0,4.0,2.0,2.0,2.0,4.0,2.0,4.0,4.0,3.0,2.0,2.0,4.0,1.0,,281.13,23.28,,,,6.69,,37.97,,,,,,,,,,,,,,,,,58.71,,,51.37,,,,,,,,,,,,,,,,,,,,,,,,92.85,,,10.26,,APPROVED,Male,32.0,FALSE
534,2022-03-22 00:46:45,19,en,1374479462,2022-03-22 00:36:48,2022-03-22 00:46:45,Y,Y,A1,,,1,5.0,6.0,5.0,3.0,5.0,5.0,3.0,7.0,6.0,5.0,5.0,5.0,6.0,5.0,5.0,6.0,5.0,5.0,5.0,5.0,6.0,5.0,2.0,5.0,5.0,3.0,4.0,5.0,3.0,5.0,5.0,1.0,4,,,,,,,,,,,,,,,,,,,,,,,,,,,,,,,,,12,,,,,,,,,,,,,,,,,,,,,,,,,,,,,,,,,3,,,,,,,,,,,,,,,,,,,,,,,,,,,,,,,,,9,,,,,,,,,,,,,,,,,,,,,,,,,,,,,,,,,14,,,,,,,,,,,,,,,,,,,,,,,,,,,,,,,,,10,,,,,,,,,,,,,,,,,,,,,,,,,,,,,,,,,8,,,,,,,,,,,,,,,,,,,,,,,,,,,,,,,,,0,2.0,2.0,2.0,2.0,2.0,2.0,2.0,1.0,3.0,2.0,2.0,2.0,3.0,3.0,2.0,2.0,3.0,2.0,2.0,2.0,2.0,2.0,2.0,2.0,2.0,3.0,2.0,2.0,2.0,2.0,2.0,2.0,6,,,,,,,,,,,,,,,,,,,,,,,,,,,,,,,,,7,,,,,,,,,,,,,,,,,,,,,,,,,,,,,,,,,5,,,,,,,,,,,,,,,,,,,,,,,,,,,,,,,,,2,4.0,4.0,4.0,3.0,4.0,3.0,3.0,5.0,3.0,4.0,3.0,3.0,4.0,3.0,3.0,3.0,5.0,4.0,3.0,3.0,3.0,3.0,3.0,3.0,3.0,2.0,3.0,3.0,3.0,3.0,2.0,6.0,13,,,,,,,,,,,,,,,,,,,,,,,,,,,,,,,,,11,,,,,,,,,,,,,,,,,,,,,,,,,,,,,,,,,,600.56,14.06,,,,4.96,,16.58,,115.71,,,,,,,,,,,,,,,,,,,,,,,,108.5,,,,,,,,,,,,321.73,,,,,,,,,19.02,,APPROVED,Male,22.0,FALSE
535,2022-03-22 00:42:56,19,en,1047960747,2022-03-22 00:37:03,2022-03-22 00:42:56,Y,Y,A1,,,14,,,,,,,,,,,,,,,,,,,,,,,,,,,,,,,,,9,,,,,,,,,,,,,,,,,,,,,,,,,,,,,,,,,7,,,,,,,,,,,,,,,,,,,,,,,,,,,,,,,,,1,6.0,6.0,6.0,7.0,6.0,2.0,3.0,7.0,7.0,6.0,6.0,6.0,6.0,5.0,7.0,7.0,7.0,6.0,6.0,4.0,6.0,6.0,6.0,6.0,6.0,7.0,5.0,6.0,7.0,6.0,7.0,4.0,12,,,,,,,,,,,,,,,,,,,,,,,,,,,,,,,,,4,,,,,,,,,,,,,,,,,,,,,,,,,,,,,,,,,10,,,,,,,,,,,,,,,,,,,,,,,,,,,,,,,,,8,,,,,,,,,,,,,,,,,,,,,,,,,,,,,,,,,2,1.0,3.0,1.0,3.0,1.0,1.0,6.0,2.0,1.0,2.0,1.0,1.0,1.0,1.0,1.0,2.0,3.0,1.0,1.0,2.0,1.0,2.0,4.0,1.0,1.0,4.0,2.0,1.0,2.0,2.0,2.0,2.0,6,,,,,,,,,,,,,,,,,,,,,,,,,,,,,,,,,13,,,,,,,,,,,,,,,,,,,,,,,,,,,,,,,,,5,,,,,,,,,,,,,,,,,,,,,,,,,,,,,,,,,0,6.0,6.0,6.0,5.0,3.0,1.0,5.0,4.0,7.0,4.0,6.0,3.0,7.0,5.0,5.0,3.0,7.0,4.0,6.0,1.0,5.0,6.0,4.0,3.0,3.0,4.0,4.0,7.0,7.0,4.0,6.0,6.0,11,,,,,,,,,,,,,,,,,,,,,,,,,,,,,,,,,3,,,,,,,,,,,,,,,,,,,,,,,,,,,,,,,,,,355.7,16.03,,,,8.91,,40.83,,,,,,,,,,,72.59,,,,,,,,,,,,,,,72.28,,,,,,,,,,,,142.01,,,,,,,,,3.05,,APPROVED,Male,20.0,FALSE
536,2022-03-22 00:43:42,19,en,1754254128,2022-03-22 00:38:37,2022-03-22 00:43:42,Y,Y,A1,,,1,5.0,6.0,6.0,3.0,5.0,2.0,4.0,5.0,5.0,5.0,5.0,5.0,5.0,4.0,5.0,5.0,6.0,3.0,3.0,3.0,3.0,4.0,5.0,3.0,5.0,1.0,6.0,5.0,5.0,3.0,5.0,1.0,6,,,,,,,,,,,,,,,,,,,,,,,,,,,,,,,,,11,,,,,,,,,,,,,,,,,,,,,,,,,,,,,,,,,14,,,,,,,,,,,,,,,,,,,,,,,,,,,,,,,,,0,5.0,3.0,5.0,3.0,2.0,3.0,5.0,5.0,4.0,3.0,3.0,6.0,3.0,3.0,3.0,5.0,5.0,3.0,4.0,3.0,5.0,3.0,4.0,3.0,2.0,6.0,5.0,3.0,6.0,5.0,6.0,5.0,13,,,,,,,,,,,,,,,,,,,,,,,,,,,,,,,,,4,,,,,,,,,,,,,,,,,,,,,,,,,,,,,,,,,2,5.0,3.0,3.0,2.0,3.0,4.0,3.0,2.0,2.0,3.0,3.0,3.0,3.0,3.0,3.0,4.0,3.0,3.0,2.0,3.0,5.0,2.0,5.0,3.0,3.0,5.0,5.0,4.0,2.0,3.0,5.0,1.0,12,,,,,,,,,,,,,,,,,,,,,,,,,,,,,,,,,5,,,,,,,,,,,,,,,,,,,,,,,,,,,,,,,,,7,,,,,,,,,,,,,,,,,,,,,,,,,,,,,,,,,3,,,,,,,,,,,,,,,,,,,,,,,,,,,,,,,,,9,,,,,,,,,,,,,,,,,,,,,,,,,,,,,,,,,8,,,,,,,,,,,,,,,,,,,,,,,,,,,,,,,,,10,,,,,,,,,,,,,,,,,,,,,,,,,,,,,,,,,,308.5,18.7,,,,6.53,,49.31,,69.13,,,,,,,,,,,,93.25,,,,,,,,,67.64,,,,,,,,,,,,,,,,,,,,,,,,3.94,,APPROVED,Male,36.0,FALSE
538,2022-03-22 00:43:00,19,en,1245663120,2022-03-22 00:38:41,2022-03-22 00:43:00,Y,Y,A2,,,5,,,,,,,,,,,,,,,,,,,,,,,,,,,,,,,,,7,,,,,,,,,,,,,,,,,,,,,,,,,,,,,,,,,8,,,,,,,,,,,,,,,,,,,,,,,,,,,,,,,,,3,,,,,,,,,,,,,,,,,,,,,,,,,,,,,,,,,1,3.0,2.0,3.0,5.0,1.0,2.0,6.0,4.0,1.0,3.0,5.0,5.0,2.0,3.0,3.0,2.0,4.0,4.0,4.0,3.0,4.0,2.0,5.0,2.0,2.0,6.0,2.0,4.0,7.0,4.0,3.0,5.0,11,,,,,,,,,,,,,,,,,,,,,,,,,,,,,,,,,0,6.0,7.0,6.0,4.0,6.0,3.0,4.0,5.0,7.0,5.0,5.0,6.0,6.0,5.0,6.0,4.0,6.0,5.0,6.0,5.0,5.0,6.0,4.0,6.0,6.0,4.0,2.0,6.0,4.0,6.0,5.0,7.0,6,,,,,,,,,,,,,,,,,,,,,,,,,,,,,,,,,2,4.0,4.0,3.0,2.0,5.0,2.0,5.0,3.0,6.0,3.0,2.0,4.0,5.0,3.0,5.0,4.0,6.0,4.0,2.0,4.0,3.0,5.0,4.0,5.0,5.0,3.0,2.0,3.0,4.0,5.0,2.0,2.0,12,,,,,,,,,,,,,,,,,,,,,,,,,,,,,,,,,14,,,,,,,,,,,,,,,,,,,,,,,,,,,,,,,,,10,,,,,,,,,,,,,,,,,,,,,,,,,,,,,,,,,9,,,,,,,,,,,,,,,,,,,,,,,,,,,,,,,,,4,,,,,,,,,,,,,,,,,,,,,,,,,,,,,,,,,13,,,,,,,,,,,,,,,,,,,,,,,,,,,,,,,,,,262.39,17.18,,,,4.44,,37.87,,,,,,,,,,,,,,68.13,,,,,,63.93,,,,,,67.6,,,,,,,,,,,,,,,,,,,,,3.24,,APPROVED,Male,26.0,FALSE
540,2022-03-22 00:43:38,19,en,1552644058,2022-03-22 00:38:43,2022-03-22 00:43:38,Y,Y,-oth-,student at university,,5,,,,,,,,,,,,,,,,,,,,,,,,,,,,,,,,,0,6.0,5.0,6.0,6.0,5.0,6.0,4.0,7.0,4.0,6.0,5.0,4.0,4.0,4.0,4.0,6.0,6.0,4.0,6.0,4.0,4.0,6.0,6.0,6.0,6.0,5.0,2.0,5.0,4.0,6.0,6.0,2.0,14,,,,,,,,,,,,,,,,,,,,,,,,,,,,,,,,,3,,,,,,,,,,,,,,,,,,,,,,,,,,,,,,,,,13,,,,,,,,,,,,,,,,,,,,,,,,,,,,,,,,,2,4.0,4.0,3.0,3.0,3.0,2.0,3.0,6.0,4.0,3.0,2.0,4.0,3.0,3.0,2.0,4.0,5.0,3.0,4.0,3.0,3.0,5.0,2.0,3.0,3.0,3.0,3.0,2.0,3.0,3.0,4.0,6.0,4,,,,,,,,,,,,,,,,,,,,,,,,,,,,,,,,,9,,,,,,,,,,,,,,,,,,,,,,,,,,,,,,,,,6,,,,,,,,,,,,,,,,,,,,,,,,,,,,,,,,,11,,,,,,,,,,,,,,,,,,,,,,,,,,,,,,,,,10,,,,,,,,,,,,,,,,,,,,,,,,,,,,,,,,,1,4.0,5.0,3.0,4.0,4.0,2.0,4.0,4.0,4.0,4.0,2.0,6.0,4.0,4.0,5.0,4.0,6.0,2.0,4.0,3.0,3.0,4.0,2.0,4.0,5.0,6.0,4.0,4.0,4.0,4.0,5.0,5.0,7,,,,,,,,,,,,,,,,,,,,,,,,,,,,,,,,,8,,,,,,,,,,,,,,,,,,,,,,,,,,,,,,,,,12,,,,,,,,,,,,,,,,,,,,,,,,,,,,,,,,,,300.57,10.75,,,,28.08,,46.76,,,,,62.62,,,,,,,,,,,,57.83,,,,,,,,,,,,,,,,,,91.39,,,,,,,,,,,,3.14,,APPROVED,Female,21.0,FALSE
541,2022-03-22 00:45:12,19,en,1754224235,2022-03-22 00:38:44,2022-03-22 00:45:12,Y,Y,A1,,,11,,,,,,,,,,,,,,,,,,,,,,,,,,,,,,,,,9,,,,,,,,,,,,,,,,,,,,,,,,,,,,,,,,,10,,,,,,,,,,,,,,,,,,,,,,,,,,,,,,,,,1,5.0,6.0,6.0,6.0,5.0,6.0,6.0,6.0,7.0,6.0,5.0,5.0,6.0,5.0,6.0,5.0,6.0,6.0,6.0,6.0,6.0,6.0,6.0,6.0,6.0,6.0,5.0,6.0,5.0,5.0,6.0,4.0,4,,,,,,,,,,,,,,,,,,,,,,,,,,,,,,,,,12,,,,,,,,,,,,,,,,,,,,,,,,,,,,,,,,,2,4.0,6.0,1.0,1.0,1.0,4.0,7.0,1.0,4.0,1.0,1.0,4.0,4.0,1.0,1.0,1.0,6.0,1.0,4.0,1.0,1.0,6.0,1.0,4.0,1.0,4.0,4.0,1.0,7.0,4.0,1.0,7.0,8,,,,,,,,,,,,,,,,,,,,,,,,,,,,,,,,,3,,,,,,,,,,,,,,,,,,,,,,,,,,,,,,,,,5,,,,,,,,,,,,,,,,,,,,,,,,,,,,,,,,,6,,,,,,,,,,,,,,,,,,,,,,,,,,,,,,,,,13,,,,,,,,,,,,,,,,,,,,,,,,,,,,,,,,,0,1.0,5.0,1.0,1.0,1.0,1.0,1.0,1.0,5.0,1.0,1.0,1.0,1.0,1.0,1.0,1.0,1.0,1.0,1.0,1.0,1.0,1.0,1.0,2.0,1.0,1.0,1.0,1.0,6.0,1.0,1.0,6.0,7,,,,,,,,,,,,,,,,,,,,,,,,,,,,,,,,,14,,,,,,,,,,,,,,,,,,,,,,,,,,,,,,,,,,392.3,47.1,,,,18.94,,26.67,,,,,,,,,,,150.5,,,,,,,,,42.2,,,,,,,,,,,,,,,,,,103.42,,,,,,,,,3.47,,APPROVED,Male,23.0,FALSE
542,2022-03-22 00:46:23,19,en,1008583633,2022-03-22 00:38:45,2022-03-22 00:46:23,Y,Y,A1,,,4,,,,,,,,,,,,,,,,,,,,,,,,,,,,,,,,,1,5.0,5.0,4.0,4.0,5.0,5.0,3.0,5.0,5.0,3.0,5.0,1.0,4.0,3.0,5.0,3.0,5.0,4.0,4.0,4.0,5.0,5.0,5.0,4.0,5.0,5.0,4.0,4.0,4.0,4.0,5.0,2.0,10,,,,,,,,,,,,,,,,,,,,,,,,,,,,,,,,,6,,,,,,,,,,,,,,,,,,,,,,,,,,,,,,,,,14,,,,,,,,,,,,,,,,,,,,,,,,,,,,,,,,,13,,,,,,,,,,,,,,,,,,,,,,,,,,,,,,,,,8,,,,,,,,,,,,,,,,,,,,,,,,,,,,,,,,,5,,,,,,,,,,,,,,,,,,,,,,,,,,,,,,,,,11,,,,,,,,,,,,,,,,,,,,,,,,,,,,,,,,,9,,,,,,,,,,,,,,,,,,,,,,,,,,,,,,,,,3,,,,,,,,,,,,,,,,,,,,,,,,,,,,,,,,,12,,,,,,,,,,,,,,,,,,,,,,,,,,,,,,,,,0,4.0,4.0,3.0,4.0,3.0,4.0,4.0,3.0,5.0,4.0,4.0,4.0,4.0,3.0,4.0,4.0,4.0,4.0,4.0,3.0,4.0,4.0,4.0,4.0,3.0,4.0,4.0,4.0,4.0,4.0,4.0,6.0,7,,,,,,,,,,,,,,,,,,,,,,,,,,,,,,,,,2,4.0,5.0,3.0,4.0,4.0,2.0,3.0,5.0,4.0,4.0,4.0,1.0,4.0,4.0,3.0,3.0,4.0,4.0,4.0,4.0,4.0,5.0,3.0,3.0,4.0,5.0,4.0,3.0,4.0,4.0,3.0,1.0,,461.21,49.05,,,,68.47,,52.52,,,,,107.46,,,,,,,,,,,,,,,,,,,,,,,,,,,,,,,,,121.28,,,,,,59.29,,,3.14,,APPROVED,Female,19.0,FALSE
543,2022-03-22 00:46:05,19,en,1224955990,2022-03-22 00:38:47,2022-03-22 00:46:05,Y,Y,-oth-,High School,,5,,,,,,,,,,,,,,,,,,,,,,,,,,,,,,,,,3,,,,,,,,,,,,,,,,,,,,,,,,,,,,,,,,,6,,,,,,,,,,,,,,,,,,,,,,,,,,,,,,,,,7,,,,,,,,,,,,,,,,,,,,,,,,,,,,,,,,,12,,,,,,,,,,,,,,,,,,,,,,,,,,,,,,,,,10,,,,,,,,,,,,,,,,,,,,,,,,,,,,,,,,,8,,,,,,,,,,,,,,,,,,,,,,,,,,,,,,,,,4,,,,,,,,,,,,,,,,,,,,,,,,,,,,,,,,,11,,,,,,,,,,,,,,,,,,,,,,,,,,,,,,,,,14,,,,,,,,,,,,,,,,,,,,,,,,,,,,,,,,,1,3.0,5.0,2.0,4.0,2.0,1.0,4.0,3.0,6.0,2.0,2.0,3.0,3.0,3.0,3.0,3.0,3.0,4.0,2.0,3.0,2.0,3.0,1.0,3.0,2.0,2.0,4.0,3.0,2.0,2.0,3.0,4.0,9,,,,,,,,,,,,,,,,,,,,,,,,,,,,,,,,,0,5.0,4.0,4.0,5.0,6.0,5.0,4.0,6.0,5.0,4.0,5.0,5.0,5.0,4.0,5.0,5.0,5.0,4.0,6.0,4.0,4.0,5.0,7.0,6.0,5.0,6.0,2.0,6.0,5.0,4.0,5.0,6.0,13,,,,,,,,,,,,,,,,,,,,,,,,,,,,,,,,,2,1.0,2.0,1.0,2.0,1.0,2.0,4.0,3.0,2.0,1.0,1.0,1.0,1.0,2.0,1.0,2.0,2.0,1.0,1.0,2.0,2.0,2.0,3.0,1.0,1.0,1.0,1.0,1.0,1.0,2.0,2.0,1.0,,440.18,100.21,,,,18.07,,39.57,,,,,,,,,,,,,,,,,,,,,,,,,,,,,,,,102.57,,,,,,95.21,,,,,,81.3,,,3.25,,APPROVED,Female,21.0,FALSE
545,2022-03-22 00:45:09,19,en,136343479,2022-03-22 00:39:26,2022-03-22 00:45:09,Y,Y,A1,,,9,,,,,,,,,,,,,,,,,,,,,,,,,,,,,,,,,7,,,,,,,,,,,,,,,,,,,,,,,,,,,,,,,,,12,,,,,,,,,,,,,,,,,,,,,,,,,,,,,,,,,4,,,,,,,,,,,,,,,,,,,,,,,,,,,,,,,,,11,,,,,,,,,,,,,,,,,,,,,,,,,,,,,,,,,8,,,,,,,,,,,,,,,,,,,,,,,,,,,,,,,,,0,6.0,6.0,5.0,3.0,6.0,3.0,3.0,7.0,6.0,6.0,6.0,6.0,6.0,4.0,5.0,6.0,6.0,2.0,6.0,6.0,4.0,6.0,6.0,6.0,6.0,4.0,2.0,6.0,2.0,1.0,3.0,7.0,6,,,,,,,,,,,,,,,,,,,,,,,,,,,,,,,,,1,1.0,2.0,1.0,2.0,1.0,1.0,7.0,6.0,4.0,2.0,1.0,2.0,2.0,2.0,2.0,2.0,3.0,2.0,1.0,2.0,1.0,2.0,1.0,2.0,2.0,1.0,5.0,1.0,2.0,2.0,1.0,2.0,13,,,,,,,,,,,,,,,,,,,,,,,,,,,,,,,,,3,,,,,,,,,,,,,,,,,,,,,,,,,,,,,,,,,14,,,,,,,,,,,,,,,,,,,,,,,,,,,,,,,,,5,,,,,,,,,,,,,,,,,,,,,,,,,,,,,,,,,2,5.0,3.0,1.0,4.0,2.0,4.0,2.0,3.0,5.0,2.0,2.0,6.0,2.0,1.0,7.0,1.0,7.0,1.0,2.0,1.0,1.0,1.0,6.0,2.0,2.0,1.0,4.0,1.0,5.0,1.0,6.0,7.0,10,,,,,,,,,,,,,,,,,,,,,,,,,,,,,,,,,,345.65,10.43,,,,17.26,,48.08,,,,,,,,,,,,,,,,,,,,69.69,,,,,,86.58,,,,,,,,,,,,,,,111.33,,,,,,2.28,,APPROVED,Male,20.0,FALSE
546,2022-03-22 00:50:39,19,en,145144379,2022-03-22 00:39:44,2022-03-22 00:50:39,Y,Y,-oth-,High school,,11,,,,,,,,,,,,,,,,,,,,,,,,,,,,,,,,,1,6.0,4.0,6.0,6.0,5.0,5.0,2.0,6.0,4.0,5.0,5.0,5.0,6.0,5.0,5.0,6.0,5.0,6.0,6.0,5.0,4.0,6.0,6.0,6.0,6.0,6.0,5.0,5.0,4.0,6.0,6.0,2.0,4,,,,,,,,,,,,,,,,,,,,,,,,,,,,,,,,,7,,,,,,,,,,,,,,,,,,,,,,,,,,,,,,,,,5,,,,,,,,,,,,,,,,,,,,,,,,,,,,,,,,,14,,,,,,,,,,,,,,,,,,,,,,,,,,,,,,,,,10,,,,,,,,,,,,,,,,,,,,,,,,,,,,,,,,,2,2.0,1.0,1.0,2.0,2.0,1.0,6.0,3.0,2.0,2.0,1.0,2.0,2.0,2.0,2.0,2.0,2.0,2.0,2.0,2.0,2.0,2.0,1.0,2.0,2.0,1.0,4.0,2.0,2.0,2.0,2.0,1.0,0,2.0,1.0,2.0,4.0,1.0,2.0,6.0,4.0,2.0,2.0,1.0,3.0,2.0,2.0,3.0,3.0,4.0,2.0,2.0,1.0,2.0,1.0,2.0,2.0,1.0,3.0,2.0,3.0,5.0,2.0,2.0,2.0,3,,,,,,,,,,,,,,,,,,,,,,,,,,,,,,,,,13,,,,,,,,,,,,,,,,,,,,,,,,,,,,,,,,,8,,,,,,,,,,,,,,,,,,,,,,,,,,,,,,,,,6,,,,,,,,,,,,,,,,,,,,,,,,,,,,,,,,,12,,,,,,,,,,,,,,,,,,,,,,,,,,,,,,,,,9,,,,,,,,,,,,,,,,,,,,,,,,,,,,,,,,,"The question about the academic degree was a bit uncomfortable to answer as there were not many options there. In my case I entered high school as this is my highest completed level. However I just in case wanted to note that I do have a couple of years of completed college courses as well, but no degree yet. ",658.28,89.17,,,,59.76,,40.04,,,,,104.5,,,,,,,,,,,,,,,,,,121.84,,,121.11,,,,,,,,,,,,,,,,,,,,,121.86,,APPROVED,Male,31.0,FALSE
547,2022-03-22 00:45:06,19,en,125393494,2022-03-22 00:40:12,2022-03-22 00:45:06,Y,Y,A2,,,8,,,,,,,,,,,,,,,,,,,,,,,,,,,,,,,,,1,5.0,1.0,6.0,6.0,6.0,6.0,1.0,6.0,2.0,6.0,4.0,6.0,6.0,6.0,2.0,6.0,6.0,6.0,6.0,6.0,5.0,6.0,6.0,6.0,7.0,6.0,1.0,6.0,6.0,5.0,7.0,2.0,7,,,,,,,,,,,,,,,,,,,,,,,,,,,,,,,,,5,,,,,,,,,,,,,,,,,,,,,,,,,,,,,,,,,14,,,,,,,,,,,,,,,,,,,,,,,,,,,,,,,,,6,,,,,,,,,,,,,,,,,,,,,,,,,,,,,,,,,3,,,,,,,,,,,,,,,,,,,,,,,,,,,,,,,,,4,,,,,,,,,,,,,,,,,,,,,,,,,,,,,,,,,13,,,,,,,,,,,,,,,,,,,,,,,,,,,,,,,,,9,,,,,,,,,,,,,,,,,,,,,,,,,,,,,,,,,11,,,,,,,,,,,,,,,,,,,,,,,,,,,,,,,,,2,7.0,7.0,7.0,7.0,7.0,6.0,4.0,6.0,7.0,6.0,6.0,6.0,6.0,6.0,7.0,6.0,7.0,7.0,7.0,6.0,4.0,7.0,7.0,7.0,7.0,7.0,4.0,6.0,7.0,6.0,7.0,5.0,10,,,,,,,,,,,,,,,,,,,,,,,,,,,,,,,,,0,2.0,1.0,3.0,4.0,2.0,6.0,2.0,4.0,3.0,3.0,2.0,5.0,2.0,1.0,4.0,2.0,2.0,4.0,2.0,2.0,4.0,2.0,2.0,4.0,2.0,2.0,2.0,4.0,2.0,2.0,1.0,7.0,12,,,,,,,,,,,,,,,,,,,,,,,,,,,,,,,,,,297.85,14.56,,,,5.24,,51.92,,,,,68.47,,,,,,,,,,,,,,,,,,,,,,,,,,,,,,78.69,,,,,,74.99,,,,,,3.98,,APPROVED,Female,34.0,FALSE
548,2022-03-22 00:46:11,19,en,188244932,2022-03-22 00:43:26,2022-03-22 00:46:11,Y,Y,A1,,,7,,,,,,,,,,,,,,,,,,,,,,,,,,,,,,,,,3,,,,,,,,,,,,,,,,,,,,,,,,,,,,,,,,,4,,,,,,,,,,,,,,,,,,,,,,,,,,,,,,,,,13,,,,,,,,,,,,,,,,,,,,,,,,,,,,,,,,,12,,,,,,,,,,,,,,,,,,,,,,,,,,,,,,,,,11,,,,,,,,,,,,,,,,,,,,,,,,,,,,,,,,,1,3.0,6.0,5.0,4.0,3.0,3.0,3.0,5.0,6.0,4.0,5.0,3.0,2.0,2.0,5.0,5.0,5.0,3.0,3.0,3.0,5.0,2.0,5.0,5.0,2.0,5.0,2.0,5.0,5.0,3.0,5.0,7.0,10,,,,,,,,,,,,,,,,,,,,,,,,,,,,,,,,,5,,,,,,,,,,,,,,,,,,,,,,,,,,,,,,,,,2,6.0,6.0,6.0,4.0,6.0,6.0,6.0,6.0,6.0,4.0,6.0,2.0,6.0,6.0,6.0,6.0,6.0,5.0,5.0,6.0,4.0,5.0,2.0,6.0,6.0,6.0,6.0,6.0,6.0,6.0,2.0,3.0,8,,,,,,,,,,,,,,,,,,,,,,,,,,,,,,,,,14,,,,,,,,,,,,,,,,,,,,,,,,,,,,,,,,,0,2.0,5.0,2.0,2.0,2.0,2.0,2.0,5.0,6.0,2.0,2.0,2.0,5.0,4.0,2.0,2.0,2.0,2.0,2.0,2.0,2.0,2.0,2.0,3.0,2.0,5.0,2.0,5.0,2.0,2.0,3.0,6.0,6,,,,,,,,,,,,,,,,,,,,,,,,,,,,,,,,,9,,,,,,,,,,,,,,,,,,,,,,,,,,,,,,,,,,166.95,7.54,,,,4.13,,11.44,,,,,,,,,,,,,,,,,,,,49.95,,,,,,,,,41.16,,,,,,,,,50.62,,,,,,,,,2.11,,APPROVED,Male,24.0,FALSE
549,2022-03-22 00:48:41,19,en,408231272,2022-03-22 00:43:26,2022-03-22 00:48:41,Y,Y,-oth-,High School,,4,,,,,,,,,,,,,,,,,,,,,,,,,,,,,,,,,14,,,,,,,,,,,,,,,,,,,,,,,,,,,,,,,,,6,,,,,,,,,,,,,,,,,,,,,,,,,,,,,,,,,13,,,,,,,,,,,,,,,,,,,,,,,,,,,,,,,,,1,2.0,2.0,1.0,2.0,2.0,1.0,5.0,1.0,1.0,2.0,1.0,1.0,1.0,1.0,1.0,1.0,1.0,1.0,1.0,4.0,1.0,1.0,1.0,1.0,1.0,2.0,1.0,2.0,2.0,1.0,2.0,5.0,0,4.0,5.0,4.0,4.0,3.0,3.0,5.0,5.0,5.0,4.0,4.0,4.0,4.0,4.0,4.0,4.0,5.0,4.0,4.0,4.0,3.0,4.0,4.0,4.0,4.0,2.0,2.0,3.0,4.0,4.0,4.0,6.0,9,,,,,,,,,,,,,,,,,,,,,,,,,,,,,,,,,10,,,,,,,,,,,,,,,,,,,,,,,,,,,,,,,,,3,,,,,,,,,,,,,,,,,,,,,,,,,,,,,,,,,5,,,,,,,,,,,,,,,,,,,,,,,,,,,,,,,,,2,4.0,5.0,3.0,4.0,4.0,4.0,4.0,3.0,5.0,3.0,4.0,4.0,4.0,3.0,3.0,4.0,4.0,4.0,3.0,3.0,4.0,4.0,4.0,3.0,3.0,3.0,1.0,4.0,4.0,3.0,4.0,4.0,12,,,,,,,,,,,,,,,,,,,,,,,,,,,,,,,,,8,,,,,,,,,,,,,,,,,,,,,,,,,,,,,,,,,11,,,,,,,,,,,,,,,,,,,,,,,,,,,,,,,,,7,,,,,,,,,,,,,,,,,,,,,,,,,,,,,,,,,,318.44,28.9,,,,26.42,,27.36,,,,,,,,,,,,,,71.93,,,88.52,,,,,,,,,,,,,,,73.25,,,,,,,,,,,,,,,2.06,,APPROVED,Male,20.0,FALSE
550,2022-03-22 00:48:35,19,en,284151359,2022-03-22 00:43:28,2022-03-22 00:48:35,Y,Y,A2,,,9,,,,,,,,,,,,,,,,,,,,,,,,,,,,,,,,,8,,,,,,,,,,,,,,,,,,,,,,,,,,,,,,,,,10,,,,,,,,,,,,,,,,,,,,,,,,,,,,,,,,,1,5.0,5.0,5.0,5.0,5.0,3.0,6.0,4.0,5.0,5.0,5.0,5.0,5.0,5.0,5.0,5.0,6.0,5.0,4.0,5.0,5.0,5.0,3.0,5.0,5.0,5.0,5.0,5.0,5.0,5.0,5.0,4.0,7,,,,,,,,,,,,,,,,,,,,,,,,,,,,,,,,,11,,,,,,,,,,,,,,,,,,,,,,,,,,,,,,,,,12,,,,,,,,,,,,,,,,,,,,,,,,,,,,,,,,,2,5.0,5.0,5.0,3.0,5.0,4.0,6.0,5.0,6.0,5.0,4.0,6.0,5.0,5.0,6.0,3.0,6.0,5.0,5.0,3.0,6.0,5.0,5.0,4.0,5.0,3.0,5.0,5.0,3.0,5.0,5.0,1.0,14,,,,,,,,,,,,,,,,,,,,,,,,,,,,,,,,,0,2.0,2.0,1.0,1.0,3.0,2.0,7.0,1.0,4.0,1.0,1.0,1.0,1.0,5.0,6.0,4.0,1.0,1.0,1.0,1.0,1.0,1.0,1.0,1.0,7.0,1.0,5.0,4.0,1.0,1.0,1.0,3.0,3,,,,,,,,,,,,,,,,,,,,,,,,,,,,,,,,,13,,,,,,,,,,,,,,,,,,,,,,,,,,,,,,,,,4,,,,,,,,,,,,,,,,,,,,,,,,,,,,,,,,,5,,,,,,,,,,,,,,,,,,,,,,,,,,,,,,,,,6,,,,,,,,,,,,,,,,,,,,,,,,,,,,,,,,,,309.66,7.17,,,,7.03,,31.12,,,,,,,,,,,79.06,,,,,,,,,,,,78.21,,,,,,104.49,,,,,,,,,,,,,,,,,,2.58,,APPROVED,Male,28.0,FALSE
551,2022-03-22 00:51:48,19,en,618124627,2022-03-22 00:43:29,2022-03-22 00:51:48,Y,Y,A2,,,13,,,,,,,,,,,,,,,,,,,,,,,,,,,,,,,,,7,,,,,,,,,,,,,,,,,,,,,,,,,,,,,,,,,6,,,,,,,,,,,,,,,,,,,,,,,,,,,,,,,,,8,,,,,,,,,,,,,,,,,,,,,,,,,,,,,,,,,11,,,,,,,,,,,,,,,,,,,,,,,,,,,,,,,,,0,4.0,7.0,5.0,4.0,2.0,3.0,6.0,6.0,7.0,4.0,2.0,4.0,5.0,4.0,5.0,3.0,5.0,4.0,4.0,5.0,4.0,4.0,4.0,4.0,5.0,4.0,5.0,4.0,6.0,6.0,5.0,6.0,4,,,,,,,,,,,,,,,,,,,,,,,,,,,,,,,,,9,,,,,,,,,,,,,,,,,,,,,,,,,,,,,,,,,12,,,,,,,,,,,,,,,,,,,,,,,,,,,,,,,,,2,3.0,6.0,5.0,4.0,3.0,3.0,6.0,2.0,5.0,3.0,3.0,4.0,5.0,4.0,5.0,4.0,4.0,4.0,4.0,3.0,4.0,4.0,3.0,4.0,5.0,5.0,4.0,4.0,4.0,4.0,4.0,3.0,10,,,,,,,,,,,,,,,,,,,,,,,,,,,,,,,,,1,3.0,4.0,4.0,4.0,4.0,5.0,2.0,6.0,4.0,3.0,4.0,3.0,4.0,3.0,4.0,3.0,4.0,4.0,3.0,3.0,4.0,4.0,4.0,4.0,4.0,3.0,4.0,4.0,3.0,4.0,4.0,5.0,14,,,,,,,,,,,,,,,,,,,,,,,,,,,,,,,,,5,,,,,,,,,,,,,,,,,,,,,,,,,,,,,,,,,3,,,,,,,,,,,,,,,,,,,,,,,,,,,,,,,,,,502.82,57.83,,,,8.96,,60.79,,,,,,,,,,,,,,,,,186.6,,,,,,,,,,,,86.06,,,,,,100.05,,,,,,,,,,,,2.53,,APPROVED,Male,37.0,FALSE
552,2022-03-22 00:48:33,19,en,107604158,2022-03-22 00:43:29,2022-03-22 00:48:33,Y,Y,A1,,,12,,,,,,,,,,,,,,,,,,,,,,,,,,,,,,,,,13,,,,,,,,,,,,,,,,,,,,,,,,,,,,,,,,,7,,,,,,,,,,,,,,,,,,,,,,,,,,,,,,,,,0,6.0,6.0,1.0,6.0,6.0,4.0,5.0,2.0,6.0,5.0,6.0,4.0,6.0,4.0,7.0,4.0,6.0,4.0,6.0,5.0,6.0,4.0,6.0,6.0,1.0,7.0,1.0,5.0,7.0,4.0,3.0,4.0,8,,,,,,,,,,,,,,,,,,,,,,,,,,,,,,,,,9,,,,,,,,,,,,,,,,,,,,,,,,,,,,,,,,,5,,,,,,,,,,,,,,,,,,,,,,,,,,,,,,,,,1,5.0,2.0,3.0,4.0,3.0,5.0,2.0,6.0,4.0,4.0,5.0,4.0,5.0,4.0,5.0,5.0,5.0,3.0,5.0,4.0,6.0,5.0,6.0,5.0,2.0,5.0,2.0,4.0,2.0,4.0,5.0,1.0,4,,,,,,,,,,,,,,,,,,,,,,,,,,,,,,,,,14,,,,,,,,,,,,,,,,,,,,,,,,,,,,,,,,,3,,,,,,,,,,,,,,,,,,,,,,,,,,,,,,,,,6,,,,,,,,,,,,,,,,,,,,,,,,,,,,,,,,,2,3.0,1.0,2.0,2.0,1.0,4.0,7.0,4.0,1.0,1.0,2.0,1.0,2.0,1.0,1.0,3.0,3.0,1.0,3.0,2.0,2.0,2.0,1.0,2.0,1.0,2.0,2.0,2.0,1.0,2.0,1.0,6.0,11,,,,,,,,,,,,,,,,,,,,,,,,,,,,,,,,,10,,,,,,,,,,,,,,,,,,,,,,,,,,,,,,,,,,306.64,25.4,,,,5.2,,46.63,,,,,,,,,,,97.5,,,,,,,,,,,,69.38,,,,,,,,,,,,,,,60.1,,,,,,,,,2.43,,APPROVED,Male,32.0,FALSE
553,2022-03-22 00:54:24,19,en,680066800,2022-03-22 00:43:30,2022-03-22 00:54:24,Y,Y,A1,,,3,,,,,,,,,,,,,,,,,,,,,,,,,,,,,,,,,12,,,,,,,,,,,,,,,,,,,,,,,,,,,,,,,,,11,,,,,,,,,,,,,,,,,,,,,,,,,,,,,,,,,7,,,,,,,,,,,,,,,,,,,,,,,,,,,,,,,,,9,,,,,,,,,,,,,,,,,,,,,,,,,,,,,,,,,0,6.0,6.0,6.0,5.0,6.0,6.0,4.0,6.0,6.0,6.0,4.0,7.0,6.0,6.0,7.0,5.0,7.0,5.0,6.0,4.0,6.0,6.0,3.0,6.0,6.0,4.0,6.0,6.0,5.0,4.0,4.0,6.0,14,,,,,,,,,,,,,,,,,,,,,,,,,,,,,,,,,4,,,,,,,,,,,,,,,,,,,,,,,,,,,,,,,,,1,2.0,1.0,1.0,1.0,1.0,2.0,2.0,1.0,1.0,2.0,1.0,1.0,1.0,2.0,2.0,2.0,2.0,1.0,3.0,1.0,1.0,1.0,4.0,2.0,2.0,4.0,1.0,2.0,1.0,1.0,2.0,2.0,10,,,,,,,,,,,,,,,,,,,,,,,,,,,,,,,,,5,,,,,,,,,,,,,,,,,,,,,,,,,,,,,,,,,13,,,,,,,,,,,,,,,,,,,,,,,,,,,,,,,,,6,,,,,,,,,,,,,,,,,,,,,,,,,,,,,,,,,2,6.0,4.0,6.0,6.0,4.0,6.0,3.0,6.0,6.0,4.0,4.0,5.0,6.0,6.0,7.0,6.0,6.0,6.0,6.0,3.0,6.0,4.0,4.0,5.0,4.0,6.0,4.0,6.0,6.0,4.0,6.0,7.0,8,,,,,,,,,,,,,,,,,,,,,,,,,,,,,,,,,,657.9,13.58,,,,5.59,,29.75,,,,,,,,,,,,,,,,,72.84,,,,,,,,,465.31,,,,,,,,,,,,,,,67.18,,,,,,3.65,,APPROVED,Male,44.0,FALSE
554,2022-03-22 00:51:30,19,en,1259806220,2022-03-22 00:43:32,2022-03-22 00:51:30,Y,Y,-oth-,GCSE,,0,6.0,6.0,5.0,5.0,6.0,5.0,5.0,5.0,7.0,5.0,6.0,5.0,6.0,5.0,5.0,6.0,6.0,5.0,6.0,5.0,4.0,6.0,5.0,6.0,6.0,6.0,4.0,5.0,5.0,5.0,5.0,1.0,10,,,,,,,,,,,,,,,,,,,,,,,,,,,,,,,,,9,,,,,,,,,,,,,,,,,,,,,,,,,,,,,,,,,6,,,,,,,,,,,,,,,,,,,,,,,,,,,,,,,,,13,,,,,,,,,,,,,,,,,,,,,,,,,,,,,,,,,8,,,,,,,,,,,,,,,,,,,,,,,,,,,,,,,,,4,,,,,,,,,,,,,,,,,,,,,,,,,,,,,,,,,11,,,,,,,,,,,,,,,,,,,,,,,,,,,,,,,,,12,,,,,,,,,,,,,,,,,,,,,,,,,,,,,,,,,3,,,,,,,,,,,,,,,,,,,,,,,,,,,,,,,,,5,,,,,,,,,,,,,,,,,,,,,,,,,,,,,,,,,7,,,,,,,,,,,,,,,,,,,,,,,,,,,,,,,,,14,,,,,,,,,,,,,,,,,,,,,,,,,,,,,,,,,2,1.0,6.0,1.0,4.0,3.0,6.0,1.0,6.0,6.0,1.0,4.0,6.0,1.0,4.0,6.0,1.0,5.0,1.0,3.0,1.0,1.0,1.0,6.0,1.0,1.0,7.0,5.0,1.0,5.0,4.0,6.0,1.0,1,6.0,7.0,6.0,5.0,6.0,5.0,5.0,6.0,7.0,5.0,6.0,6.0,6.0,5.0,5.0,6.0,6.0,6.0,6.0,6.0,3.0,6.0,5.0,6.0,6.0,6.0,3.0,6.0,6.0,6.0,6.0,1.0,"Straight forward, thank you.",483.9,149.59,,,,10.27,,10.68,,88.53,,,,,,,,,,,,,,,,,,,,,,,,,,,,,,,,,,,,,,,90.76,,,122.36,,,11.71,,APPROVED,Female,28.0,FALSE
555,2022-03-22 00:49:30,19,en,110036072,2022-03-22 00:43:33,2022-03-22 00:49:30,Y,Y,A1,,,1,6.0,6.0,6.0,5.0,7.0,3.0,5.0,6.0,7.0,4.0,6.0,7.0,5.0,6.0,7.0,6.0,7.0,5.0,5.0,6.0,6.0,5.0,2.0,5.0,6.0,5.0,4.0,6.0,6.0,4.0,7.0,7.0,11,,,,,,,,,,,,,,,,,,,,,,,,,,,,,,,,,4,,,,,,,,,,,,,,,,,,,,,,,,,,,,,,,,,9,,,,,,,,,,,,,,,,,,,,,,,,,,,,,,,,,6,,,,,,,,,,,,,,,,,,,,,,,,,,,,,,,,,3,,,,,,,,,,,,,,,,,,,,,,,,,,,,,,,,,10,,,,,,,,,,,,,,,,,,,,,,,,,,,,,,,,,8,,,,,,,,,,,,,,,,,,,,,,,,,,,,,,,,,12,,,,,,,,,,,,,,,,,,,,,,,,,,,,,,,,,13,,,,,,,,,,,,,,,,,,,,,,,,,,,,,,,,,0,5.0,6.0,6.0,5.0,7.0,2.0,5.0,6.0,7.0,3.0,3.0,6.0,5.0,6.0,7.0,5.0,7.0,5.0,3.0,6.0,6.0,3.0,2.0,5.0,7.0,2.0,4.0,6.0,2.0,4.0,2.0,4.0,2,6.0,6.0,6.0,7.0,7.0,6.0,3.0,7.0,5.0,6.0,7.0,7.0,6.0,7.0,6.0,7.0,5.0,3.0,7.0,5.0,3.0,7.0,7.0,5.0,7.0,7.0,5.0,7.0,7.0,2.0,5.0,5.0,7,,,,,,,,,,,,,,,,,,,,,,,,,,,,,,,,,5,,,,,,,,,,,,,,,,,,,,,,,,,,,,,,,,,14,,,,,,,,,,,,,,,,,,,,,,,,,,,,,,,,,,359.61,85.42,,,,7.03,,29.49,,78.32,,,,,,,,,,,,,,,,,,,,,,,,,,,,,,89.83,,,66.28,,,,,,,,,,,,3.24,,APPROVED,Female,21.0,FALSE
556,2022-03-22 01:02:30,19,en,260658778,2022-03-22 00:43:33,2022-03-22 01:02:30,Y,Y,-oth-,High school,,7,,,,,,,,,,,,,,,,,,,,,,,,,,,,,,,,,12,,,,,,,,,,,,,,,,,,,,,,,,,,,,,,,,,3,,,,,,,,,,,,,,,,,,,,,,,,,,,,,,,,,5,,,,,,,,,,,,,,,,,,,,,,,,,,,,,,,,,11,,,,,,,,,,,,,,,,,,,,,,,,,,,,,,,,,10,,,,,,,,,,,,,,,,,,,,,,,,,,,,,,,,,2,3.0,2.0,3.0,4.0,2.0,5.0,5.0,1.0,3.0,3.0,3.0,2.0,3.0,3.0,3.0,1.0,4.0,2.0,2.0,1.0,2.0,3.0,3.0,2.0,3.0,4.0,3.0,2.0,2.0,2.0,3.0,7.0,8,,,,,,,,,,,,,,,,,,,,,,,,,,,,,,,,,14,,,,,,,,,,,,,,,,,,,,,,,,,,,,,,,,,9,,,,,,,,,,,,,,,,,,,,,,,,,,,,,,,,,1,3.0,7.0,3.0,1.0,2.0,1.0,4.0,1.0,4.0,3.0,1.0,3.0,1.0,3.0,3.0,1.0,3.0,2.0,3.0,2.0,1.0,2.0,1.0,2.0,3.0,1.0,4.0,1.0,3.0,2.0,1.0,4.0,13,,,,,,,,,,,,,,,,,,,,,,,,,,,,,,,,,4,,,,,,,,,,,,,,,,,,,,,,,,,,,,,,,,,0,1.0,3.0,2.0,5.0,2.0,3.0,4.0,4.0,6.0,2.0,1.0,4.0,3.0,3.0,5.0,3.0,5.0,2.0,4.0,2.0,3.0,4.0,4.0,3.0,3.0,4.0,3.0,4.0,4.0,3.0,6.0,7.0,6,,,,,,,,,,,,,,,,,,,,,,,,,,,,,,,,,,1139.72,11.34,,,,93.52,,55.53,,,,,,,,,,,,,,,,,,,,819.42,,,,,,,,,,,,90.3,,,,,,,,,67.04,,,,,,2.57,,APPROVED,Male,24.0,FALSE
558,2022-03-22 00:48:36,19,en,1791278100,2022-03-22 00:43:35,2022-03-22 00:48:36,Y,Y,A1,,,14,,,,,,,,,,,,,,,,,,,,,,,,,,,,,,,,,8,,,,,,,,,,,,,,,,,,,,,,,,,,,,,,,,,11,,,,,,,,,,,,,,,,,,,,,,,,,,,,,,,,,13,,,,,,,,,,,,,,,,,,,,,,,,,,,,,,,,,4,,,,,,,,,,,,,,,,,,,,,,,,,,,,,,,,,6,,,,,,,,,,,,,,,,,,,,,,,,,,,,,,,,,5,,,,,,,,,,,,,,,,,,,,,,,,,,,,,,,,,10,,,,,,,,,,,,,,,,,,,,,,,,,,,,,,,,,9,,,,,,,,,,,,,,,,,,,,,,,,,,,,,,,,,3,,,,,,,,,,,,,,,,,,,,,,,,,,,,,,,,,7,,,,,,,,,,,,,,,,,,,,,,,,,,,,,,,,,12,,,,,,,,,,,,,,,,,,,,,,,,,,,,,,,,,2,3.0,6.0,3.0,2.0,2.0,3.0,4.0,1.0,6.0,3.0,4.0,5.0,3.0,2.0,6.0,2.0,6.0,2.0,3.0,2.0,2.0,3.0,2.0,3.0,3.0,3.0,6.0,4.0,6.0,3.0,2.0,6.0,0,6.0,6.0,7.0,4.0,3.0,6.0,4.0,6.0,6.0,5.0,6.0,6.0,4.0,4.0,6.0,7.0,3.0,3.0,3.0,4.0,1.0,3.0,6.0,1.0,6.0,6.0,4.0,3.0,6.0,6.0,7.0,7.0,1,5.0,6.0,6.0,4.0,6.0,3.0,6.0,3.0,7.0,6.0,6.0,6.0,7.0,5.0,6.0,6.0,7.0,5.0,6.0,6.0,3.0,6.0,4.0,7.0,6.0,5.0,6.0,7.0,4.0,5.0,6.0,7.0,,304.81,25.69,,,,8.17,,31.62,,,,,,,,,,,,,,,,,,,,,,,,,,,,,,,,,,,,,,68.86,,,110.76,,,55.63,,,4.08,,APPROVED,Male,21.0,FALSE
559,2022-03-22 00:50:16,19,en,1727626899,2022-03-22 00:43:35,2022-03-22 00:50:16,Y,Y,A1,,,3,,,,,,,,,,,,,,,,,,,,,,,,,,,,,,,,,0,3.0,3.0,3.0,5.0,5.0,6.0,4.0,5.0,2.0,4.0,4.0,4.0,5.0,2.0,3.0,3.0,4.0,5.0,5.0,3.0,4.0,4.0,3.0,4.0,5.0,3.0,3.0,5.0,3.0,4.0,4.0,2.0,6,,,,,,,,,,,,,,,,,,,,,,,,,,,,,,,,,9,,,,,,,,,,,,,,,,,,,,,,,,,,,,,,,,,5,,,,,,,,,,,,,,,,,,,,,,,,,,,,,,,,,7,,,,,,,,,,,,,,,,,,,,,,,,,,,,,,,,,14,,,,,,,,,,,,,,,,,,,,,,,,,,,,,,,,,10,,,,,,,,,,,,,,,,,,,,,,,,,,,,,,,,,11,,,,,,,,,,,,,,,,,,,,,,,,,,,,,,,,,12,,,,,,,,,,,,,,,,,,,,,,,,,,,,,,,,,4,,,,,,,,,,,,,,,,,,,,,,,,,,,,,,,,,2,2.0,5.0,2.0,1.0,3.0,5.0,5.0,5.0,5.0,5.0,4.0,4.0,3.0,3.0,4.0,2.0,4.0,7.0,3.0,5.0,4.0,6.0,2.0,5.0,5.0,4.0,2.0,4.0,4.0,4.0,5.0,5.0,1,3.0,2.0,4.0,3.0,5.0,5.0,6.0,2.0,5.0,4.0,4.0,4.0,2.0,2.0,4.0,4.0,3.0,4.0,4.0,4.0,2.0,2.0,3.0,5.0,5.0,4.0,3.0,4.0,4.0,4.0,3.0,6.0,8,,,,,,,,,,,,,,,,,,,,,,,,,,,,,,,,,13,,,,,,,,,,,,,,,,,,,,,,,,,,,,,,,,,,405.33,69.62,,,,4.53,,56.92,,,,,54.32,,,,,,,,,,,,,,,,,,,,,,,,,,,,,,82.65,,,134.6,,,,,,,,,2.69,,APPROVED,Female,25.0,FALSE
560,2022-03-22 00:55:10,19,en,73129696,2022-03-22 00:43:39,2022-03-22 00:55:10,Y,Y,A1,,,6,,,,,,,,,,,,,,,,,,,,,,,,,,,,,,,,,14,,,,,,,,,,,,,,,,,,,,,,,,,,,,,,,,,5,,,,,,,,,,,,,,,,,,,,,,,,,,,,,,,,,13,,,,,,,,,,,,,,,,,,,,,,,,,,,,,,,,,8,,,,,,,,,,,,,,,,,,,,,,,,,,,,,,,,,4,,,,,,,,,,,,,,,,,,,,,,,,,,,,,,,,,1,5.0,7.0,2.0,5.0,1.0,1.0,1.0,4.0,5.0,1.0,1.0,2.0,3.0,1.0,5.0,4.0,5.0,5.0,1.0,1.0,1.0,3.0,1.0,1.0,4.0,1.0,4.0,1.0,1.0,2.0,5.0,7.0,7,,,,,,,,,,,,,,,,,,,,,,,,,,,,,,,,,0,1.0,6.0,5.0,2.0,5.0,1.0,1.0,1.0,6.0,6.0,4.0,3.0,2.0,2.0,2.0,1.0,5.0,1.0,4.0,5.0,2.0,1.0,2.0,2.0,1.0,1.0,1.0,5.0,4.0,3.0,5.0,2.0,3,,,,,,,,,,,,,,,,,,,,,,,,,,,,,,,,,12,,,,,,,,,,,,,,,,,,,,,,,,,,,,,,,,,11,,,,,,,,,,,,,,,,,,,,,,,,,,,,,,,,,9,,,,,,,,,,,,,,,,,,,,,,,,,,,,,,,,,2,1.0,1.0,2.0,2.0,1.0,1.0,2.0,2.0,5.0,1.0,2.0,1.0,1.0,1.0,1.0,2.0,1.0,1.0,1.0,1.0,2.0,1.0,2.0,1.0,1.0,2.0,1.0,1.0,1.0,1.0,2.0,1.0,10,,,,,,,,,,,,,,,,,,,,,,,,,,,,,,,,,the last one was very ugly.,695.69,42.95,,,,9.73,,82.96,,,,,,,,,,,,,,,,,,,,73.8,,,,,,419.85,,,,,,,,,,,,,,,51.56,,,,,,14.84,,APPROVED,Female,53.0,FALSE
561,2022-03-22 00:46:41,19,en,1541480568,2022-03-22 00:43:54,2022-03-22 00:46:41,Y,Y,A1,,,7,,,,,,,,,,,,,,,,,,,,,,,,,,,,,,,,,10,,,,,,,,,,,,,,,,,,,,,,,,,,,,,,,,,12,,,,,,,,,,,,,,,,,,,,,,,,,,,,,,,,,5,,,,,,,,,,,,,,,,,,,,,,,,,,,,,,,,,11,,,,,,,,,,,,,,,,,,,,,,,,,,,,,,,,,8,,,,,,,,,,,,,,,,,,,,,,,,,,,,,,,,,3,,,,,,,,,,,,,,,,,,,,,,,,,,,,,,,,,4,,,,,,,,,,,,,,,,,,,,,,,,,,,,,,,,,2,6.0,6.0,6.0,6.0,3.0,4.0,5.0,6.0,7.0,3.0,3.0,3.0,5.0,4.0,4.0,5.0,2.0,4.0,5.0,4.0,5.0,5.0,4.0,3.0,6.0,6.0,5.0,3.0,5.0,5.0,6.0,2.0,14,,,,,,,,,,,,,,,,,,,,,,,,,,,,,,,,,1,5.0,5.0,4.0,3.0,4.0,6.0,2.0,4.0,4.0,3.0,5.0,4.0,6.0,5.0,3.0,5.0,4.0,5.0,2.0,6.0,4.0,3.0,5.0,4.0,3.0,5.0,6.0,3.0,6.0,6.0,3.0,4.0,0,5.0,3.0,4.0,7.0,6.0,6.0,3.0,4.0,5.0,4.0,7.0,6.0,5.0,3.0,4.0,5.0,4.0,3.0,5.0,5.0,2.0,3.0,6.0,5.0,6.0,4.0,1.0,4.0,3.0,3.0,3.0,5.0,9,,,,,,,,,,,,,,,,,,,,,,,,,,,,,,,,,6,,,,,,,,,,,,,,,,,,,,,,,,,,,,,,,,,13,,,,,,,,,,,,,,,,,,,,,,,,,,,,,,,,,,171.81,10.8,,,,11.89,,7.79,,,,,,,,,,,,,,,,,,,,,,,,,,46.28,,,,,,36.63,,,55.7,,,,,,,,,,,,2.72,,APPROVED,Male,22.0,FALSE
562,2022-03-22 00:51:21,19,en,624095866,2022-03-22 00:44:04,2022-03-22 00:51:21,Y,Y,-oth-,High School certificate,,2,2.0,6.0,5.0,2.0,4.0,2.0,7.0,1.0,6.0,2.0,1.0,1.0,2.0,2.0,6.0,1.0,7.0,1.0,4.0,4.0,3.0,2.0,2.0,4.0,2.0,1.0,1.0,4.0,3.0,1.0,1.0,1.0,9,,,,,,,,,,,,,,,,,,,,,,,,,,,,,,,,,2,7.0,6.0,7.0,7.0,7.0,7.0,4.0,7.0,7.0,7.0,6.0,6.0,6.0,7.0,7.0,7.0,7.0,7.0,7.0,6.0,4.0,7.0,7.0,7.0,7.0,6.0,3.0,7.0,7.0,5.0,7.0,1.0,8,,,,,,,,,,,,,,,,,,,,,,,,,,,,,,,,,13,,,,,,,,,,,,,,,,,,,,,,,,,,,,,,,,,4,,,,,,,,,,,,,,,,,,,,,,,,,,,,,,,,,14,,,,,,,,,,,,,,,,,,,,,,,,,,,,,,,,,5,,,,,,,,,,,,,,,,,,,,,,,,,,,,,,,,,12,,,,,,,,,,,,,,,,,,,,,,,,,,,,,,,,,3,,,,,,,,,,,,,,,,,,,,,,,,,,,,,,,,,7,,,,,,,,,,,,,,,,,,,,,,,,,,,,,,,,,11,,,,,,,,,,,,,,,,,,,,,,,,,,,,,,,,,10,,,,,,,,,,,,,,,,,,,,,,,,,,,,,,,,,2,1.0,2.0,1.0,1.0,1.0,1.0,1.0,1.0,2.0,1.0,1.0,1.0,1.0,1.0,5.0,1.0,7.0,1.0,1.0,1.0,1.0,1.0,1.0,1.0,1.0,1.0,2.0,1.0,5.0,1.0,1.0,7.0,6,,,,,,,,,,,,,,,,,,,,,,,,,,,,,,,,,,441.11,33.35,,,,37.92,,33.46,,145.63,,,,,,101.89,,,,,,,,,,,,,,,,,,,,,,,,,,,,,,,,,81.46,,,,,,7.4,,APPROVED,Female,22.0,FALSE
563,2022-03-22 00:57:35,19,en,346087212,2022-03-22 00:50:08,2022-03-22 00:57:35,Y,Y,A1,,,4,,,,,,,,,,,,,,,,,,,,,,,,,,,,,,,,,5,,,,,,,,,,,,,,,,,,,,,,,,,,,,,,,,,2,6.0,7.0,6.0,5.0,5.0,5.0,2.0,7.0,6.0,5.0,6.0,6.0,5.0,6.0,6.0,6.0,6.0,6.0,6.0,6.0,6.0,6.0,5.0,6.0,6.0,3.0,6.0,7.0,3.0,6.0,3.0,3.0,11,,,,,,,,,,,,,,,,,,,,,,,,,,,,,,,,,14,,,,,,,,,,,,,,,,,,,,,,,,,,,,,,,,,1,6.0,5.0,6.0,6.0,5.0,6.0,2.0,7.0,6.0,5.0,6.0,6.0,7.0,6.0,5.0,3.0,6.0,6.0,6.0,5.0,6.0,6.0,6.0,5.0,6.0,6.0,3.0,6.0,5.0,6.0,6.0,6.0,3,,,,,,,,,,,,,,,,,,,,,,,,,,,,,,,,,13,,,,,,,,,,,,,,,,,,,,,,,,,,,,,,,,,10,,,,,,,,,,,,,,,,,,,,,,,,,,,,,,,,,0,3.0,5.0,2.0,3.0,2.0,2.0,6.0,2.0,6.0,2.0,2.0,3.0,2.0,5.0,5.0,2.0,3.0,2.0,2.0,2.0,5.0,2.0,2.0,3.0,3.0,2.0,5.0,2.0,6.0,3.0,2.0,3.0,12,,,,,,,,,,,,,,,,,,,,,,,,,,,,,,,,,6,,,,,,,,,,,,,,,,,,,,,,,,,,,,,,,,,7,,,,,,,,,,,,,,,,,,,,,,,,,,,,,,,,,8,,,,,,,,,,,,,,,,,,,,,,,,,,,,,,,,,9,,,,,,,,,,,,,,,,,,,,,,,,,,,,,,,,,"Very nice survey, would like to know what info could be presented by the first type of graph",450.24,92.4,,,,9.53,,34.7,,,,,,,,98.08,,,,,,,,,76.71,,,,,,,,,,,,102.01,,,,,,,,,,,,,,,,,,36.81,,APPROVED,Male,20.0,FALSE
564,2022-03-22 00:57:37,19,en,761529640,2022-03-22 00:50:10,2022-03-22 00:57:37,Y,Y,-oth-,College Degree,,8,,,,,,,,,,,,,,,,,,,,,,,,,,,,,,,,,10,,,,,,,,,,,,,,,,,,,,,,,,,,,,,,,,,6,,,,,,,,,,,,,,,,,,,,,,,,,,,,,,,,,2,6.0,6.0,6.0,5.0,6.0,4.0,6.0,5.0,6.0,6.0,6.0,3.0,6.0,5.0,6.0,5.0,6.0,6.0,6.0,5.0,5.0,6.0,5.0,6.0,5.0,5.0,3.0,6.0,6.0,6.0,3.0,4.0,11,,,,,,,,,,,,,,,,,,,,,,,,,,,,,,,,,4,,,,,,,,,,,,,,,,,,,,,,,,,,,,,,,,,12,,,,,,,,,,,,,,,,,,,,,,,,,,,,,,,,,3,,,,,,,,,,,,,,,,,,,,,,,,,,,,,,,,,5,,,,,,,,,,,,,,,,,,,,,,,,,,,,,,,,,9,,,,,,,,,,,,,,,,,,,,,,,,,,,,,,,,,0,2.0,6.0,2.0,5.0,3.0,3.0,3.0,6.0,5.0,3.0,3.0,3.0,3.0,3.0,5.0,2.0,2.0,3.0,3.0,2.0,2.0,3.0,5.0,3.0,4.0,4.0,5.0,2.0,6.0,3.0,2.0,4.0,14,,,,,,,,,,,,,,,,,,,,,,,,,,,,,,,,,1,6.0,6.0,7.0,6.0,7.0,7.0,2.0,7.0,6.0,6.0,6.0,6.0,6.0,6.0,7.0,6.0,6.0,6.0,6.0,6.0,6.0,6.0,7.0,6.0,7.0,6.0,3.0,6.0,7.0,6.0,7.0,6.0,13,,,,,,,,,,,,,,,,,,,,,,,,,,,,,,,,,7,,,,,,,,,,,,,,,,,,,,,,,,,,,,,,,,,,450.14,57.02,,,,23.23,,49.58,,,,,,,,,,,166.65,,,,,,,,,,,,,,,,,,,,,86.37,,,,,,64.72,,,,,,,,,2.57,,APPROVED,Male,23.0,FALSE
565,2022-03-22 00:54:11,19,en,414891835,2022-03-22 00:50:10,2022-03-22 00:54:11,Y,Y,A1,,,10,,,,,,,,,,,,,,,,,,,,,,,,,,,,,,,,,3,,,,,,,,,,,,,,,,,,,,,,,,,,,,,,,,,6,,,,,,,,,,,,,,,,,,,,,,,,,,,,,,,,,11,,,,,,,,,,,,,,,,,,,,,,,,,,,,,,,,,9,,,,,,,,,,,,,,,,,,,,,,,,,,,,,,,,,14,,,,,,,,,,,,,,,,,,,,,,,,,,,,,,,,,7,,,,,,,,,,,,,,,,,,,,,,,,,,,,,,,,,2,4.0,6.0,3.0,3.0,2.0,2.0,6.0,4.0,6.0,3.0,3.0,3.0,5.0,5.0,5.0,3.0,6.0,3.0,5.0,4.0,5.0,5.0,3.0,5.0,5.0,1.0,4.0,5.0,1.0,4.0,3.0,1.0,0,1.0,2.0,1.0,1.0,1.0,1.0,7.0,3.0,5.0,1.0,1.0,1.0,1.0,1.0,4.0,1.0,3.0,1.0,1.0,2.0,2.0,1.0,1.0,1.0,1.0,1.0,1.0,1.0,1.0,1.0,1.0,2.0,1,2.0,1.0,1.0,1.0,1.0,3.0,7.0,1.0,1.0,2.0,5.0,3.0,2.0,1.0,4.0,1.0,1.0,1.0,3.0,2.0,3.0,1.0,5.0,1.0,2.0,2.0,2.0,2.0,6.0,1.0,1.0,3.0,8,,,,,,,,,,,,,,,,,,,,,,,,,,,,,,,,,12,,,,,,,,,,,,,,,,,,,,,,,,,,,,,,,,,5,,,,,,,,,,,,,,,,,,,,,,,,,,,,,,,,,4,,,,,,,,,,,,,,,,,,,,,,,,,,,,,,,,,13,,,,,,,,,,,,,,,,,,,,,,,,,,,,,,,,,,242.11,18.97,,,,4.45,,20.23,,,,,,,,,,,,,,,,,,,,,,,65.23,,,56.68,,,71.28,,,,,,,,,,,,,,,,,,5.27,,APPROVED,Male,21.0,FALSE
566,2022-03-22 00:55:51,19,en,458574502,2022-03-22 00:50:11,2022-03-22 00:55:51,Y,Y,A1,,,3,,,,,,,,,,,,,,,,,,,,,,,,,,,,,,,,,4,,,,,,,,,,,,,,,,,,,,,,,,,,,,,,,,,12,,,,,,,,,,,,,,,,,,,,,,,,,,,,,,,,,8,,,,,,,,,,,,,,,,,,,,,,,,,,,,,,,,,1,5.0,3.0,3.0,5.0,5.0,6.0,6.0,4.0,5.0,5.0,6.0,6.0,4.0,6.0,5.0,5.0,6.0,5.0,4.0,3.0,3.0,5.0,6.0,5.0,3.0,6.0,3.0,4.0,6.0,3.0,5.0,5.0,11,,,,,,,,,,,,,,,,,,,,,,,,,,,,,,,,,7,,,,,,,,,,,,,,,,,,,,,,,,,,,,,,,,,5,,,,,,,,,,,,,,,,,,,,,,,,,,,,,,,,,10,,,,,,,,,,,,,,,,,,,,,,,,,,,,,,,,,9,,,,,,,,,,,,,,,,,,,,,,,,,,,,,,,,,0,3.0,5.0,3.0,2.0,5.0,2.0,6.0,5.0,6.0,4.0,4.0,6.0,2.0,6.0,3.0,5.0,5.0,1.0,3.0,3.0,3.0,5.0,2.0,3.0,5.0,2.0,4.0,3.0,6.0,3.0,2.0,4.0,14,,,,,,,,,,,,,,,,,,,,,,,,,,,,,,,,,6,,,,,,,,,,,,,,,,,,,,,,,,,,,,,,,,,13,,,,,,,,,,,,,,,,,,,,,,,,,,,,,,,,,2,6.0,7.0,6.0,5.0,6.0,6.0,2.0,6.0,6.0,5.0,6.0,6.0,5.0,5.0,5.0,6.0,7.0,4.0,6.0,4.0,4.0,6.0,6.0,6.0,6.0,6.0,3.0,6.0,6.0,4.0,6.0,1.0,,342.99,26.21,,,,32.33,,42.63,,,,,,,,,,,,,,66.15,,,,,,,,,,,,,,,,,,118.04,,,,,,,,,,,,55.17,,,2.46,,APPROVED,Male,21.0,FALSE
567,2022-03-22 01:05:49,19,en,990511901,2022-03-22 00:50:15,2022-03-22 01:05:49,Y,Y,A1,,,6,,,,,,,,,,,,,,,,,,,,,,,,,,,,,,,,,0,7.0,7.0,7.0,7.0,6.0,7.0,1.0,7.0,7.0,7.0,7.0,7.0,7.0,4.0,4.0,7.0,7.0,4.0,7.0,7.0,4.0,7.0,7.0,7.0,7.0,7.0,4.0,7.0,7.0,7.0,7.0,2.0,1,7.0,7.0,7.0,7.0,7.0,7.0,1.0,7.0,7.0,7.0,7.0,7.0,7.0,4.0,7.0,7.0,7.0,4.0,7.0,7.0,4.0,7.0,7.0,7.0,7.0,7.0,7.0,7.0,7.0,7.0,4.0,1.0,12,,,,,,,,,,,,,,,,,,,,,,,,,,,,,,,,,11,,,,,,,,,,,,,,,,,,,,,,,,,,,,,,,,,13,,,,,,,,,,,,,,,,,,,,,,,,,,,,,,,,,10,,,,,,,,,,,,,,,,,,,,,,,,,,,,,,,,,5,,,,,,,,,,,,,,,,,,,,,,,,,,,,,,,,,7,,,,,,,,,,,,,,,,,,,,,,,,,,,,,,,,,8,,,,,,,,,,,,,,,,,,,,,,,,,,,,,,,,,9,,,,,,,,,,,,,,,,,,,,,,,,,,,,,,,,,2,5.0,6.0,5.0,4.0,4.0,5.0,2.0,5.0,5.0,4.0,4.0,4.0,4.0,4.0,5.0,4.0,7.0,4.0,5.0,4.0,3.0,5.0,4.0,4.0,4.0,4.0,4.0,4.0,4.0,5.0,4.0,5.0,3,,,,,,,,,,,,,,,,,,,,,,,,,,,,,,,,,14,,,,,,,,,,,,,,,,,,,,,,,,,,,,,,,,,4,,,,,,,,,,,,,,,,,,,,,,,,,,,,,,,,,"It was really interesting! I found it really fun to do, and because I had never seen the last two visualizations in my life, I found them confusing yet amazing, and I'd really love to know the data and meaning behind them, so I'll search them once I'm done here. Thank you and best of luck!",937.38,23.44,,,,5.76,,185.56,,,,,162.21,,,110.6,,,,,,,,,,,,,,,,,,,,,,,,,,,242.02,,,,,,,,,,,,207.79,,APPROVED,Female,24.0,FALSE
568,2022-03-22 00:58:18,19,en,975716090,2022-03-22 00:50:16,2022-03-22 00:58:18,Y,Y,A1,,,11,,,,,,,,,,,,,,,,,,,,,,,,,,,,,,,,,1,6.0,5.0,5.0,5.0,6.0,6.0,2.0,5.0,4.0,5.0,6.0,5.0,5.0,5.0,5.0,5.0,5.0,6.0,6.0,6.0,5.0,5.0,6.0,6.0,5.0,6.0,4.0,5.0,4.0,5.0,6.0,2.0,7,,,,,,,,,,,,,,,,,,,,,,,,,,,,,,,,,2,6.0,6.0,5.0,4.0,5.0,6.0,1.0,5.0,6.0,5.0,4.0,5.0,5.0,5.0,5.0,5.0,5.0,4.0,5.0,6.0,6.0,5.0,5.0,6.0,5.0,6.0,6.0,6.0,5.0,6.0,6.0,4.0,8,,,,,,,,,,,,,,,,,,,,,,,,,,,,,,,,,0,3.0,5.0,3.0,3.0,5.0,2.0,5.0,6.0,6.0,5.0,3.0,3.0,3.0,3.0,4.0,3.0,5.0,3.0,4.0,4.0,5.0,4.0,2.0,5.0,4.0,5.0,5.0,5.0,4.0,5.0,4.0,6.0,12,,,,,,,,,,,,,,,,,,,,,,,,,,,,,,,,,6,,,,,,,,,,,,,,,,,,,,,,,,,,,,,,,,,9,,,,,,,,,,,,,,,,,,,,,,,,,,,,,,,,,13,,,,,,,,,,,,,,,,,,,,,,,,,,,,,,,,,3,,,,,,,,,,,,,,,,,,,,,,,,,,,,,,,,,4,,,,,,,,,,,,,,,,,,,,,,,,,,,,,,,,,5,,,,,,,,,,,,,,,,,,,,,,,,,,,,,,,,,10,,,,,,,,,,,,,,,,,,,,,,,,,,,,,,,,,14,,,,,,,,,,,,,,,,,,,,,,,,,,,,,,,,,,486.47,64.81,,,,13.03,,58.74,,,,,93.83,,,,,,92.86,,,,,,117.89,,,,,,,,,,,,,,,,,,,,,,,,,,,,,,45.31,,APPROVED,Male,26.0,FALSE
569,2022-03-22 00:55:43,19,en,1441598411,2022-03-22 00:50:19,2022-03-22 00:55:43,Y,Y,-oth-,2 year degree,,13,,,,,,,,,,,,,,,,,,,,,,,,,,,,,,,,,0,5.0,3.0,5.0,5.0,5.0,7.0,1.0,7.0,4.0,4.0,5.0,6.0,6.0,4.0,4.0,4.0,4.0,6.0,6.0,4.0,3.0,5.0,7.0,6.0,6.0,6.0,2.0,4.0,2.0,5.0,6.0,2.0,9,,,,,,,,,,,,,,,,,,,,,,,,,,,,,,,,,14,,,,,,,,,,,,,,,,,,,,,,,,,,,,,,,,,8,,,,,,,,,,,,,,,,,,,,,,,,,,,,,,,,,2,6.0,6.0,7.0,3.0,7.0,2.0,7.0,6.0,6.0,4.0,3.0,7.0,5.0,7.0,7.0,4.0,7.0,5.0,6.0,6.0,5.0,6.0,2.0,6.0,7.0,4.0,7.0,6.0,4.0,4.0,4.0,6.0,11,,,,,,,,,,,,,,,,,,,,,,,,,,,,,,,,,1,5.0,3.0,2.0,2.0,3.0,1.0,7.0,2.0,2.0,1.0,2.0,5.0,3.0,1.0,6.0,3.0,4.0,3.0,3.0,3.0,2.0,3.0,2.0,4.0,3.0,2.0,4.0,3.0,2.0,4.0,3.0,1.0,3,,,,,,,,,,,,,,,,,,,,,,,,,,,,,,,,,12,,,,,,,,,,,,,,,,,,,,,,,,,,,,,,,,,5,,,,,,,,,,,,,,,,,,,,,,,,,,,,,,,,,10,,,,,,,,,,,,,,,,,,,,,,,,,,,,,,,,,7,,,,,,,,,,,,,,,,,,,,,,,,,,,,,,,,,4,,,,,,,,,,,,,,,,,,,,,,,,,,,,,,,,,6,,,,,,,,,,,,,,,,,,,,,,,,,,,,,,,,,,326.75,39.39,,,,15.02,,28.31,,,,,84.53,,,,,,,,,,,,74.41,,,,,,81.71,,,,,,,,,,,,,,,,,,,,,,,,3.38,,APPROVED,Male,25.0,FALSE
570,2022-03-22 00:55:36,19,en,214655291,2022-03-22 00:50:19,2022-03-22 00:55:36,Y,Y,A1,,,13,,,,,,,,,,,,,,,,,,,,,,,,,,,,,,,,,9,,,,,,,,,,,,,,,,,,,,,,,,,,,,,,,,,11,,,,,,,,,,,,,,,,,,,,,,,,,,,,,,,,,1,5.0,6.0,6.0,3.0,5.0,2.0,7.0,5.0,6.0,4.0,4.0,3.0,4.0,5.0,5.0,2.0,5.0,3.0,4.0,4.0,4.0,6.0,2.0,5.0,5.0,2.0,4.0,4.0,2.0,5.0,3.0,4.0,10,,,,,,,,,,,,,,,,,,,,,,,,,,,,,,,,,5,,,,,,,,,,,,,,,,,,,,,,,,,,,,,,,,,7,,,,,,,,,,,,,,,,,,,,,,,,,,,,,,,,,3,,,,,,,,,,,,,,,,,,,,,,,,,,,,,,,,,6,,,,,,,,,,,,,,,,,,,,,,,,,,,,,,,,,4,,,,,,,,,,,,,,,,,,,,,,,,,,,,,,,,,8,,,,,,,,,,,,,,,,,,,,,,,,,,,,,,,,,0,6.0,7.0,6.0,6.0,6.0,6.0,3.0,6.0,7.0,6.0,6.0,5.0,6.0,6.0,6.0,5.0,6.0,6.0,6.0,6.0,4.0,6.0,5.0,6.0,6.0,5.0,5.0,6.0,5.0,6.0,6.0,5.0,2,1.0,3.0,1.0,1.0,2.0,3.0,6.0,4.0,3.0,2.0,3.0,2.0,1.0,1.0,2.0,1.0,1.0,1.0,2.0,2.0,2.0,3.0,1.0,2.0,4.0,2.0,2.0,2.0,2.0,3.0,2.0,6.0,14,,,,,,,,,,,,,,,,,,,,,,,,,,,,,,,,,12,,,,,,,,,,,,,,,,,,,,,,,,,,,,,,,,,,322.34,33.97,,,,8.81,,39.37,,,,,,,,,,,80.77,,,,,,,,,,,,,,,,,,,,,,,,94.12,,,61.46,,,,,,,,,3.84,,APPROVED,Male,36.0,FALSE
571,2022-03-22 00:57:51,19,en,1791672958,2022-03-22 00:50:21,2022-03-22 00:57:51,Y,Y,A1,,,9,,,,,,,,,,,,,,,,,,,,,,,,,,,,,,,,,6,,,,,,,,,,,,,,,,,,,,,,,,,,,,,,,,,8,,,,,,,,,,,,,,,,,,,,,,,,,,,,,,,,,2,7.0,7.0,7.0,5.0,7.0,5.0,1.0,6.0,7.0,6.0,7.0,7.0,7.0,7.0,7.0,5.0,7.0,7.0,5.0,7.0,6.0,7.0,5.0,7.0,7.0,6.0,6.0,7.0,7.0,7.0,7.0,4.0,3,,,,,,,,,,,,,,,,,,,,,,,,,,,,,,,,,12,,,,,,,,,,,,,,,,,,,,,,,,,,,,,,,,,7,,,,,,,,,,,,,,,,,,,,,,,,,,,,,,,,,13,,,,,,,,,,,,,,,,,,,,,,,,,,,,,,,,,10,,,,,,,,,,,,,,,,,,,,,,,,,,,,,,,,,5,,,,,,,,,,,,,,,,,,,,,,,,,,,,,,,,,4,,,,,,,,,,,,,,,,,,,,,,,,,,,,,,,,,0,5.0,4.0,6.0,6.0,6.0,5.0,3.0,7.0,5.0,2.0,5.0,5.0,5.0,3.0,5.0,6.0,7.0,4.0,5.0,5.0,3.0,5.0,4.0,5.0,3.0,7.0,1.0,5.0,4.0,3.0,7.0,5.0,11,,,,,,,,,,,,,,,,,,,,,,,,,,,,,,,,,1,6.0,2.0,2.0,7.0,3.0,3.0,2.0,5.0,6.0,2.0,2.0,2.0,5.0,2.0,5.0,2.0,5.0,4.0,3.0,1.0,4.0,3.0,3.0,3.0,2.0,6.0,1.0,2.0,2.0,3.0,6.0,7.0,14,,,,,,,,,,,,,,,,,,,,,,,,,,,,,,,,,,454.01,17.91,,,,7.64,,64.11,,,,,,,,,,,72.48,,,,,,,,,,,,,,,,,,,,,,,,165.99,,,,,,120.49,,,,,,5.39,,APPROVED,Female,19.0,FALSE
572,2022-03-22 00:58:07,19,en,1465436068,2022-03-22 00:50:24,2022-03-22 00:58:07,Y,Y,-oth-,Vocational training,,10,,,,,,,,,,,,,,,,,,,,,,,,,,,,,,,,,1,6.0,2.0,6.0,6.0,4.0,6.0,2.0,6.0,3.0,4.0,6.0,4.0,6.0,3.0,2.0,6.0,4.0,5.0,6.0,4.0,4.0,6.0,6.0,6.0,5.0,6.0,2.0,5.0,4.0,6.0,6.0,2.0,13,,,,,,,,,,,,,,,,,,,,,,,,,,,,,,,,,12,,,,,,,,,,,,,,,,,,,,,,,,,,,,,,,,,4,,,,,,,,,,,,,,,,,,,,,,,,,,,,,,,,,5,,,,,,,,,,,,,,,,,,,,,,,,,,,,,,,,,8,,,,,,,,,,,,,,,,,,,,,,,,,,,,,,,,,9,,,,,,,,,,,,,,,,,,,,,,,,,,,,,,,,,6,,,,,,,,,,,,,,,,,,,,,,,,,,,,,,,,,3,,,,,,,,,,,,,,,,,,,,,,,,,,,,,,,,,7,,,,,,,,,,,,,,,,,,,,,,,,,,,,,,,,,2,5.0,6.0,5.0,4.0,5.0,5.0,3.0,4.0,5.0,2.0,5.0,4.0,4.0,4.0,5.0,4.0,5.0,4.0,5.0,3.0,4.0,5.0,4.0,5.0,5.0,4.0,5.0,5.0,4.0,5.0,4.0,5.0,14,,,,,,,,,,,,,,,,,,,,,,,,,,,,,,,,,11,,,,,,,,,,,,,,,,,,,,,,,,,,,,,,,,,0,2.0,5.0,2.0,4.0,2.0,2.0,6.0,3.0,4.0,2.0,3.0,2.0,2.0,4.0,4.0,2.0,4.0,2.0,2.0,2.0,2.0,3.0,2.0,2.0,2.0,2.0,5.0,3.0,3.0,4.0,4.0,1.0,,466.76,65.61,,,,15.27,,33.88,,,,,108.28,,,,,,,,,,,,,,,,,,,,,,,,,,,,,,104.42,,,,,,,,,136.25,,,3.05,,APPROVED,Male,31.0,FALSE
573,2022-03-22 01:05:32,19,en,1353409863,2022-03-22 00:50:24,2022-03-22 01:05:32,Y,Y,-oth-,High school,,10,,,,,,,,,,,,,,,,,,,,,,,,,,,,,,,,,2,6.0,4.0,5.0,6.0,5.0,7.0,1.0,6.0,1.0,6.0,6.0,5.0,5.0,4.0,4.0,5.0,5.0,5.0,6.0,5.0,4.0,6.0,7.0,6.0,5.0,7.0,4.0,5.0,6.0,5.0,6.0,2.0,11,,,,,,,,,,,,,,,,,,,,,,,,,,,,,,,,,1,3.0,6.0,5.0,5.0,6.0,3.0,3.0,6.0,7.0,2.0,5.0,3.0,2.0,4.0,6.0,5.0,6.0,4.0,4.0,5.0,4.0,5.0,4.0,5.0,6.0,3.0,1.0,6.0,4.0,4.0,2.0,4.0,8,,,,,,,,,,,,,,,,,,,,,,,,,,,,,,,,,5,,,,,,,,,,,,,,,,,,,,,,,,,,,,,,,,,13,,,,,,,,,,,,,,,,,,,,,,,,,,,,,,,,,12,,,,,,,,,,,,,,,,,,,,,,,,,,,,,,,,,0,2.0,1.0,1.0,1.0,1.0,1.0,7.0,1.0,3.0,1.0,1.0,1.0,1.0,2.0,2.0,1.0,4.0,1.0,1.0,1.0,1.0,1.0,2.0,1.0,1.0,1.0,1.0,1.0,4.0,1.0,1.0,2.0,6,,,,,,,,,,,,,,,,,,,,,,,,,,,,,,,,,9,,,,,,,,,,,,,,,,,,,,,,,,,,,,,,,,,14,,,,,,,,,,,,,,,,,,,,,,,,,,,,,,,,,7,,,,,,,,,,,,,,,,,,,,,,,,,,,,,,,,,4,,,,,,,,,,,,,,,,,,,,,,,,,,,,,,,,,3,,,,,,,,,,,,,,,,,,,,,,,,,,,,,,,,,,912.04,208.68,,,,129.47,,44.9,,,,,125.53,,,,,,144.52,,,,,,,,,,,,,,,253.03,,,,,,,,,,,,,,,,,,,,,5.91,,APPROVED,Female,31.0,FALSE
574,2022-03-22 00:54:40,19,en,194454948,2022-03-22 00:50:26,2022-03-22 00:54:40,Y,Y,A1,,,14,,,,,,,,,,,,,,,,,,,,,,,,,,,,,,,,,1,6.0,4.0,6.0,5.0,5.0,6.0,3.0,6.0,3.0,5.0,5.0,6.0,6.0,5.0,5.0,5.0,6.0,5.0,5.0,6.0,4.0,6.0,6.0,5.0,6.0,6.0,3.0,5.0,4.0,6.0,5.0,2.0,6,,,,,,,,,,,,,,,,,,,,,,,,,,,,,,,,,13,,,,,,,,,,,,,,,,,,,,,,,,,,,,,,,,,4,,,,,,,,,,,,,,,,,,,,,,,,,,,,,,,,,11,,,,,,,,,,,,,,,,,,,,,,,,,,,,,,,,,12,,,,,,,,,,,,,,,,,,,,,,,,,,,,,,,,,5,,,,,,,,,,,,,,,,,,,,,,,,,,,,,,,,,9,,,,,,,,,,,,,,,,,,,,,,,,,,,,,,,,,0,5.0,6.0,3.0,2.0,3.0,3.0,7.0,4.0,5.0,3.0,4.0,3.0,3.0,5.0,6.0,4.0,5.0,2.0,4.0,4.0,4.0,4.0,3.0,3.0,3.0,3.0,5.0,3.0,5.0,4.0,3.0,3.0,3,,,,,,,,,,,,,,,,,,,,,,,,,,,,,,,,,2,5.0,6.0,3.0,6.0,5.0,3.0,3.0,6.0,5.0,5.0,5.0,6.0,5.0,6.0,5.0,5.0,6.0,4.0,5.0,5.0,5.0,5.0,5.0,5.0,5.0,5.0,6.0,5.0,3.0,4.0,4.0,5.0,10,,,,,,,,,,,,,,,,,,,,,,,,,,,,,,,,,7,,,,,,,,,,,,,,,,,,,,,,,,,,,,,,,,,8,,,,,,,,,,,,,,,,,,,,,,,,,,,,,,,,,,257.4,10.38,,,,6.33,,28.54,,,,,71.71,,,,,,,,,,,,,,,,,,,,,,,,70.26,,,,,,65.91,,,,,,,,,,,,4.27,,APPROVED,Male,21.0,FALSE
575,2022-03-22 01:00:42,19,en,471963481,2022-03-22 00:50:27,2022-03-22 01:00:42,Y,Y,A1,,,11,,,,,,,,,,,,,,,,,,,,,,,,,,,,,,,,,13,,,,,,,,,,,,,,,,,,,,,,,,,,,,,,,,,4,,,,,,,,,,,,,,,,,,,,,,,,,,,,,,,,,2,1.0,6.0,1.0,1.0,5.0,1.0,7.0,5.0,6.0,1.0,1.0,1.0,1.0,4.0,1.0,1.0,5.0,1.0,2.0,1.0,1.0,3.0,1.0,1.0,5.0,1.0,6.0,1.0,1.0,1.0,1.0,4.0,1,2.0,5.0,2.0,3.0,2.0,3.0,7.0,5.0,5.0,2.0,4.0,6.0,3.0,5.0,6.0,3.0,5.0,2.0,5.0,2.0,5.0,4.0,2.0,2.0,3.0,5.0,1.0,2.0,4.0,4.0,5.0,5.0,7,,,,,,,,,,,,,,,,,,,,,,,,,,,,,,,,,0,2.0,6.0,2.0,3.0,2.0,2.0,6.0,1.0,6.0,3.0,2.0,2.0,3.0,4.0,5.0,2.0,5.0,2.0,2.0,5.0,4.0,3.0,2.0,2.0,2.0,3.0,4.0,2.0,4.0,3.0,3.0,7.0,10,,,,,,,,,,,,,,,,,,,,,,,,,,,,,,,,,9,,,,,,,,,,,,,,,,,,,,,,,,,,,,,,,,,3,,,,,,,,,,,,,,,,,,,,,,,,,,,,,,,,,12,,,,,,,,,,,,,,,,,,,,,,,,,,,,,,,,,8,,,,,,,,,,,,,,,,,,,,,,,,,,,,,,,,,5,,,,,,,,,,,,,,,,,,,,,,,,,,,,,,,,,6,,,,,,,,,,,,,,,,,,,,,,,,,,,,,,,,,14,,,,,,,,,,,,,,,,,,,,,,,,,,,,,,,,,,618.37,38.01,,,,25.86,,41.3,,,,,,,,,,,111.25,,,246.07,,,,,,150.48,,,,,,,,,,,,,,,,,,,,,,,,,,,5.4,,APPROVED,Female,21.0,FALSE
576,2022-03-22 00:55:00,19,en,1319992466,2022-03-22 00:50:28,2022-03-22 00:55:00,Y,Y,A1,,,2,1.0,1.0,1.0,1.0,1.0,1.0,7.0,1.0,3.0,1.0,2.0,1.0,2.0,1.0,2.0,1.0,1.0,1.0,1.0,1.0,1.0,1.0,1.0,1.0,1.0,2.0,5.0,1.0,1.0,1.0,2.0,1.0,1,7.0,7.0,7.0,7.0,6.0,7.0,2.0,7.0,7.0,6.0,7.0,6.0,6.0,5.0,6.0,6.0,7.0,6.0,6.0,6.0,6.0,7.0,7.0,7.0,7.0,7.0,4.0,7.0,7.0,6.0,7.0,2.0,4,,,,,,,,,,,,,,,,,,,,,,,,,,,,,,,,,9,,,,,,,,,,,,,,,,,,,,,,,,,,,,,,,,,7,,,,,,,,,,,,,,,,,,,,,,,,,,,,,,,,,14,,,,,,,,,,,,,,,,,,,,,,,,,,,,,,,,,8,,,,,,,,,,,,,,,,,,,,,,,,,,,,,,,,,12,,,,,,,,,,,,,,,,,,,,,,,,,,,,,,,,,5,,,,,,,,,,,,,,,,,,,,,,,,,,,,,,,,,3,,,,,,,,,,,,,,,,,,,,,,,,,,,,,,,,,6,,,,,,,,,,,,,,,,,,,,,,,,,,,,,,,,,0,3.0,6.0,3.0,2.0,5.0,3.0,6.0,3.0,6.0,4.0,5.0,2.0,3.0,4.0,3.0,2.0,5.0,4.0,5.0,5.0,4.0,5.0,2.0,5.0,3.0,2.0,2.0,5.0,5.0,5.0,5.0,5.0,13,,,,,,,,,,,,,,,,,,,,,,,,,,,,,,,,,11,,,,,,,,,,,,,,,,,,,,,,,,,,,,,,,,,10,,,,,,,,,,,,,,,,,,,,,,,,,,,,,,,,,,275.9,23.53,,,,7.4,,30.47,,56.86,,,56.26,,,,,,,,,,,,,,,,,,,,,,,,,,,,,,97.62,,,,,,,,,,,,3.76,,APPROVED,Male,29.0,FALSE
577,2022-03-22 00:58:12,19,en,1660423796,2022-03-22 00:50:28,2022-03-22 00:58:12,Y,Y,A1,,,4,,,,,,,,,,,,,,,,,,,,,,,,,,,,,,,,,1,6.0,4.0,6.0,7.0,4.0,7.0,1.0,7.0,4.0,6.0,6.0,6.0,6.0,6.0,4.0,6.0,6.0,6.0,6.0,4.0,5.0,6.0,7.0,6.0,4.0,7.0,6.0,7.0,5.0,6.0,4.0,2.0,5,,,,,,,,,,,,,,,,,,,,,,,,,,,,,,,,,0,5.0,6.0,6.0,5.0,6.0,5.0,2.0,3.0,6.0,6.0,6.0,5.0,6.0,6.0,6.0,5.0,6.0,3.0,5.0,4.0,5.0,7.0,3.0,6.0,4.0,6.0,6.0,6.0,6.0,5.0,6.0,4.0,6,,,,,,,,,,,,,,,,,,,,,,,,,,,,,,,,,12,,,,,,,,,,,,,,,,,,,,,,,,,,,,,,,,,14,,,,,,,,,,,,,,,,,,,,,,,,,,,,,,,,,10,,,,,,,,,,,,,,,,,,,,,,,,,,,,,,,,,2,1.0,5.0,1.0,1.0,4.0,1.0,1.0,1.0,1.0,1.0,1.0,1.0,1.0,1.0,2.0,1.0,1.0,1.0,1.0,1.0,1.0,1.0,2.0,2.0,4.0,1.0,5.0,4.0,1.0,1.0,1.0,2.0,11,,,,,,,,,,,,,,,,,,,,,,,,,,,,,,,,,7,,,,,,,,,,,,,,,,,,,,,,,,,,,,,,,,,13,,,,,,,,,,,,,,,,,,,,,,,,,,,,,,,,,8,,,,,,,,,,,,,,,,,,,,,,,,,,,,,,,,,3,,,,,,,,,,,,,,,,,,,,,,,,,,,,,,,,,9,,,,,,,,,,,,,,,,,,,,,,,,,,,,,,,,,,466.94,22.21,,,,15.25,,10.51,,,,,220.08,,,,,,82.57,,,,,,,,,,,,,,,112.66,,,,,,,,,,,,,,,,,,,,,3.66,,APPROVED,Female,23.0,FALSE
578,2022-03-22 00:57:30,19,en,1900272345,2022-03-22 00:50:29,2022-03-22 00:57:30,Y,Y,A1,,,14,,,,,,,,,,,,,,,,,,,,,,,,,,,,,,,,,2,6.0,3.0,4.0,4.0,5.0,6.0,2.0,7.0,4.0,6.0,5.0,6.0,6.0,3.0,5.0,6.0,5.0,6.0,5.0,5.0,4.0,6.0,6.0,6.0,5.0,6.0,3.0,7.0,5.0,6.0,6.0,2.0,7,,,,,,,,,,,,,,,,,,,,,,,,,,,,,,,,,6,,,,,,,,,,,,,,,,,,,,,,,,,,,,,,,,,0,2.0,3.0,4.0,3.0,2.0,2.0,6.0,4.0,4.0,2.0,2.0,5.0,4.0,1.0,3.0,1.0,4.0,4.0,3.0,2.0,4.0,1.0,3.0,2.0,2.0,6.0,2.0,2.0,5.0,5.0,3.0,5.0,12,,,,,,,,,,,,,,,,,,,,,,,,,,,,,,,,,1,1.0,1.0,1.0,2.0,1.0,1.0,3.0,3.0,1.0,1.0,1.0,1.0,1.0,1.0,1.0,3.0,3.0,1.0,1.0,1.0,1.0,2.0,2.0,1.0,1.0,1.0,2.0,1.0,1.0,1.0,3.0,7.0,13,,,,,,,,,,,,,,,,,,,,,,,,,,,,,,,,,8,,,,,,,,,,,,,,,,,,,,,,,,,,,,,,,,,9,,,,,,,,,,,,,,,,,,,,,,,,,,,,,,,,,3,,,,,,,,,,,,,,,,,,,,,,,,,,,,,,,,,11,,,,,,,,,,,,,,,,,,,,,,,,,,,,,,,,,5,,,,,,,,,,,,,,,,,,,,,,,,,,,,,,,,,10,,,,,,,,,,,,,,,,,,,,,,,,,,,,,,,,,4,,,,,,,,,,,,,,,,,,,,,,,,,,,,,,,,,,425.64,20.69,,,,9.02,,16.11,,,,,69.27,,,,,,,,,116.74,,,,,,130.11,,,,,,,,,,,,,,,,,,,,,,,,,,,63.7,,APPROVED,Female,24.0,FALSE
579,2022-03-22 00:55:21,19,en,390724696,2022-03-22 00:50:29,2022-03-22 00:55:21,Y,Y,A1,,,10,,,,,,,,,,,,,,,,,,,,,,,,,,,,,,,,,6,,,,,,,,,,,,,,,,,,,,,,,,,,,,,,,,,14,,,,,,,,,,,,,,,,,,,,,,,,,,,,,,,,,5,,,,,,,,,,,,,,,,,,,,,,,,,,,,,,,,,0,1.0,2.0,2.0,1.0,2.0,2.0,7.0,3.0,4.0,2.0,1.0,5.0,2.0,2.0,4.0,1.0,3.0,1.0,2.0,2.0,1.0,2.0,1.0,1.0,2.0,4.0,4.0,1.0,7.0,1.0,4.0,5.0,3,,,,,,,,,,,,,,,,,,,,,,,,,,,,,,,,,9,,,,,,,,,,,,,,,,,,,,,,,,,,,,,,,,,8,,,,,,,,,,,,,,,,,,,,,,,,,,,,,,,,,7,,,,,,,,,,,,,,,,,,,,,,,,,,,,,,,,,13,,,,,,,,,,,,,,,,,,,,,,,,,,,,,,,,,4,,,,,,,,,,,,,,,,,,,,,,,,,,,,,,,,,2,3.0,3.0,4.0,6.0,3.0,5.0,3.0,6.0,3.0,4.0,3.0,6.0,4.0,5.0,6.0,4.0,7.0,2.0,4.0,4.0,4.0,4.0,5.0,4.0,4.0,7.0,6.0,4.0,6.0,4.0,5.0,5.0,12,,,,,,,,,,,,,,,,,,,,,,,,,,,,,,,,,11,,,,,,,,,,,,,,,,,,,,,,,,,,,,,,,,,1,5.0,7.0,6.0,2.0,6.0,3.0,4.0,5.0,7.0,5.0,4.0,6.0,5.0,6.0,7.0,4.0,7.0,6.0,6.0,5.0,5.0,6.0,2.0,5.0,6.0,2.0,6.0,5.0,7.0,5.0,5.0,1.0,No comment.,294.61,10.22,,,,11.52,,39.18,,,,,,,,,,,,,,85.38,,,,,,,,,,,,,,,,,,,,,72.16,,,,,,,,,66.73,,,9.42,,APPROVED,Female,19.0,FALSE
580,2022-03-22 00:58:08,19,en,144869771,2022-03-22 00:50:29,2022-03-22 00:58:08,Y,Y,A1,,,8,,,,,,,,,,,,,,,,,,,,,,,,,,,,,,,,,4,,,,,,,,,,,,,,,,,,,,,,,,,,,,,,,,,2,6.0,6.0,4.0,4.0,6.0,6.0,6.0,6.0,6.0,4.0,4.0,5.0,6.0,4.0,4.0,5.0,6.0,5.0,5.0,4.0,6.0,5.0,6.0,4.0,4.0,6.0,4.0,6.0,6.0,4.0,6.0,3.0,5,,,,,,,,,,,,,,,,,,,,,,,,,,,,,,,,,9,,,,,,,,,,,,,,,,,,,,,,,,,,,,,,,,,6,,,,,,,,,,,,,,,,,,,,,,,,,,,,,,,,,13,,,,,,,,,,,,,,,,,,,,,,,,,,,,,,,,,12,,,,,,,,,,,,,,,,,,,,,,,,,,,,,,,,,14,,,,,,,,,,,,,,,,,,,,,,,,,,,,,,,,,10,,,,,,,,,,,,,,,,,,,,,,,,,,,,,,,,,0,5.0,6.0,6.0,4.0,6.0,4.0,6.0,7.0,5.0,4.0,6.0,5.0,4.0,4.0,3.0,5.0,5.0,3.0,3.0,4.0,3.0,4.0,3.0,3.0,6.0,4.0,5.0,4.0,6.0,3.0,4.0,4.0,1,2.0,2.0,1.0,5.0,2.0,4.0,6.0,4.0,5.0,2.0,3.0,2.0,2.0,4.0,4.0,4.0,2.0,2.0,2.0,2.0,2.0,2.0,4.0,2.0,1.0,4.0,2.0,2.0,2.0,4.0,4.0,5.0,11,,,,,,,,,,,,,,,,,,,,,,,,,,,,,,,,,3,,,,,,,,,,,,,,,,,,,,,,,,,,,,,,,,,7,,,,,,,,,,,,,,,,,,,,,,,,,,,,,,,,,,459.57,37.95,,,,4.12,,70.12,,,,,,,,89.51,,,,,,,,,,,,,,,,,,,,,,,,89.44,,,165.97,,,,,,,,,,,,2.46,,APPROVED,Male,24.0,FALSE
581,2022-03-22 01:07:35,19,en,595523137,2022-03-22 00:50:30,2022-03-22 01:07:35,Y,Y,A1,,,2,2.0,6.0,2.0,2.0,2.0,2.0,2.0,2.0,6.0,2.0,2.0,2.0,2.0,2.0,2.0,2.0,2.0,2.0,2.0,2.0,2.0,2.0,2.0,2.0,2.0,2.0,2.0,2.0,2.0,2.0,2.0,1.0,8,,,,,,,,,,,,,,,,,,,,,,,,,,,,,,,,,5,,,,,,,,,,,,,,,,,,,,,,,,,,,,,,,,,7,,,,,,,,,,,,,,,,,,,,,,,,,,,,,,,,,4,,,,,,,,,,,,,,,,,,,,,,,,,,,,,,,,,1,2.0,6.0,2.0,2.0,6.0,2.0,6.0,2.0,6.0,2.0,4.0,2.0,2.0,2.0,2.0,2.0,4.0,2.0,2.0,2.0,2.0,2.0,2.0,2.0,4.0,2.0,2.0,2.0,6.0,2.0,2.0,6.0,12,,,,,,,,,,,,,,,,,,,,,,,,,,,,,,,,,0,2.0,4.0,3.0,4.0,4.0,3.0,4.0,2.0,4.0,4.0,2.0,5.0,3.0,3.0,3.0,5.0,6.0,3.0,4.0,4.0,4.0,4.0,5.0,3.0,3.0,2.0,2.0,5.0,2.0,4.0,2.0,1.0,13,,,,,,,,,,,,,,,,,,,,,,,,,,,,,,,,,3,,,,,,,,,,,,,,,,,,,,,,,,,,,,,,,,,11,,,,,,,,,,,,,,,,,,,,,,,,,,,,,,,,,10,,,,,,,,,,,,,,,,,,,,,,,,,,,,,,,,,14,,,,,,,,,,,,,,,,,,,,,,,,,,,,,,,,,9,,,,,,,,,,,,,,,,,,,,,,,,,,,,,,,,,6,,,,,,,,,,,,,,,,,,,,,,,,,,,,,,,,,,1028.63,32.82,,,,13.77,,104.99,,121.27,,,,,,,,,,,,,,,162.98,,,,,,588.86,,,,,,,,,,,,,,,,,,,,,,,,3.94,,APPROVED,Male,25.0,FALSE
582,2022-03-22 01:00:26,19,en,1719675479,2022-03-22 00:50:32,2022-03-22 01:00:26,Y,Y,A1,,,0,3.0,6.0,3.0,1.0,2.0,1.0,6.0,4.0,6.0,3.0,3.0,4.0,4.0,5.0,6.0,4.0,6.0,1.0,2.0,2.0,2.0,2.0,1.0,2.0,5.0,1.0,7.0,5.0,1.0,4.0,4.0,1.0,11,,,,,,,,,,,,,,,,,,,,,,,,,,,,,,,,,1,5.0,6.0,4.0,6.0,4.0,7.0,4.0,4.0,3.0,5.0,4.0,4.0,6.0,4.0,6.0,4.0,6.0,3.0,6.0,5.0,5.0,5.0,6.0,6.0,6.0,5.0,1.0,6.0,6.0,3.0,6.0,3.0,12,,,,,,,,,,,,,,,,,,,,,,,,,,,,,,,,,7,,,,,,,,,,,,,,,,,,,,,,,,,,,,,,,,,6,,,,,,,,,,,,,,,,,,,,,,,,,,,,,,,,,10,,,,,,,,,,,,,,,,,,,,,,,,,,,,,,,,,4,,,,,,,,,,,,,,,,,,,,,,,,,,,,,,,,,3,,,,,,,,,,,,,,,,,,,,,,,,,,,,,,,,,8,,,,,,,,,,,,,,,,,,,,,,,,,,,,,,,,,5,,,,,,,,,,,,,,,,,,,,,,,,,,,,,,,,,14,,,,,,,,,,,,,,,,,,,,,,,,,,,,,,,,,2,6.0,7.0,4.0,3.0,4.0,5.0,5.0,4.0,5.0,4.0,4.0,4.0,5.0,3.0,5.0,5.0,6.0,3.0,6.0,4.0,6.0,5.0,2.0,6.0,6.0,6.0,1.0,2.0,7.0,5.0,5.0,6.0,13,,,,,,,,,,,,,,,,,,,,,,,,,,,,,,,,,9,,,,,,,,,,,,,,,,,,,,,,,,,,,,,,,,,,597.65,185.78,,,,8.63,,62.85,,118.93,,,,,,96.23,,,,,,,,,,,,,,,,,,,,,,,,,,,,,,118.31,,,,,,,,,6.92,,APPROVED,Male,21.0,FALSE
583,2022-03-22 00:54:45,19,en,1296924054,2022-03-22 00:50:42,2022-03-22 00:54:45,Y,Y,A1,,,10,,,,,,,,,,,,,,,,,,,,,,,,,,,,,,,,,5,,,,,,,,,,,,,,,,,,,,,,,,,,,,,,,,,8,,,,,,,,,,,,,,,,,,,,,,,,,,,,,,,,,7,,,,,,,,,,,,,,,,,,,,,,,,,,,,,,,,,11,,,,,,,,,,,,,,,,,,,,,,,,,,,,,,,,,14,,,,,,,,,,,,,,,,,,,,,,,,,,,,,,,,,13,,,,,,,,,,,,,,,,,,,,,,,,,,,,,,,,,12,,,,,,,,,,,,,,,,,,,,,,,,,,,,,,,,,0,2.0,2.0,2.0,2.0,2.0,2.0,6.0,2.0,2.0,2.0,2.0,2.0,2.0,2.0,2.0,2.0,2.0,2.0,2.0,2.0,2.0,2.0,4.0,2.0,2.0,4.0,4.0,2.0,2.0,2.0,2.0,2.0,9,,,,,,,,,,,,,,,,,,,,,,,,,,,,,,,,,3,,,,,,,,,,,,,,,,,,,,,,,,,,,,,,,,,4,,,,,,,,,,,,,,,,,,,,,,,,,,,,,,,,,1,6.0,6.0,6.0,6.0,6.0,6.0,6.0,6.0,6.0,6.0,6.0,6.0,6.0,6.0,6.0,6.0,6.0,6.0,6.0,6.0,6.0,6.0,6.0,6.0,6.0,6.0,6.0,6.0,6.0,6.0,6.0,6.0,6,,,,,,,,,,,,,,,,,,,,,,,,,,,,,,,,,2,2.0,4.0,2.0,2.0,2.0,2.0,2.0,2.0,2.0,2.0,2.0,2.0,2.0,2.0,2.0,2.0,2.0,2.0,2.0,2.0,2.0,2.0,2.0,2.0,2.0,2.0,6.0,2.0,2.0,2.0,2.0,1.0,,244.87,16.17,,,,8.25,,36.28,,,,,,,,,,,,,,,,,,,,,,,,,,76.48,,,,,,,,,,,,43.31,,,,,,59.18,,,5.2,,APPROVED,Male,26.0,FALSE
584,2022-03-22 00:59:57,19,en,1552547528,2022-03-22 00:50:48,2022-03-22 00:59:57,Y,Y,A1,,,10,,,,,,,,,,,,,,,,,,,,,,,,,,,,,,,,,1,6.0,3.0,5.0,7.0,5.0,7.0,1.0,5.0,2.0,2.0,4.0,5.0,6.0,4.0,3.0,6.0,5.0,6.0,6.0,5.0,4.0,6.0,7.0,6.0,6.0,6.0,1.0,6.0,4.0,6.0,4.0,2.0,9,,,,,,,,,,,,,,,,,,,,,,,,,,,,,,,,,11,,,,,,,,,,,,,,,,,,,,,,,,,,,,,,,,,13,,,,,,,,,,,,,,,,,,,,,,,,,,,,,,,,,8,,,,,,,,,,,,,,,,,,,,,,,,,,,,,,,,,14,,,,,,,,,,,,,,,,,,,,,,,,,,,,,,,,,12,,,,,,,,,,,,,,,,,,,,,,,,,,,,,,,,,2,2.0,6.0,2.0,2.0,2.0,1.0,5.0,2.0,7.0,2.0,1.0,2.0,2.0,4.0,6.0,4.0,7.0,4.0,2.0,2.0,1.0,3.0,7.0,2.0,2.0,1.0,5.0,2.0,2.0,1.0,2.0,2.0,0,3.0,6.0,3.0,1.0,3.0,2.0,6.0,4.0,3.0,2.0,4.0,3.0,3.0,4.0,4.0,1.0,4.0,3.0,4.0,2.0,2.0,2.0,2.0,2.0,4.0,5.0,5.0,2.0,5.0,3.0,1.0,3.0,4,,,,,,,,,,,,,,,,,,,,,,,,,,,,,,,,,5,,,,,,,,,,,,,,,,,,,,,,,,,,,,,,,,,6,,,,,,,,,,,,,,,,,,,,,,,,,,,,,,,,,3,,,,,,,,,,,,,,,,,,,,,,,,,,,,,,,,,7,,,,,,,,,,,,,,,,,,,,,,,,,,,,,,,,,,549.91,65.03,,,,5.19,,59.0,,,,,230.61,,,,,,,,,,,,,,,,,,,,,97.07,,,90.93,,,,,,,,,,,,,,,,,,2.08,,APPROVED,Male,26.0,FALSE
585,2022-03-22 00:57:57,19,en,1294834540,2022-03-22 00:51:15,2022-03-22 00:57:56,Y,Y,-oth-,Technical  secondary education diploma,,3,,,,,,,,,,,,,,,,,,,,,,,,,,,,,,,,,7,,,,,,,,,,,,,,,,,,,,,,,,,,,,,,,,,4,,,,,,,,,,,,,,,,,,,,,,,,,,,,,,,,,10,,,,,,,,,,,,,,,,,,,,,,,,,,,,,,,,,11,,,,,,,,,,,,,,,,,,,,,,,,,,,,,,,,,2,6.0,6.0,7.0,6.0,7.0,7.0,4.0,6.0,7.0,7.0,6.0,6.0,7.0,7.0,6.0,5.0,6.0,5.0,7.0,6.0,5.0,7.0,7.0,6.0,7.0,7.0,5.0,7.0,7.0,6.0,7.0,6.0,5,,,,,,,,,,,,,,,,,,,,,,,,,,,,,,,,,1,5.0,4.0,3.0,2.0,3.0,5.0,3.0,3.0,4.0,4.0,3.0,4.0,4.0,4.0,5.0,4.0,2.0,5.0,4.0,4.0,3.0,5.0,3.0,3.0,4.0,4.0,4.0,5.0,3.0,3.0,4.0,1.0,0,2.0,4.0,3.0,2.0,3.0,4.0,7.0,1.0,5.0,4.0,3.0,3.0,2.0,2.0,5.0,3.0,5.0,1.0,2.0,1.0,1.0,3.0,3.0,3.0,2.0,4.0,2.0,2.0,6.0,2.0,2.0,2.0,13,,,,,,,,,,,,,,,,,,,,,,,,,,,,,,,,,9,,,,,,,,,,,,,,,,,,,,,,,,,,,,,,,,,14,,,,,,,,,,,,,,,,,,,,,,,,,,,,,,,,,8,,,,,,,,,,,,,,,,,,,,,,,,,,,,,,,,,12,,,,,,,,,,,,,,,,,,,,,,,,,,,,,,,,,6,,,,,,,,,,,,,,,,,,,,,,,,,,,,,,,,,,405.67,25.94,,,,53.05,,73.38,,,,,,,,,,,,,,,,,70.83,,,,,,78.72,,,100.75,,,,,,,,,,,,,,,,,,,,,3.0,,APPROVED,Male,20.0,FALSE
586,2022-03-22 01:02:37,19,en,344006530,2022-03-22 00:52:14,2022-03-22 01:02:37,Y,Y,A1,,,4,,,,,,,,,,,,,,,,,,,,,,,,,,,,,,,,,11,,,,,,,,,,,,,,,,,,,,,,,,,,,,,,,,,2,6.0,6.0,7.0,6.0,7.0,6.0,6.0,5.0,6.0,6.0,7.0,6.0,6.0,7.0,6.0,7.0,6.0,6.0,6.0,5.0,5.0,7.0,7.0,7.0,6.0,5.0,2.0,6.0,6.0,7.0,6.0,1.0,10,,,,,,,,,,,,,,,,,,,,,,,,,,,,,,,,,9,,,,,,,,,,,,,,,,,,,,,,,,,,,,,,,,,8,,,,,,,,,,,,,,,,,,,,,,,,,,,,,,,,,12,,,,,,,,,,,,,,,,,,,,,,,,,,,,,,,,,1,3.0,2.0,5.0,3.0,7.0,7.0,4.0,5.0,4.0,5.0,5.0,6.0,5.0,6.0,7.0,3.0,4.0,5.0,6.0,7.0,5.0,6.0,5.0,6.0,7.0,5.0,3.0,5.0,3.0,5.0,5.0,1.0,7,,,,,,,,,,,,,,,,,,,,,,,,,,,,,,,,,13,,,,,,,,,,,,,,,,,,,,,,,,,,,,,,,,,5,,,,,,,,,,,,,,,,,,,,,,,,,,,,,,,,,14,,,,,,,,,,,,,,,,,,,,,,,,,,,,,,,,,1,6.0,6.0,5.0,5.0,6.0,6.0,3.0,5.0,7.0,5.0,7.0,7.0,6.0,6.0,5.0,5.0,6.0,6.0,6.0,6.0,7.0,6.0,5.0,5.0,7.0,7.0,4.0,6.0,7.0,5.0,6.0,6.0,3,,,,,,,,,,,,,,,,,,,,,,,,,,,,,,,,,6,,,,,,,,,,,,,,,,,,,,,,,,,,,,,,,,,no thanks,628.32,74.01,,,,17.21,,27.07,,,,,,,,81.37,,,,,,,,,,,,,,,288.28,,,,,,,,,,,,,,,123.03,,,,,,,,,17.35,,APPROVED,Male,28.0,FALSE
587,2022-03-22 01:08:22,19,en,2093773793,2022-03-22 00:57:16,2022-03-22 01:08:22,Y,Y,-oth-,High-school diploma (currently in the 3rd year of my BA),,8,,,,,,,,,,,,,,,,,,,,,,,,,,,,,,,,,13,,,,,,,,,,,,,,,,,,,,,,,,,,,,,,,,,9,,,,,,,,,,,,,,,,,,,,,,,,,,,,,,,,,3,,,,,,,,,,,,,,,,,,,,,,,,,,,,,,,,,7,,,,,,,,,,,,,,,,,,,,,,,,,,,,,,,,,12,,,,,,,,,,,,,,,,,,,,,,,,,,,,,,,,,6,,,,,,,,,,,,,,,,,,,,,,,,,,,,,,,,,0,5.0,6.0,4.0,3.0,4.0,2.0,7.0,6.0,6.0,3.0,2.0,5.0,5.0,5.0,4.0,5.0,6.0,5.0,4.0,4.0,3.0,5.0,2.0,3.0,4.0,2.0,4.0,4.0,5.0,4.0,3.0,1.0,14,,,,,,,,,,,,,,,,,,,,,,,,,,,,,,,,,4,,,,,,,,,,,,,,,,,,,,,,,,,,,,,,,,,1,5.0,5.0,4.0,4.0,4.0,3.0,6.0,7.0,6.0,4.0,5.0,5.0,5.0,5.0,4.0,5.0,6.0,5.0,5.0,4.0,4.0,5.0,3.0,5.0,4.0,3.0,5.0,3.0,4.0,5.0,3.0,4.0,10,,,,,,,,,,,,,,,,,,,,,,,,,,,,,,,,,5,,,,,,,,,,,,,,,,,,,,,,,,,,,,,,,,,2,6.0,4.0,4.0,6.0,4.0,6.0,2.0,6.0,4.0,4.0,2.0,6.0,6.0,6.0,6.0,6.0,6.0,4.0,4.0,4.0,4.0,4.0,7.0,5.0,4.0,7.0,2.0,4.0,2.0,5.0,6.0,7.0,11,,,,,,,,,,,,,,,,,,,,,,,,,,,,,,,,,,669.05,20.83,,,,180.11,,45.99,,,,,,,,,,,,,,,,,,,,,,,144.07,,,,,,,,,156.82,,,,,,,,,117.62,,,,,,3.61,,APPROVED,Female,21.0,FALSE
589,2022-03-22 01:02:04,19,en,1724947871,2022-03-22 00:57:19,2022-03-22 01:02:04,Y,Y,-oth-,High school,,9,,,,,,,,,,,,,,,,,,,,,,,,,,,,,,,,,6,,,,,,,,,,,,,,,,,,,,,,,,,,,,,,,,,2,6.0,5.0,6.0,6.0,5.0,6.0,3.0,7.0,5.0,5.0,4.0,4.0,4.0,4.0,4.0,5.0,6.0,5.0,5.0,4.0,3.0,6.0,5.0,6.0,6.0,5.0,4.0,5.0,4.0,6.0,5.0,3.0,0,3.0,5.0,3.0,3.0,3.0,4.0,5.0,3.0,6.0,2.0,2.0,5.0,3.0,3.0,3.0,3.0,5.0,3.0,4.0,3.0,3.0,3.0,4.0,3.0,3.0,4.0,3.0,3.0,3.0,4.0,4.0,4.0,10,,,,,,,,,,,,,,,,,,,,,,,,,,,,,,,,,11,,,,,,,,,,,,,,,,,,,,,,,,,,,,,,,,,13,,,,,,,,,,,,,,,,,,,,,,,,,,,,,,,,,4,,,,,,,,,,,,,,,,,,,,,,,,,,,,,,,,,12,,,,,,,,,,,,,,,,,,,,,,,,,,,,,,,,,3,,,,,,,,,,,,,,,,,,,,,,,,,,,,,,,,,5,,,,,,,,,,,,,,,,,,,,,,,,,,,,,,,,,7,,,,,,,,,,,,,,,,,,,,,,,,,,,,,,,,,1,5.0,5.0,5.0,5.0,4.0,6.0,2.0,6.0,4.0,3.0,4.0,4.0,3.0,4.0,4.0,4.0,5.0,4.0,3.0,4.0,3.0,5.0,5.0,5.0,4.0,5.0,3.0,4.0,4.0,5.0,5.0,6.0,14,,,,,,,,,,,,,,,,,,,,,,,,,,,,,,,,,8,,,,,,,,,,,,,,,,,,,,,,,,,,,,,,,,,,288.96,17.1,,,,11.85,,40.42,,,,,,,,66.5,,,64.85,,,,,,,,,,,,,,,,,,,,,,,,,,,84.51,,,,,,,,,3.73,,APPROVED,Female,24.0,FALSE
590,2022-03-22 01:02:47,19,en,1348061482,2022-03-22 00:57:21,2022-03-22 01:02:47,Y,Y,-oth-,Some college,,9,,,,,,,,,,,,,,,,,,,,,,,,,,,,,,,,,14,,,,,,,,,,,,,,,,,,,,,,,,,,,,,,,,,13,,,,,,,,,,,,,,,,,,,,,,,,,,,,,,,,,1,6.0,6.0,6.0,6.0,6.0,5.0,6.0,7.0,6.0,6.0,7.0,6.0,6.0,6.0,6.0,6.0,6.0,6.0,6.0,5.0,6.0,6.0,5.0,6.0,6.0,6.0,6.0,5.0,6.0,6.0,6.0,4.0,5,,,,,,,,,,,,,,,,,,,,,,,,,,,,,,,,,0,6.0,6.0,6.0,2.0,6.0,2.0,2.0,6.0,6.0,3.0,3.0,6.0,6.0,7.0,6.0,6.0,6.0,6.0,5.0,6.0,3.0,6.0,3.0,6.0,6.0,5.0,7.0,2.0,6.0,5.0,6.0,6.0,4,,,,,,,,,,,,,,,,,,,,,,,,,,,,,,,,,2,2.0,2.0,2.0,2.0,2.0,1.0,2.0,3.0,2.0,2.0,1.0,2.0,2.0,2.0,2.0,2.0,2.0,2.0,2.0,1.0,2.0,3.0,2.0,2.0,2.0,3.0,3.0,2.0,2.0,2.0,2.0,1.0,7,,,,,,,,,,,,,,,,,,,,,,,,,,,,,,,,,10,,,,,,,,,,,,,,,,,,,,,,,,,,,,,,,,,8,,,,,,,,,,,,,,,,,,,,,,,,,,,,,,,,,12,,,,,,,,,,,,,,,,,,,,,,,,,,,,,,,,,11,,,,,,,,,,,,,,,,,,,,,,,,,,,,,,,,,6,,,,,,,,,,,,,,,,,,,,,,,,,,,,,,,,,3,,,,,,,,,,,,,,,,,,,,,,,,,,,,,,,,,,328.52,11.96,,,,42.45,,49.57,,,,,,,,,,,52.49,,,,,,117.81,,,,,,51.2,,,,,,,,,,,,,,,,,,,,,,,,3.04,,APPROVED,Female,20.0,FALSE
591,2022-03-22 01:08:17,19,en,1747599196,2022-03-22 00:57:21,2022-03-22 01:08:17,Y,Y,A1,,,6,,,,,,,,,,,,,,,,,,,,,,,,,,,,,,,,,5,,,,,,,,,,,,,,,,,,,,,,,,,,,,,,,,,9,,,,,,,,,,,,,,,,,,,,,,,,,,,,,,,,,2,4.0,6.0,5.0,4.0,5.0,2.0,5.0,5.0,6.0,4.0,4.0,4.0,5.0,6.0,5.0,4.0,6.0,4.0,5.0,2.0,3.0,3.0,5.0,4.0,3.0,6.0,5.0,3.0,3.0,3.0,6.0,4.0,8,,,,,,,,,,,,,,,,,,,,,,,,,,,,,,,,,11,,,,,,,,,,,,,,,,,,,,,,,,,,,,,,,,,3,,,,,,,,,,,,,,,,,,,,,,,,,,,,,,,,,12,,,,,,,,,,,,,,,,,,,,,,,,,,,,,,,,,0,4.0,5.0,3.0,6.0,3.0,4.0,6.0,4.0,3.0,3.0,4.0,4.0,3.0,4.0,5.0,3.0,1.0,5.0,5.0,4.0,2.0,5.0,4.0,4.0,3.0,2.0,2.0,3.0,4.0,4.0,4.0,2.0,14,,,,,,,,,,,,,,,,,,,,,,,,,,,,,,,,,1,5.0,7.0,5.0,5.0,4.0,3.0,1.0,2.0,6.0,4.0,3.0,3.0,4.0,3.0,5.0,4.0,6.0,5.0,5.0,3.0,5.0,5.0,2.0,5.0,4.0,2.0,4.0,4.0,4.0,2.0,5.0,4.0,7,,,,,,,,,,,,,,,,,,,,,,,,,,,,,,,,,4,,,,,,,,,,,,,,,,,,,,,,,,,,,,,,,,,13,,,,,,,,,,,,,,,,,,,,,,,,,,,,,,,,,10,,,,,,,,,,,,,,,,,,,,,,,,,,,,,,,,,,661.31,145.13,,,,55.89,,39.79,,,,,,,,,,,108.91,,,,,,,,,,,,,,,137.28,,,,,,170.57,,,,,,,,,,,,,,,3.74,,APPROVED,Male,23.0,FALSE
592,2022-03-22 01:02:59,19,en,958794553,2022-03-22 00:57:22,2022-03-22 01:02:59,Y,Y,A2,,,0,5.0,6.0,6.0,4.0,5.0,2.0,5.0,6.0,7.0,5.0,5.0,5.0,4.0,6.0,6.0,6.0,6.0,2.0,6.0,5.0,3.0,4.0,2.0,4.0,5.0,4.0,1.0,3.0,6.0,4.0,4.0,1.0,9,,,,,,,,,,,,,,,,,,,,,,,,,,,,,,,,,5,,,,,,,,,,,,,,,,,,,,,,,,,,,,,,,,,13,,,,,,,,,,,,,,,,,,,,,,,,,,,,,,,,,12,,,,,,,,,,,,,,,,,,,,,,,,,,,,,,,,,1,6.0,6.0,5.0,7.0,6.0,6.0,4.0,6.0,5.0,5.0,6.0,6.0,6.0,6.0,7.0,7.0,7.0,6.0,6.0,6.0,7.0,6.0,5.0,6.0,6.0,7.0,3.0,6.0,5.0,4.0,6.0,6.0,11,,,,,,,,,,,,,,,,,,,,,,,,,,,,,,,,,10,,,,,,,,,,,,,,,,,,,,,,,,,,,,,,,,,8,,,,,,,,,,,,,,,,,,,,,,,,,,,,,,,,,7,,,,,,,,,,,,,,,,,,,,,,,,,,,,,,,,,14,,,,,,,,,,,,,,,,,,,,,,,,,,,,,,,,,6,,,,,,,,,,,,,,,,,,,,,,,,,,,,,,,,,3,,,,,,,,,,,,,,,,,,,,,,,,,,,,,,,,,2,5.0,3.0,6.0,4.0,4.0,3.0,4.0,5.0,5.0,5.0,3.0,4.0,5.0,6.0,5.0,4.0,5.0,6.0,6.0,3.0,5.0,5.0,6.0,6.0,5.0,4.0,4.0,3.0,5.0,3.0,5.0,7.0,4,,,,,,,,,,,,,,,,,,,,,,,,,,,,,,,,,,340.55,28.71,,,,11.64,,50.21,,99.66,,,,,,,,,,,,,,,69.86,,,,,,,,,,,,,,,,,,,,,,,,77.22,,,,,,3.25,,APPROVED,Female,26.0,FALSE
593,2022-03-22 01:11:16,19,en,1158857172,2022-03-22 00:57:23,2022-03-22 01:11:16,Y,Y,-oth-,Student,,10,,,,,,,,,,,,,,,,,,,,,,,,,,,,,,,,,12,,,,,,,,,,,,,,,,,,,,,,,,,,,,,,,,,11,,,,,,,,,,,,,,,,,,,,,,,,,,,,,,,,,13,,,,,,,,,,,,,,,,,,,,,,,,,,,,,,,,,1,3.0,2.0,2.0,3.0,3.0,1.0,6.0,3.0,2.0,4.0,2.0,1.0,3.0,3.0,3.0,1.0,3.0,2.0,3.0,3.0,1.0,3.0,1.0,2.0,2.0,2.0,3.0,3.0,2.0,3.0,3.0,5.0,2,5.0,5.0,3.0,5.0,4.0,5.0,6.0,6.0,5.0,4.0,3.0,3.0,5.0,4.0,5.0,4.0,5.0,4.0,5.0,5.0,3.0,5.0,4.0,6.0,3.0,2.0,5.0,5.0,3.0,3.0,5.0,6.0,5,,,,,,,,,,,,,,,,,,,,,,,,,,,,,,,,,4,,,,,,,,,,,,,,,,,,,,,,,,,,,,,,,,,8,,,,,,,,,,,,,,,,,,,,,,,,,,,,,,,,,14,,,,,,,,,,,,,,,,,,,,,,,,,,,,,,,,,7,,,,,,,,,,,,,,,,,,,,,,,,,,,,,,,,,9,,,,,,,,,,,,,,,,,,,,,,,,,,,,,,,,,0,5.0,6.0,5.0,2.0,5.0,2.0,6.0,3.0,2.0,4.0,5.0,5.0,5.0,5.0,7.0,3.0,6.0,4.0,5.0,5.0,4.0,5.0,1.0,6.0,5.0,2.0,4.0,6.0,3.0,5.0,3.0,6.0,3,,,,,,,,,,,,,,,,,,,,,,,,,,,,,,,,,6,,,,,,,,,,,,,,,,,,,,,,,,,,,,,,,,,no comments,835.37,51.12,,,,17.65,,71.58,,,,,,,,,,,,,,215.54,,,151.22,,,,,,,,,,,,,,,,,,,,,315.95,,,,,,,,,12.31,,APPROVED,Male,19.0,FALSE
594,2022-03-22 01:04:07,19,en,1985781140,2022-03-22 00:57:25,2022-03-22 01:04:07,Y,Y,A1,,,13,,,,,,,,,,,,,,,,,,,,,,,,,,,,,,,,,6,,,,,,,,,,,,,,,,,,,,,,,,,,,,,,,,,2,4.0,6.0,5.0,6.0,6.0,5.0,2.0,4.0,3.0,3.0,6.0,6.0,6.0,4.0,5.0,5.0,6.0,6.0,5.0,4.0,6.0,6.0,5.0,5.0,5.0,6.0,2.0,6.0,6.0,6.0,6.0,3.0,0,4.0,6.0,6.0,5.0,6.0,3.0,2.0,5.0,6.0,5.0,6.0,4.0,6.0,2.0,5.0,4.0,6.0,6.0,4.0,5.0,3.0,6.0,6.0,6.0,6.0,6.0,2.0,4.0,4.0,5.0,7.0,4.0,5,,,,,,,,,,,,,,,,,,,,,,,,,,,,,,,,,14,,,,,,,,,,,,,,,,,,,,,,,,,,,,,,,,,9,,,,,,,,,,,,,,,,,,,,,,,,,,,,,,,,,4,,,,,,,,,,,,,,,,,,,,,,,,,,,,,,,,,8,,,,,,,,,,,,,,,,,,,,,,,,,,,,,,,,,11,,,,,,,,,,,,,,,,,,,,,,,,,,,,,,,,,1,1.0,1.0,1.0,4.0,1.0,5.0,4.0,2.0,3.0,1.0,1.0,1.0,2.0,1.0,1.0,4.0,4.0,2.0,4.0,1.0,1.0,2.0,4.0,3.0,1.0,4.0,4.0,1.0,1.0,1.0,4.0,4.0,10,,,,,,,,,,,,,,,,,,,,,,,,,,,,,,,,,12,,,,,,,,,,,,,,,,,,,,,,,,,,,,,,,,,7,,,,,,,,,,,,,,,,,,,,,,,,,,,,,,,,,3,,,,,,,,,,,,,,,,,,,,,,,,,,,,,,,,,,404.99,18.9,,,,51.7,,53.46,,,,,,,,82.43,,,102.02,,,,,,,,,,,,,,,,,,,,,91.38,,,,,,,,,,,,,,,5.1,,APPROVED,Male,21.0,FALSE
595,2022-03-22 01:02:33,19,en,986091816,2022-03-22 00:57:26,2022-03-22 01:02:33,Y,Y,A1,,,6,,,,,,,,,,,,,,,,,,,,,,,,,,,,,,,,,13,,,,,,,,,,,,,,,,,,,,,,,,,,,,,,,,,4,,,,,,,,,,,,,,,,,,,,,,,,,,,,,,,,,2,5.0,6.0,4.0,5.0,5.0,4.0,5.0,5.0,5.0,4.0,5.0,5.0,5.0,4.0,5.0,5.0,5.0,5.0,4.0,4.0,4.0,5.0,6.0,5.0,4.0,7.0,4.0,5.0,6.0,4.0,6.0,4.0,9,,,,,,,,,,,,,,,,,,,,,,,,,,,,,,,,,0,5.0,6.0,4.0,2.0,5.0,2.0,7.0,6.0,5.0,5.0,3.0,3.0,4.0,2.0,5.0,4.0,5.0,5.0,5.0,5.0,4.0,5.0,2.0,6.0,5.0,3.0,4.0,6.0,5.0,4.0,3.0,6.0,5,,,,,,,,,,,,,,,,,,,,,,,,,,,,,,,,,11,,,,,,,,,,,,,,,,,,,,,,,,,,,,,,,,,10,,,,,,,,,,,,,,,,,,,,,,,,,,,,,,,,,14,,,,,,,,,,,,,,,,,,,,,,,,,,,,,,,,,12,,,,,,,,,,,,,,,,,,,,,,,,,,,,,,,,,3,,,,,,,,,,,,,,,,,,,,,,,,,,,,,,,,,8,,,,,,,,,,,,,,,,,,,,,,,,,,,,,,,,,1,4.0,2.0,3.0,5.0,4.0,3.0,5.0,5.0,4.0,3.0,4.0,3.0,4.0,3.0,5.0,4.0,5.0,3.0,4.0,3.0,4.0,4.0,5.0,3.0,4.0,6.0,4.0,3.0,5.0,3.0,4.0,7.0,7,,,,,,,,,,,,,,,,,,,,,,,,,,,,,,,,,,308.12,53.29,,,,4.98,,25.14,,,,,,,,,,,65.14,,,,,,83.11,,,,,,,,,,,,,,,,,,,,,,,,74.07,,,,,,2.39,,APPROVED,Male,28.0,FALSE
596,2022-03-22 01:02:14,19,en,149510067,2022-03-22 00:57:26,2022-03-22 01:02:14,Y,Y,A1,,,0,5.0,6.0,3.0,1.0,3.0,2.0,5.0,5.0,6.0,3.0,4.0,5.0,3.0,4.0,6.0,2.0,5.0,2.0,3.0,4.0,3.0,4.0,2.0,3.0,4.0,3.0,4.0,4.0,4.0,4.0,4.0,1.0,12,,,,,,,,,,,,,,,,,,,,,,,,,,,,,,,,,2,6.0,5.0,5.0,4.0,6.0,5.0,4.0,7.0,7.0,6.0,5.0,4.0,6.0,5.0,5.0,6.0,4.0,5.0,5.0,7.0,4.0,6.0,5.0,6.0,6.0,3.0,4.0,6.0,5.0,6.0,5.0,3.0,10,,,,,,,,,,,,,,,,,,,,,,,,,,,,,,,,,14,,,,,,,,,,,,,,,,,,,,,,,,,,,,,,,,,5,,,,,,,,,,,,,,,,,,,,,,,,,,,,,,,,,4,,,,,,,,,,,,,,,,,,,,,,,,,,,,,,,,,13,,,,,,,,,,,,,,,,,,,,,,,,,,,,,,,,,11,,,,,,,,,,,,,,,,,,,,,,,,,,,,,,,,,7,,,,,,,,,,,,,,,,,,,,,,,,,,,,,,,,,9,,,,,,,,,,,,,,,,,,,,,,,,,,,,,,,,,6,,,,,,,,,,,,,,,,,,,,,,,,,,,,,,,,,8,,,,,,,,,,,,,,,,,,,,,,,,,,,,,,,,,1,5.0,2.0,2.0,3.0,4.0,4.0,5.0,3.0,3.0,4.0,3.0,5.0,4.0,3.0,5.0,4.0,6.0,6.0,4.0,2.0,4.0,4.0,6.0,4.0,2.0,7.0,5.0,2.0,3.0,3.0,4.0,7.0,3,,,,,,,,,,,,,,,,,,,,,,,,,,,,,,,,,,292.09,12.3,,,,6.35,,54.89,,69.49,,,,,,71.41,,,,,,,,,,,,,,,,,,,,,,,,,,,,,,,,,74.67,,,,,,2.98,,APPROVED,Male,28.0,FALSE
597,2022-03-22 01:03:27,19,en,609092032,2022-03-22 00:57:27,2022-03-22 01:03:27,Y,Y,-oth-,High school degree,,14,,,,,,,,,,,,,,,,,,,,,,,,,,,,,,,,,6,,,,,,,,,,,,,,,,,,,,,,,,,,,,,,,,,11,,,,,,,,,,,,,,,,,,,,,,,,,,,,,,,,,1,6.0,7.0,6.0,6.0,7.0,7.0,2.0,7.0,7.0,6.0,7.0,6.0,7.0,7.0,7.0,7.0,6.0,5.0,6.0,5.0,6.0,5.0,6.0,6.0,6.0,7.0,6.0,5.0,5.0,5.0,6.0,4.0,12,,,,,,,,,,,,,,,,,,,,,,,,,,,,,,,,,10,,,,,,,,,,,,,,,,,,,,,,,,,,,,,,,,,13,,,,,,,,,,,,,,,,,,,,,,,,,,,,,,,,,2,1.0,3.0,1.0,3.0,2.0,2.0,7.0,2.0,2.0,5.0,1.0,5.0,2.0,3.0,5.0,1.0,5.0,1.0,3.0,3.0,1.0,3.0,2.0,2.0,1.0,2.0,5.0,2.0,1.0,5.0,2.0,1.0,3,,,,,,,,,,,,,,,,,,,,,,,,,,,,,,,,,5,,,,,,,,,,,,,,,,,,,,,,,,,,,,,,,,,8,,,,,,,,,,,,,,,,,,,,,,,,,,,,,,,,,0,5.0,6.0,5.0,3.0,7.0,5.0,5.0,6.0,6.0,3.0,6.0,5.0,5.0,5.0,6.0,6.0,6.0,3.0,5.0,5.0,3.0,5.0,2.0,2.0,6.0,5.0,5.0,6.0,5.0,5.0,5.0,5.0,9,,,,,,,,,,,,,,,,,,,,,,,,,,,,,,,,,4,,,,,,,,,,,,,,,,,,,,,,,,,,,,,,,,,7,,,,,,,,,,,,,,,,,,,,,,,,,,,,,,,,,,363.54,18.02,,,,26.0,,30.79,,,,,,,,,,,102.85,,,,,,,,,,,,96.95,,,,,,,,,,,,85.58,,,,,,,,,,,,3.35,,APPROVED,Male,21.0,FALSE
598,2022-03-22 01:01:33,19,en,597700625,2022-03-22 00:57:29,2022-03-22 01:01:33,Y,Y,A2,,,6,,,,,,,,,,,,,,,,,,,,,,,,,,,,,,,,,2,5.0,3.0,4.0,5.0,4.0,6.0,3.0,6.0,2.0,3.0,5.0,4.0,5.0,4.0,3.0,5.0,4.0,3.0,5.0,4.0,4.0,5.0,6.0,5.0,4.0,5.0,3.0,3.0,4.0,5.0,5.0,2.0,3,,,,,,,,,,,,,,,,,,,,,,,,,,,,,,,,,12,,,,,,,,,,,,,,,,,,,,,,,,,,,,,,,,,1,4.0,5.0,2.0,2.0,2.0,2.0,7.0,3.0,2.0,2.0,2.0,2.0,2.0,2.0,4.0,2.0,2.0,2.0,2.0,4.0,2.0,2.0,2.0,2.0,4.0,2.0,4.0,2.0,2.0,2.0,2.0,5.0,5,,,,,,,,,,,,,,,,,,,,,,,,,,,,,,,,,9,,,,,,,,,,,,,,,,,,,,,,,,,,,,,,,,,7,,,,,,,,,,,,,,,,,,,,,,,,,,,,,,,,,8,,,,,,,,,,,,,,,,,,,,,,,,,,,,,,,,,10,,,,,,,,,,,,,,,,,,,,,,,,,,,,,,,,,13,,,,,,,,,,,,,,,,,,,,,,,,,,,,,,,,,0,2.0,2.0,2.0,5.0,4.0,5.0,2.0,5.0,2.0,2.0,2.0,2.0,2.0,2.0,5.0,2.0,2.0,2.0,2.0,2.0,2.0,2.0,2.0,2.0,3.0,2.0,2.0,2.0,2.0,2.0,3.0,5.0,11,,,,,,,,,,,,,,,,,,,,,,,,,,,,,,,,,4,,,,,,,,,,,,,,,,,,,,,,,,,,,,,,,,,14,,,,,,,,,,,,,,,,,,,,,,,,,,,,,,,,,,246.64,16.4,,,,4.3,,15.45,,,,,67.28,,,,,,,,,66.08,,,,,,,,,,,,,,,,,,,,,74.76,,,,,,,,,,,,2.37,,APPROVED,Female,34.0,FALSE
599,2022-03-22 01:03:57,19,en,80342407,2022-03-22 00:57:29,2022-03-22 01:03:57,Y,Y,A1,,,10,,,,,,,,,,,,,,,,,,,,,,,,,,,,,,,,,14,,,,,,,,,,,,,,,,,,,,,,,,,,,,,,,,,0,3.0,6.0,5.0,3.0,6.0,3.0,3.0,4.0,5.0,6.0,4.0,5.0,5.0,5.0,6.0,3.0,5.0,2.0,4.0,4.0,2.0,4.0,4.0,3.0,5.0,4.0,4.0,3.0,3.0,3.0,3.0,3.0,11,,,,,,,,,,,,,,,,,,,,,,,,,,,,,,,,,2,1.0,1.0,1.0,1.0,1.0,6.0,5.0,3.0,1.0,1.0,7.0,4.0,1.0,1.0,1.0,1.0,2.0,1.0,1.0,1.0,1.0,1.0,6.0,1.0,1.0,6.0,1.0,1.0,7.0,1.0,5.0,5.0,7,,,,,,,,,,,,,,,,,,,,,,,,,,,,,,,,,3,,,,,,,,,,,,,,,,,,,,,,,,,,,,,,,,,4,,,,,,,,,,,,,,,,,,,,,,,,,,,,,,,,,13,,,,,,,,,,,,,,,,,,,,,,,,,,,,,,,,,12,,,,,,,,,,,,,,,,,,,,,,,,,,,,,,,,,9,,,,,,,,,,,,,,,,,,,,,,,,,,,,,,,,,5,,,,,,,,,,,,,,,,,,,,,,,,,,,,,,,,,6,,,,,,,,,,,,,,,,,,,,,,,,,,,,,,,,,1,1.0,4.0,1.0,1.0,1.0,1.0,1.0,1.0,5.0,1.0,1.0,5.0,1.0,1.0,1.0,1.0,1.0,1.0,1.0,1.0,1.0,1.0,1.0,1.0,1.0,3.0,3.0,1.0,1.0,1.0,1.0,6.0,8,,,,,,,,,,,,,,,,,,,,,,,,,,,,,,,,,,391.74,14.19,,,,10.68,,18.81,,,,,,,,169.41,,,,,,108.84,,,,,,,,,,,,,,,,,,,,,,,,,,,64.89,,,,,,4.92,,APPROVED,Male,22.0,FALSE
600,2022-03-22 01:11:07,19,en,1464647350,2022-03-22 00:57:29,2022-03-22 01:11:07,Y,Y,A1,,,6,,,,,,,,,,,,,,,,,,,,,,,,,,,,,,,,,10,,,,,,,,,,,,,,,,,,,,,,,,,,,,,,,,,12,,,,,,,,,,,,,,,,,,,,,,,,,,,,,,,,,2,5.0,2.0,7.0,4.0,7.0,2.0,3.0,2.0,6.0,5.0,2.0,5.0,6.0,5.0,7.0,5.0,2.0,2.0,2.0,5.0,5.0,2.0,1.0,6.0,7.0,2.0,6.0,6.0,5.0,5.0,1.0,4.0,11,,,,,,,,,,,,,,,,,,,,,,,,,,,,,,,,,9,,,,,,,,,,,,,,,,,,,,,,,,,,,,,,,,,13,,,,,,,,,,,,,,,,,,,,,,,,,,,,,,,,,14,,,,,,,,,,,,,,,,,,,,,,,,,,,,,,,,,0,1.0,3.0,1.0,1.0,1.0,1.0,1.0,1.0,4.0,1.0,1.0,1.0,1.0,1.0,1.0,1.0,1.0,1.0,1.0,1.0,1.0,1.0,1.0,1.0,1.0,1.0,1.0,1.0,1.0,1.0,1.0,2.0,5,,,,,,,,,,,,,,,,,,,,,,,,,,,,,,,,,8,,,,,,,,,,,,,,,,,,,,,,,,,,,,,,,,,4,,,,,,,,,,,,,,,,,,,,,,,,,,,,,,,,,3,,,,,,,,,,,,,,,,,,,,,,,,,,,,,,,,,1,5.0,6.0,6.0,6.0,5.0,3.0,6.0,5.0,6.0,4.0,5.0,4.0,5.0,5.0,7.0,5.0,6.0,3.0,5.0,4.0,5.0,6.0,6.0,4.0,6.0,7.0,5.0,5.0,6.0,5.0,6.0,7.0,7,,,,,,,,,,,,,,,,,,,,,,,,,,,,,,,,,,820.77,109.19,,,,12.04,,32.41,,,,,,,,,,,412.94,,,,,,,,,,,,,,,96.73,,,,,,,,,,,,,,,153.89,,,,,,3.57,,APPROVED,Male,21.0,FALSE
601,2022-03-22 01:03:59,19,en,111568161,2022-03-22 00:57:30,2022-03-22 01:03:59,Y,Y,A1,,,7,,,,,,,,,,,,,,,,,,,,,,,,,,,,,,,,,12,,,,,,,,,,,,,,,,,,,,,,,,,,,,,,,,,0,5.0,2.0,7.0,2.0,7.0,4.0,2.0,5.0,6.0,6.0,7.0,1.0,5.0,4.0,5.0,6.0,6.0,1.0,6.0,6.0,3.0,6.0,1.0,5.0,6.0,1.0,1.0,6.0,2.0,6.0,1.0,3.0,10,,,,,,,,,,,,,,,,,,,,,,,,,,,,,,,,,2,5.0,1.0,3.0,5.0,5.0,7.0,1.0,6.0,2.0,4.0,5.0,2.0,2.0,2.0,5.0,4.0,5.0,5.0,5.0,2.0,5.0,5.0,7.0,6.0,5.0,7.0,1.0,1.0,7.0,3.0,7.0,5.0,4,,,,,,,,,,,,,,,,,,,,,,,,,,,,,,,,,1,2.0,2.0,2.0,5.0,1.0,2.0,7.0,1.0,3.0,3.0,2.0,2.0,1.0,1.0,6.0,1.0,7.0,1.0,1.0,1.0,2.0,1.0,4.0,1.0,1.0,5.0,1.0,2.0,7.0,2.0,5.0,7.0,11,,,,,,,,,,,,,,,,,,,,,,,,,,,,,,,,,13,,,,,,,,,,,,,,,,,,,,,,,,,,,,,,,,,9,,,,,,,,,,,,,,,,,,,,,,,,,,,,,,,,,3,,,,,,,,,,,,,,,,,,,,,,,,,,,,,,,,,6,,,,,,,,,,,,,,,,,,,,,,,,,,,,,,,,,5,,,,,,,,,,,,,,,,,,,,,,,,,,,,,,,,,8,,,,,,,,,,,,,,,,,,,,,,,,,,,,,,,,,14,,,,,,,,,,,,,,,,,,,,,,,,,,,,,,,,,,392.5,40.48,,,,6.21,,40.25,,,,,,,,119.87,,,,,,76.81,,,,,,105.3,,,,,,,,,,,,,,,,,,,,,,,,,,,3.58,,APPROVED,Male,21.0,FALSE
602,2022-03-22 01:05:15,19,en,689922993,2022-03-22 00:57:30,2022-03-22 01:05:15,Y,Y,-oth-,High School,,3,,,,,,,,,,,,,,,,,,,,,,,,,,,,,,,,,4,,,,,,,,,,,,,,,,,,,,,,,,,,,,,,,,,6,,,,,,,,,,,,,,,,,,,,,,,,,,,,,,,,,5,,,,,,,,,,,,,,,,,,,,,,,,,,,,,,,,,2,3.0,3.0,3.0,3.0,2.0,3.0,6.0,4.0,3.0,3.0,4.0,3.0,3.0,3.0,4.0,3.0,4.0,4.0,2.0,2.0,3.0,2.0,2.0,2.0,4.0,4.0,1.0,3.0,4.0,3.0,2.0,5.0,9,,,,,,,,,,,,,,,,,,,,,,,,,,,,,,,,,11,,,,,,,,,,,,,,,,,,,,,,,,,,,,,,,,,10,,,,,,,,,,,,,,,,,,,,,,,,,,,,,,,,,1,2.0,2.0,1.0,2.0,2.0,2.0,7.0,2.0,2.0,2.0,1.0,2.0,2.0,2.0,2.0,1.0,1.0,2.0,2.0,2.0,1.0,2.0,1.0,2.0,2.0,2.0,2.0,1.0,2.0,2.0,2.0,2.0,12,,,,,,,,,,,,,,,,,,,,,,,,,,,,,,,,,14,,,,,,,,,,,,,,,,,,,,,,,,,,,,,,,,,7,,,,,,,,,,,,,,,,,,,,,,,,,,,,,,,,,8,,,,,,,,,,,,,,,,,,,,,,,,,,,,,,,,,0,6.0,5.0,5.0,6.0,4.0,7.0,3.0,7.0,6.0,4.0,6.0,6.0,6.0,7.0,7.0,6.0,7.0,6.0,6.0,4.0,6.0,6.0,7.0,6.0,4.0,7.0,1.0,5.0,7.0,6.0,6.0,7.0,13,,,,,,,,,,,,,,,,,,,,,,,,,,,,,,,,,,468.16,41.66,,,,112.63,,52.04,,,,,,,,,,,,,,84.89,,,,,,,,,,,,71.19,,,,,,,,,,,,,,,101.09,,,,,,4.66,,APPROVED,Male,23.0,FALSE
603,2022-03-22 01:00:45,19,en,218833551,2022-03-22 00:57:33,2022-03-22 01:00:45,Y,Y,A1,,,14,,,,,,,,,,,,,,,,,,,,,,,,,,,,,,,,,12,,,,,,,,,,,,,,,,,,,,,,,,,,,,,,,,,2,5.0,4.0,5.0,5.0,5.0,5.0,5.0,4.0,5.0,4.0,5.0,5.0,5.0,4.0,5.0,5.0,5.0,4.0,4.0,5.0,5.0,5.0,6.0,6.0,5.0,5.0,5.0,5.0,4.0,4.0,4.0,3.0,8,,,,,,,,,,,,,,,,,,,,,,,,,,,,,,,,,6,,,,,,,,,,,,,,,,,,,,,,,,,,,,,,,,,4,,,,,,,,,,,,,,,,,,,,,,,,,,,,,,,,,3,,,,,,,,,,,,,,,,,,,,,,,,,,,,,,,,,0,4.0,2.0,1.0,3.0,1.0,1.0,7.0,1.0,1.0,3.0,1.0,2.0,3.0,3.0,1.0,1.0,3.0,3.0,4.0,1.0,1.0,2.0,3.0,1.0,1.0,2.0,4.0,2.0,1.0,1.0,1.0,1.0,10,,,,,,,,,,,,,,,,,,,,,,,,,,,,,,,,,11,,,,,,,,,,,,,,,,,,,,,,,,,,,,,,,,,1,3.0,6.0,5.0,5.0,5.0,5.0,3.0,5.0,5.0,6.0,4.0,5.0,5.0,5.0,5.0,5.0,5.0,5.0,5.0,6.0,5.0,5.0,5.0,4.0,5.0,4.0,5.0,5.0,5.0,5.0,3.0,4.0,9,,,,,,,,,,,,,,,,,,,,,,,,,,,,,,,,,5,,,,,,,,,,,,,,,,,,,,,,,,,,,,,,,,,13,,,,,,,,,,,,,,,,,,,,,,,,,,,,,,,,,7,,,,,,,,,,,,,,,,,,,,,,,,,,,,,,,,,,196.81,8.71,,,,5.5,,30.23,,,,,,,,33.0,,,,,,,,,,,,,,,66.55,,,,,,,,,50.14,,,,,,,,,,,,,,,2.68,,APPROVED,Male,29.0,FALSE
605,2022-03-22 01:01:30,19,en,1258631708,2022-03-22 00:57:34,2022-03-22 01:01:30,Y,Y,A2,,,2,4.0,6.0,5.0,4.0,4.0,3.0,4.0,5.0,6.0,4.0,5.0,5.0,5.0,5.0,5.0,4.0,5.0,4.0,4.0,4.0,3.0,5.0,3.0,4.0,5.0,4.0,3.0,5.0,4.0,4.0,4.0,1.0,3,,,,,,,,,,,,,,,,,,,,,,,,,,,,,,,,,7,,,,,,,,,,,,,,,,,,,,,,,,,,,,,,,,,6,,,,,,,,,,,,,,,,,,,,,,,,,,,,,,,,,10,,,,,,,,,,,,,,,,,,,,,,,,,,,,,,,,,1,5.0,4.0,5.0,5.0,4.0,5.0,4.0,6.0,5.0,5.0,4.0,5.0,5.0,4.0,4.0,4.0,5.0,6.0,5.0,4.0,5.0,4.0,5.0,4.0,5.0,6.0,1.0,4.0,6.0,4.0,5.0,6.0,0,4.0,4.0,6.0,4.0,4.0,6.0,4.0,6.0,6.0,4.0,5.0,6.0,6.0,5.0,4.0,4.0,6.0,5.0,5.0,4.0,6.0,5.0,6.0,5.0,5.0,4.0,1.0,5.0,4.0,2.0,5.0,7.0,8,,,,,,,,,,,,,,,,,,,,,,,,,,,,,,,,,5,,,,,,,,,,,,,,,,,,,,,,,,,,,,,,,,,12,,,,,,,,,,,,,,,,,,,,,,,,,,,,,,,,,13,,,,,,,,,,,,,,,,,,,,,,,,,,,,,,,,,14,,,,,,,,,,,,,,,,,,,,,,,,,,,,,,,,,11,,,,,,,,,,,,,,,,,,,,,,,,,,,,,,,,,9,,,,,,,,,,,,,,,,,,,,,,,,,,,,,,,,,4,,,,,,,,,,,,,,,,,,,,,,,,,,,,,,,,,,238.84,8.71,,,,8.7,,26.51,,61.03,,,,,,,,,,,,,,,65.59,,,65.02,,,,,,,,,,,,,,,,,,,,,,,,,,,3.28,,APPROVED,Male,29.0,FALSE
606,2022-03-22 01:04:26,19,en,317447627,2022-03-22 00:57:37,2022-03-22 01:04:26,Y,Y,A1,,,7,,,,,,,,,,,,,,,,,,,,,,,,,,,,,,,,,9,,,,,,,,,,,,,,,,,,,,,,,,,,,,,,,,,11,,,,,,,,,,,,,,,,,,,,,,,,,,,,,,,,,8,,,,,,,,,,,,,,,,,,,,,,,,,,,,,,,,,5,,,,,,,,,,,,,,,,,,,,,,,,,,,,,,,,,0,6.0,7.0,6.0,6.0,6.0,5.0,2.0,6.0,7.0,6.0,5.0,6.0,6.0,6.0,6.0,6.0,7.0,6.0,6.0,6.0,5.0,6.0,5.0,6.0,6.0,5.0,2.0,6.0,5.0,6.0,6.0,6.0,4,,,,,,,,,,,,,,,,,,,,,,,,,,,,,,,,,10,,,,,,,,,,,,,,,,,,,,,,,,,,,,,,,,,6,,,,,,,,,,,,,,,,,,,,,,,,,,,,,,,,,14,,,,,,,,,,,,,,,,,,,,,,,,,,,,,,,,,13,,,,,,,,,,,,,,,,,,,,,,,,,,,,,,,,,2,6.0,6.0,6.0,6.0,6.0,6.0,1.0,6.0,5.0,6.0,6.0,6.0,6.0,6.0,6.0,6.0,6.0,7.0,6.0,6.0,6.0,6.0,6.0,6.0,6.0,6.0,1.0,7.0,5.0,6.0,6.0,5.0,1,7.0,6.0,7.0,7.0,7.0,7.0,2.0,7.0,7.0,7.0,7.0,7.0,7.0,7.0,7.0,7.0,7.0,7.0,7.0,7.0,7.0,7.0,7.0,7.0,7.0,7.0,1.0,7.0,7.0,7.0,7.0,6.0,3,,,,,,,,,,,,,,,,,,,,,,,,,,,,,,,,,12,,,,,,,,,,,,,,,,,,,,,,,,,,,,,,,,,,412.52,48.08,,,,8.81,,31.64,,,,,,,,,,,,,,,,,145.7,,,,,,,,,,,,,,,,,,95.43,,,67.24,,,,,,,,,15.62,,APPROVED,Female,22.0,FALSE
607,2022-03-22 01:03:18,19,en,96108768,2022-03-22 00:57:38,2022-03-22 01:03:18,Y,Y,A1,,,7,,,,,,,,,,,,,,,,,,,,,,,,,,,,,,,,,3,,,,,,,,,,,,,,,,,,,,,,,,,,,,,,,,,1,6.0,7.0,7.0,6.0,7.0,7.0,1.0,7.0,7.0,7.0,7.0,5.0,7.0,6.0,6.0,7.0,7.0,6.0,6.0,7.0,7.0,7.0,7.0,6.0,7.0,7.0,1.0,7.0,7.0,5.0,7.0,3.0,0,5.0,5.0,2.0,1.0,1.0,3.0,7.0,3.0,5.0,1.0,3.0,1.0,1.0,1.0,1.0,1.0,1.0,3.0,1.0,1.0,2.0,1.0,1.0,1.0,1.0,1.0,6.0,1.0,5.0,3.0,1.0,4.0,6,,,,,,,,,,,,,,,,,,,,,,,,,,,,,,,,,14,,,,,,,,,,,,,,,,,,,,,,,,,,,,,,,,,13,,,,,,,,,,,,,,,,,,,,,,,,,,,,,,,,,2,1.0,1.0,1.0,1.0,1.0,1.0,7.0,1.0,4.0,1.0,1.0,1.0,1.0,1.0,1.0,1.0,3.0,1.0,1.0,1.0,1.0,1.0,5.0,1.0,1.0,1.0,1.0,2.0,1.0,1.0,5.0,1.0,11,,,,,,,,,,,,,,,,,,,,,,,,,,,,,,,,,5,,,,,,,,,,,,,,,,,,,,,,,,,,,,,,,,,4,,,,,,,,,,,,,,,,,,,,,,,,,,,,,,,,,10,,,,,,,,,,,,,,,,,,,,,,,,,,,,,,,,,9,,,,,,,,,,,,,,,,,,,,,,,,,,,,,,,,,8,,,,,,,,,,,,,,,,,,,,,,,,,,,,,,,,,12,,,,,,,,,,,,,,,,,,,,,,,,,,,,,,,,,I like it,341.64,46.47,,,,7.42,,66.03,,,,,,,,78.15,,,71.22,,,,,,,,,,,,63.27,,,,,,,,,,,,,,,,,,,,,,,,9.08,,APPROVED,Female,23.0,FALSE
608,2022-03-22 01:02:03,19,en,114839454,2022-03-22 00:57:39,2022-03-22 01:02:03,Y,Y,A1,,,1,6.0,5.0,1.0,5.0,6.0,1.0,7.0,7.0,6.0,4.0,5.0,3.0,4.0,5.0,5.0,4.0,6.0,5.0,4.0,1.0,1.0,4.0,1.0,5.0,4.0,2.0,4.0,3.0,5.0,5.0,1.0,1.0,11,,,,,,,,,,,,,,,,,,,,,,,,,,,,,,,,,2,4.0,6.0,6.0,4.0,6.0,6.0,2.0,7.0,5.0,6.0,7.0,3.0,6.0,4.0,7.0,7.0,5.0,5.0,6.0,6.0,6.0,6.0,5.0,4.0,6.0,6.0,3.0,6.0,4.0,6.0,5.0,3.0,5,,,,,,,,,,,,,,,,,,,,,,,,,,,,,,,,,3,,,,,,,,,,,,,,,,,,,,,,,,,,,,,,,,,9,,,,,,,,,,,,,,,,,,,,,,,,,,,,,,,,,8,,,,,,,,,,,,,,,,,,,,,,,,,,,,,,,,,7,,,,,,,,,,,,,,,,,,,,,,,,,,,,,,,,,4,,,,,,,,,,,,,,,,,,,,,,,,,,,,,,,,,6,,,,,,,,,,,,,,,,,,,,,,,,,,,,,,,,,14,,,,,,,,,,,,,,,,,,,,,,,,,,,,,,,,,13,,,,,,,,,,,,,,,,,,,,,,,,,,,,,,,,,0,6.0,6.0,5.0,2.0,5.0,1.0,7.0,1.0,6.0,5.0,6.0,3.0,6.0,4.0,7.0,3.0,6.0,5.0,4.0,4.0,5.0,5.0,5.0,7.0,6.0,5.0,2.0,2.0,7.0,4.0,2.0,6.0,12,,,,,,,,,,,,,,,,,,,,,,,,,,,,,,,,,10,,,,,,,,,,,,,,,,,,,,,,,,,,,,,,,,,,267.78,20.85,,,,6.1,,27.82,,61.44,,,,,,81.41,,,,,,,,,,,,,,,,,,,,,,,,,,,,,,66.73,,,,,,,,,3.43,,APPROVED,Male,24.0,FALSE
609,2022-03-22 01:02:05,19,en,141859593,2022-03-22 00:57:39,2022-03-22 01:02:05,Y,Y,A3,,,2,5.0,6.0,4.0,4.0,4.0,4.0,4.0,2.0,4.0,3.0,5.0,4.0,5.0,5.0,4.0,3.0,6.0,4.0,4.0,2.0,2.0,4.0,4.0,5.0,2.0,6.0,4.0,5.0,4.0,3.0,4.0,1.0,0,6.0,4.0,4.0,4.0,4.0,6.0,4.0,6.0,5.0,4.0,6.0,6.0,6.0,6.0,6.0,6.0,5.0,5.0,6.0,4.0,4.0,6.0,6.0,6.0,6.0,6.0,4.0,6.0,6.0,4.0,6.0,2.0,14,,,,,,,,,,,,,,,,,,,,,,,,,,,,,,,,,1,3.0,2.0,4.0,2.0,2.0,2.0,6.0,4.0,2.0,3.0,4.0,2.0,2.0,5.0,2.0,2.0,3.0,2.0,2.0,2.0,2.0,2.0,4.0,4.0,2.0,6.0,4.0,2.0,5.0,2.0,2.0,4.0,5,,,,,,,,,,,,,,,,,,,,,,,,,,,,,,,,,13,,,,,,,,,,,,,,,,,,,,,,,,,,,,,,,,,11,,,,,,,,,,,,,,,,,,,,,,,,,,,,,,,,,8,,,,,,,,,,,,,,,,,,,,,,,,,,,,,,,,,9,,,,,,,,,,,,,,,,,,,,,,,,,,,,,,,,,6,,,,,,,,,,,,,,,,,,,,,,,,,,,,,,,,,4,,,,,,,,,,,,,,,,,,,,,,,,,,,,,,,,,7,,,,,,,,,,,,,,,,,,,,,,,,,,,,,,,,,3,,,,,,,,,,,,,,,,,,,,,,,,,,,,,,,,,10,,,,,,,,,,,,,,,,,,,,,,,,,,,,,,,,,12,,,,,,,,,,,,,,,,,,,,,,,,,,,,,,,,,,268.52,8.2,,,,4.73,,25.28,,69.02,,,56.63,,,,,,101.59,,,,,,,,,,,,,,,,,,,,,,,,,,,,,,,,,,,,3.07,,APPROVED,Female,31.0,FALSE
611,2022-03-22 01:03:28,19,en,461938705,2022-03-22 00:57:51,2022-03-22 01:03:28,Y,Y,-oth-,high school degree,,5,,,,,,,,,,,,,,,,,,,,,,,,,,,,,,,,,0,5.0,5.0,6.0,7.0,4.0,6.0,4.0,7.0,2.0,4.0,2.0,5.0,5.0,5.0,5.0,7.0,6.0,3.0,5.0,4.0,4.0,4.0,7.0,3.0,5.0,6.0,1.0,3.0,6.0,1.0,5.0,2.0,6,,,,,,,,,,,,,,,,,,,,,,,,,,,,,,,,,10,,,,,,,,,,,,,,,,,,,,,,,,,,,,,,,,,14,,,,,,,,,,,,,,,,,,,,,,,,,,,,,,,,,11,,,,,,,,,,,,,,,,,,,,,,,,,,,,,,,,,12,,,,,,,,,,,,,,,,,,,,,,,,,,,,,,,,,9,,,,,,,,,,,,,,,,,,,,,,,,,,,,,,,,,8,,,,,,,,,,,,,,,,,,,,,,,,,,,,,,,,,13,,,,,,,,,,,,,,,,,,,,,,,,,,,,,,,,,3,,,,,,,,,,,,,,,,,,,,,,,,,,,,,,,,,4,,,,,,,,,,,,,,,,,,,,,,,,,,,,,,,,,7,,,,,,,,,,,,,,,,,,,,,,,,,,,,,,,,,1,4.0,6.0,5.0,5.0,2.0,6.0,4.0,5.0,6.0,3.0,2.0,6.0,1.0,3.0,7.0,7.0,5.0,1.0,2.0,1.0,1.0,5.0,7.0,3.0,3.0,7.0,5.0,4.0,2.0,1.0,6.0,1.0,2,5.0,6.0,2.0,4.0,2.0,5.0,4.0,6.0,3.0,1.0,6.0,2.0,2.0,3.0,3.0,5.0,4.0,2.0,1.0,2.0,1.0,4.0,2.0,3.0,2.0,5.0,4.0,5.0,1.0,1.0,2.0,1.0,,342.18,17.65,,,,18.7,,28.41,,,,,84.84,,,,,,,,,,,,,,,,,,,,,,,,,,,,,,,,,,,,88.75,,,99.96,,,3.87,,APPROVED,Female,20.0,FALSE
612,2022-03-22 01:07:37,19,en,1379099483,2022-03-22 00:58:13,2022-03-22 01:07:37,Y,Y,A1,,,6,,,,,,,,,,,,,,,,,,,,,,,,,,,,,,,,,3,,,,,,,,,,,,,,,,,,,,,,,,,,,,,,,,,10,,,,,,,,,,,,,,,,,,,,,,,,,,,,,,,,,14,,,,,,,,,,,,,,,,,,,,,,,,,,,,,,,,,9,,,,,,,,,,,,,,,,,,,,,,,,,,,,,,,,,8,,,,,,,,,,,,,,,,,,,,,,,,,,,,,,,,,12,,,,,,,,,,,,,,,,,,,,,,,,,,,,,,,,,0,4.0,5.0,4.0,3.0,4.0,4.0,7.0,5.0,5.0,3.0,3.0,4.0,4.0,4.0,4.0,3.0,5.0,3.0,5.0,4.0,3.0,5.0,3.0,3.0,2.0,4.0,5.0,4.0,4.0,4.0,3.0,1.0,11,,,,,,,,,,,,,,,,,,,,,,,,,,,,,,,,,2,3.0,4.0,3.0,3.0,4.0,3.0,6.0,4.0,5.0,4.0,3.0,3.0,4.0,4.0,5.0,3.0,6.0,3.0,4.0,3.0,3.0,4.0,3.0,3.0,3.0,4.0,5.0,4.0,4.0,4.0,3.0,3.0,1,7.0,6.0,7.0,6.0,7.0,7.0,3.0,6.0,7.0,6.0,6.0,6.0,7.0,6.0,6.0,6.0,6.0,6.0,7.0,7.0,6.0,7.0,6.0,6.0,7.0,5.0,4.0,7.0,6.0,6.0,6.0,4.0,13,,,,,,,,,,,,,,,,,,,,,,,,,,,,,,,,,4,,,,,,,,,,,,,,,,,,,,,,,,,,,,,,,,,7,,,,,,,,,,,,,,,,,,,,,,,,,,,,,,,,,5,,,,,,,,,,,,,,,,,,,,,,,,,,,,,,,,,,566.72,151.34,,,,8.84,,89.42,,,,,,,,,,,,,,,,,,,,,,,115.48,,,,,,99.64,,,93.85,,,,,,,,,,,,,,,8.15,,APPROVED,Female,28.0,FALSE
613,2022-03-22 01:08:29,19,en,355765388,2022-03-22 01:00:50,2022-03-22 01:08:29,Y,Y,A2,,,12,,,,,,,,,,,,,,,,,,,,,,,,,,,,,,,,,7,,,,,,,,,,,,,,,,,,,,,,,,,,,,,,,,,9,,,,,,,,,,,,,,,,,,,,,,,,,,,,,,,,,11,,,,,,,,,,,,,,,,,,,,,,,,,,,,,,,,,4,,,,,,,,,,,,,,,,,,,,,,,,,,,,,,,,,8,,,,,,,,,,,,,,,,,,,,,,,,,,,,,,,,,3,,,,,,,,,,,,,,,,,,,,,,,,,,,,,,,,,5,,,,,,,,,,,,,,,,,,,,,,,,,,,,,,,,,0,1.0,4.0,1.0,4.0,3.0,4.0,7.0,2.0,1.0,1.0,1.0,1.0,1.0,1.0,1.0,3.0,1.0,1.0,1.0,1.0,1.0,1.0,2.0,1.0,2.0,6.0,1.0,1.0,1.0,2.0,1.0,2.0,10,,,,,,,,,,,,,,,,,,,,,,,,,,,,,,,,,1,7.0,7.0,7.0,7.0,6.0,6.0,2.0,7.0,7.0,7.0,7.0,6.0,7.0,7.0,5.0,6.0,6.0,7.0,6.0,7.0,6.0,7.0,7.0,7.0,7.0,7.0,6.0,7.0,4.0,7.0,6.0,4.0,14,,,,,,,,,,,,,,,,,,,,,,,,,,,,,,,,,2,5.0,2.0,2.0,5.0,4.0,1.0,7.0,5.0,6.0,2.0,5.0,2.0,3.0,5.0,1.0,4.0,5.0,1.0,2.0,1.0,1.0,3.0,4.0,2.0,3.0,6.0,5.0,2.0,2.0,2.0,4.0,6.0,6,,,,,,,,,,,,,,,,,,,,,,,,,,,,,,,,,13,,,,,,,,,,,,,,,,,,,,,,,,,,,,,,,,,,457.45,17.85,,,,10.07,,44.42,,,,,,,,,,,,,,,,,,,,,,,,,,145.73,,,,,,111.14,,,,,,121.79,,,,,,,,,6.45,,APPROVED,Male,46.0,FALSE
614,2022-03-22 01:18:41,19,en,872847888,2022-03-22 01:04:51,2022-03-22 01:18:41,Y,Y,-oth-,Upper secondary school,,9,,,,,,,,,,,,,,,,,,,,,,,,,,,,,,,,,12,,,,,,,,,,,,,,,,,,,,,,,,,,,,,,,,,11,,,,,,,,,,,,,,,,,,,,,,,,,,,,,,,,,6,,,,,,,,,,,,,,,,,,,,,,,,,,,,,,,,,3,,,,,,,,,,,,,,,,,,,,,,,,,,,,,,,,,14,,,,,,,,,,,,,,,,,,,,,,,,,,,,,,,,,7,,,,,,,,,,,,,,,,,,,,,,,,,,,,,,,,,13,,,,,,,,,,,,,,,,,,,,,,,,,,,,,,,,,0,2.0,5.0,3.0,6.0,2.0,3.0,7.0,1.0,6.0,2.0,2.0,5.0,1.0,3.0,5.0,4.0,7.0,2.0,3.0,1.0,2.0,5.0,4.0,2.0,2.0,1.0,5.0,4.0,4.0,3.0,4.0,2.0,2,4.0,6.0,4.0,3.0,2.0,4.0,7.0,1.0,5.0,3.0,4.0,6.0,5.0,5.0,5.0,6.0,7.0,5.0,5.0,2.0,7.0,6.0,5.0,4.0,3.0,7.0,6.0,6.0,5.0,4.0,6.0,3.0,10,,,,,,,,,,,,,,,,,,,,,,,,,,,,,,,,,8,,,,,,,,,,,,,,,,,,,,,,,,,,,,,,,,,5,,,,,,,,,,,,,,,,,,,,,,,,,,,,,,,,,1,5.0,7.0,6.0,5.0,2.0,6.0,4.0,6.0,4.0,4.0,4.0,5.0,4.0,4.0,6.0,3.0,5.0,5.0,4.0,3.0,5.0,5.0,6.0,5.0,3.0,7.0,6.0,4.0,4.0,4.0,7.0,7.0,4,,,,,,,,,,,,,,,,,,,,,,,,,,,,,,,,,,804.22,135.57,,,,32.98,,74.08,,,,,,,,,,,,,,,,,,,,,,,,,,182.73,,,210.25,,,,,,,,,,,,153.74,,,,,,14.87,,APPROVED,Male,25.0,FALSE
615,2022-03-22 01:11:24,19,en,1407744922,2022-03-22 01:05:54,2022-03-22 01:11:24,Y,Y,A1,,,12,,,,,,,,,,,,,,,,,,,,,,,,,,,,,,,,,9,,,,,,,,,,,,,,,,,,,,,,,,,,,,,,,,,8,,,,,,,,,,,,,,,,,,,,,,,,,,,,,,,,,6,,,,,,,,,,,,,,,,,,,,,,,,,,,,,,,,,1,2.0,1.0,2.0,3.0,4.0,1.0,4.0,5.0,4.0,2.0,2.0,4.0,2.0,2.0,2.0,2.0,2.0,2.0,2.0,3.0,2.0,3.0,1.0,2.0,2.0,6.0,4.0,1.0,5.0,2.0,2.0,5.0,14,,,,,,,,,,,,,,,,,,,,,,,,,,,,,,,,,7,,,,,,,,,,,,,,,,,,,,,,,,,,,,,,,,,3,,,,,,,,,,,,,,,,,,,,,,,,,,,,,,,,,2,1.0,1.0,1.0,5.0,1.0,4.0,3.0,1.0,2.0,1.0,1.0,1.0,2.0,1.0,2.0,1.0,4.0,2.0,2.0,4.0,1.0,1.0,5.0,1.0,1.0,6.0,3.0,1.0,5.0,1.0,3.0,2.0,13,,,,,,,,,,,,,,,,,,,,,,,,,,,,,,,,,10,,,,,,,,,,,,,,,,,,,,,,,,,,,,,,,,,11,,,,,,,,,,,,,,,,,,,,,,,,,,,,,,,,,5,,,,,,,,,,,,,,,,,,,,,,,,,,,,,,,,,0,5.0,2.0,4.0,5.0,4.0,5.0,4.0,6.0,5.0,4.0,3.0,6.0,5.0,5.0,6.0,5.0,6.0,4.0,4.0,2.0,4.0,6.0,5.0,4.0,2.0,7.0,4.0,4.0,6.0,4.0,6.0,7.0,4,,,,,,,,,,,,,,,,,,,,,,,,,,,,,,,,,,428.82,72.22,,,,8.74,,38.24,,,,,,,,,,,,,,154.9,,,,,,,,,,,,58.03,,,,,,,,,,,,,,,94.56,,,,,,2.13,,APPROVED,Male,19.0,FALSE
616,2022-03-22 01:10:50,19,en,1133948779,2022-03-22 01:05:54,2022-03-22 01:10:50,Y,Y,-oth-,highschool?,,6,,,,,,,,,,,,,,,,,,,,,,,,,,,,,,,,,9,,,,,,,,,,,,,,,,,,,,,,,,,,,,,,,,,3,,,,,,,,,,,,,,,,,,,,,,,,,,,,,,,,,13,,,,,,,,,,,,,,,,,,,,,,,,,,,,,,,,,2,1.0,1.0,1.0,1.0,1.0,1.0,7.0,1.0,1.0,1.0,1.0,1.0,1.0,1.0,1.0,1.0,1.0,1.0,1.0,1.0,1.0,1.0,1.0,1.0,1.0,1.0,1.0,1.0,1.0,1.0,5.0,5.0,12,,,,,,,,,,,,,,,,,,,,,,,,,,,,,,,,,10,,,,,,,,,,,,,,,,,,,,,,,,,,,,,,,,,8,,,,,,,,,,,,,,,,,,,,,,,,,,,,,,,,,1,3.0,3.0,2.0,1.0,1.0,1.0,6.0,3.0,6.0,1.0,1.0,1.0,5.0,5.0,5.0,2.0,6.0,4.0,5.0,1.0,1.0,5.0,6.0,1.0,1.0,6.0,2.0,2.0,4.0,1.0,2.0,2.0,4,,,,,,,,,,,,,,,,,,,,,,,,,,,,,,,,,5,,,,,,,,,,,,,,,,,,,,,,,,,,,,,,,,,11,,,,,,,,,,,,,,,,,,,,,,,,,,,,,,,,,0,1.0,5.0,1.0,1.0,1.0,1.0,7.0,5.0,7.0,1.0,1.0,1.0,1.0,1.0,1.0,1.0,1.0,1.0,2.0,1.0,1.0,1.0,2.0,1.0,1.0,3.0,5.0,1.0,3.0,1.0,5.0,6.0,14,,,,,,,,,,,,,,,,,,,,,,,,,,,,,,,,,7,,,,,,,,,,,,,,,,,,,,,,,,,,,,,,,,,,298.94,13.91,,,,33.11,,15.57,,,,,,,,,,,,,,71.31,,,,,,,,,,,,74.55,,,,,,,,,,,,87.99,,,,,,,,,2.5,,APPROVED,Male,21.0,FALSE
617,2022-03-22 01:09:58,19,en,247423802,2022-03-22 01:05:57,2022-03-22 01:09:58,Y,Y,A1,,,6,,,,,,,,,,,,,,,,,,,,,,,,,,,,,,,,,9,,,,,,,,,,,,,,,,,,,,,,,,,,,,,,,,,10,,,,,,,,,,,,,,,,,,,,,,,,,,,,,,,,,11,,,,,,,,,,,,,,,,,,,,,,,,,,,,,,,,,4,,,,,,,,,,,,,,,,,,,,,,,,,,,,,,,,,0,1.0,3.0,2.0,4.0,1.0,1.0,7.0,3.0,4.0,2.0,1.0,2.0,3.0,3.0,2.0,2.0,1.0,1.0,2.0,1.0,1.0,2.0,1.0,2.0,1.0,1.0,4.0,2.0,2.0,1.0,2.0,6.0,5,,,,,,,,,,,,,,,,,,,,,,,,,,,,,,,,,13,,,,,,,,,,,,,,,,,,,,,,,,,,,,,,,,,1,1.0,1.0,1.0,4.0,1.0,3.0,6.0,4.0,1.0,1.0,2.0,3.0,1.0,1.0,3.0,1.0,2.0,1.0,1.0,1.0,1.0,1.0,3.0,2.0,1.0,3.0,3.0,2.0,2.0,3.0,5.0,2.0,12,,,,,,,,,,,,,,,,,,,,,,,,,,,,,,,,,7,,,,,,,,,,,,,,,,,,,,,,,,,,,,,,,,,2,2.0,2.0,2.0,3.0,2.0,3.0,4.0,5.0,2.0,1.0,2.0,2.0,2.0,1.0,3.0,1.0,2.0,2.0,2.0,1.0,2.0,3.0,2.0,2.0,2.0,3.0,3.0,2.0,2.0,3.0,3.0,5.0,3,,,,,,,,,,,,,,,,,,,,,,,,,,,,,,,,,14,,,,,,,,,,,,,,,,,,,,,,,,,,,,,,,,,8,,,,,,,,,,,,,,,,,,,,,,,,,,,,,,,,,,245.52,13.6,,,,8.08,,37.56,,,,,,,,,,,,,,,,,63.67,,,,,,,,,67.93,,,,,,,,,51.74,,,,,,,,,,,,2.94,,APPROVED,Male,30.0,FALSE
618,2022-03-22 01:14:05,19,en,1251622747,2022-03-22 01:05:57,2022-03-22 01:14:05,Y,Y,A1,,,4,,,,,,,,,,,,,,,,,,,,,,,,,,,,,,,,,13,,,,,,,,,,,,,,,,,,,,,,,,,,,,,,,,,1,4.0,4.0,3.0,4.0,4.0,4.0,2.0,4.0,3.0,3.0,3.0,3.0,3.0,3.0,2.0,3.0,4.0,4.0,3.0,3.0,3.0,4.0,4.0,3.0,4.0,3.0,1.0,3.0,4.0,4.0,4.0,3.0,14,,,,,,,,,,,,,,,,,,,,,,,,,,,,,,,,,7,,,,,,,,,,,,,,,,,,,,,,,,,,,,,,,,,3,,,,,,,,,,,,,,,,,,,,,,,,,,,,,,,,,6,,,,,,,,,,,,,,,,,,,,,,,,,,,,,,,,,2,1.0,1.0,1.0,1.0,1.0,1.0,1.0,1.0,1.0,1.0,1.0,1.0,1.0,1.0,1.0,1.0,1.0,1.0,1.0,1.0,1.0,1.0,1.0,1.0,1.0,1.0,1.0,1.0,1.0,1.0,1.0,1.0,5,,,,,,,,,,,,,,,,,,,,,,,,,,,,,,,,,8,,,,,,,,,,,,,,,,,,,,,,,,,,,,,,,,,0,2.0,3.0,2.0,2.0,2.0,2.0,5.0,3.0,2.0,2.0,2.0,2.0,2.0,2.0,2.0,2.0,2.0,2.0,2.0,2.0,2.0,2.0,3.0,2.0,2.0,2.0,2.0,2.0,3.0,2.0,1.0,4.0,9,,,,,,,,,,,,,,,,,,,,,,,,,,,,,,,,,10,,,,,,,,,,,,,,,,,,,,,,,,,,,,,,,,,12,,,,,,,,,,,,,,,,,,,,,,,,,,,,,,,,,11,,,,,,,,,,,,,,,,,,,,,,,,,,,,,,,,,"It is interesting to evaluate this type of thing, they are very useful tools on a day-to-day basis and it is interesting to know the visual tastes of people.",490.59,27.36,,,,32.19,,36.29,,,,,,,,112.55,,,,,,,,,,,,,,,48.68,,,,,,,,,174.03,,,,,,,,,,,,,,,59.49,,APPROVED,Male,24.0,FALSE
619,2022-03-22 01:28:37,19,en,1681598952,2022-03-22 01:05:59,2022-03-22 01:28:37,Y,Y,A1,,,2,2.0,7.0,5.0,3.0,6.0,2.0,5.0,3.0,6.0,3.0,3.0,2.0,5.0,3.0,4.0,3.0,4.0,2.0,3.0,2.0,2.0,2.0,2.0,5.0,6.0,2.0,2.0,2.0,3.0,3.0,5.0,1.0,10,,,,,,,,,,,,,,,,,,,,,,,,,,,,,,,,,9,,,,,,,,,,,,,,,,,,,,,,,,,,,,,,,,,4,,,,,,,,,,,,,,,,,,,,,,,,,,,,,,,,,1,3.0,2.0,3.0,2.0,2.0,4.0,5.0,4.0,5.0,3.0,2.0,2.0,5.0,3.0,3.0,2.0,6.0,4.0,6.0,2.0,5.0,5.0,5.0,5.0,3.0,6.0,3.0,3.0,4.0,5.0,5.0,5.0,0,2.0,7.0,6.0,3.0,5.0,5.0,3.0,5.0,5.0,2.0,6.0,3.0,3.0,2.0,3.0,6.0,5.0,3.0,3.0,3.0,4.0,2.0,2.0,2.0,6.0,2.0,2.0,3.0,6.0,6.0,5.0,6.0,13,,,,,,,,,,,,,,,,,,,,,,,,,,,,,,,,,14,,,,,,,,,,,,,,,,,,,,,,,,,,,,,,,,,11,,,,,,,,,,,,,,,,,,,,,,,,,,,,,,,,,8,,,,,,,,,,,,,,,,,,,,,,,,,,,,,,,,,5,,,,,,,,,,,,,,,,,,,,,,,,,,,,,,,,,7,,,,,,,,,,,,,,,,,,,,,,,,,,,,,,,,,12,,,,,,,,,,,,,,,,,,,,,,,,,,,,,,,,,3,,,,,,,,,,,,,,,,,,,,,,,,,,,,,,,,,6,,,,,,,,,,,,,,,,,,,,,,,,,,,,,,,,,,1361.91,1099.73,,,,8.68,,21.98,,63.9,,,,,,,,,,,,70.18,,,93.88,,,,,,,,,,,,,,,,,,,,,,,,,,,,,,3.56,,APPROVED,Female,24.0,FALSE
620,2022-03-22 01:11:24,19,en,915286121,2022-03-22 01:06:01,2022-03-22 01:11:24,Y,Y,A1,,,11,,,,,,,,,,,,,,,,,,,,,,,,,,,,,,,,,13,,,,,,,,,,,,,,,,,,,,,,,,,,,,,,,,,5,,,,,,,,,,,,,,,,,,,,,,,,,,,,,,,,,1,6.0,6.0,6.0,3.0,6.0,5.0,5.0,6.0,6.0,6.0,6.0,5.0,5.0,6.0,6.0,6.0,6.0,5.0,6.0,6.0,6.0,6.0,3.0,6.0,6.0,6.0,6.0,6.0,6.0,6.0,6.0,4.0,2,3.0,3.0,2.0,3.0,3.0,2.0,6.0,3.0,5.0,3.0,3.0,3.0,2.0,3.0,3.0,2.0,3.0,2.0,3.0,2.0,3.0,2.0,3.0,3.0,3.0,5.0,2.0,3.0,3.0,3.0,5.0,5.0,10,,,,,,,,,,,,,,,,,,,,,,,,,,,,,,,,,7,,,,,,,,,,,,,,,,,,,,,,,,,,,,,,,,,14,,,,,,,,,,,,,,,,,,,,,,,,,,,,,,,,,12,,,,,,,,,,,,,,,,,,,,,,,,,,,,,,,,,8,,,,,,,,,,,,,,,,,,,,,,,,,,,,,,,,,3,,,,,,,,,,,,,,,,,,,,,,,,,,,,,,,,,6,,,,,,,,,,,,,,,,,,,,,,,,,,,,,,,,,0,3.0,6.0,3.0,3.0,2.0,5.0,4.0,6.0,6.0,3.0,5.0,3.0,3.0,6.0,6.0,2.0,6.0,2.0,5.0,2.0,3.0,5.0,2.0,5.0,5.0,6.0,5.0,5.0,6.0,5.0,6.0,6.0,4,,,,,,,,,,,,,,,,,,,,,,,,,,,,,,,,,9,,,,,,,,,,,,,,,,,,,,,,,,,,,,,,,,,,326.23,90.98,,,,5.97,,43.02,,,,,,,,,,,50.83,,,50.34,,,,,,,,,,,,,,,,,,,,,,,,82.39,,,,,,,,,2.7,,APPROVED,Male,23.0,FALSE
621,2022-03-22 01:11:10,19,en,1712277198,2022-03-22 01:06:02,2022-03-22 01:11:10,Y,Y,-oth-,High School,,9,,,,,,,,,,,,,,,,,,,,,,,,,,,,,,,,,4,,,,,,,,,,,,,,,,,,,,,,,,,,,,,,,,,11,,,,,,,,,,,,,,,,,,,,,,,,,,,,,,,,,8,,,,,,,,,,,,,,,,,,,,,,,,,,,,,,,,,0,3.0,3.0,1.0,2.0,2.0,1.0,7.0,2.0,4.0,2.0,3.0,5.0,5.0,4.0,6.0,2.0,5.0,1.0,4.0,3.0,3.0,3.0,2.0,3.0,3.0,4.0,5.0,3.0,5.0,3.0,4.0,5.0,10,,,,,,,,,,,,,,,,,,,,,,,,,,,,,,,,,13,,,,,,,,,,,,,,,,,,,,,,,,,,,,,,,,,2,6.0,6.0,6.0,6.0,5.0,6.0,2.0,4.0,4.0,4.0,5.0,6.0,6.0,5.0,4.0,5.0,5.0,6.0,6.0,5.0,4.0,6.0,6.0,5.0,5.0,2.0,2.0,5.0,4.0,5.0,5.0,1.0,3,,,,,,,,,,,,,,,,,,,,,,,,,,,,,,,,,1,1.0,5.0,1.0,1.0,2.0,1.0,7.0,1.0,1.0,1.0,1.0,3.0,2.0,2.0,4.0,1.0,3.0,1.0,1.0,1.0,1.0,1.0,1.0,1.0,2.0,1.0,5.0,1.0,6.0,1.0,1.0,3.0,14,,,,,,,,,,,,,,,,,,,,,,,,,,,,,,,,,12,,,,,,,,,,,,,,,,,,,,,,,,,,,,,,,,,7,,,,,,,,,,,,,,,,,,,,,,,,,,,,,,,,,6,,,,,,,,,,,,,,,,,,,,,,,,,,,,,,,,,5,,,,,,,,,,,,,,,,,,,,,,,,,,,,,,,,,,309.56,21.08,,,,13.99,,31.21,,,,,,,,,,,,,,95.28,,,,,,,,,74.71,,,,,,69.92,,,,,,,,,,,,,,,,,,3.37,,APPROVED,Male,37.0,FALSE
622,2022-03-22 01:17:39,19,en,304792879,2022-03-22 01:06:02,2022-03-22 01:17:39,Y,Y,-oth-,High School equivalent,,2,2.0,7.0,2.0,2.0,2.0,2.0,7.0,4.0,6.0,2.0,2.0,3.0,2.0,4.0,5.0,1.0,5.0,2.0,2.0,2.0,1.0,2.0,1.0,2.0,2.0,4.0,7.0,2.0,5.0,2.0,4.0,1.0,9,,,,,,,,,,,,,,,,,,,,,,,,,,,,,,,,,12,,,,,,,,,,,,,,,,,,,,,,,,,,,,,,,,,13,,,,,,,,,,,,,,,,,,,,,,,,,,,,,,,,,5,,,,,,,,,,,,,,,,,,,,,,,,,,,,,,,,,6,,,,,,,,,,,,,,,,,,,,,,,,,,,,,,,,,7,,,,,,,,,,,,,,,,,,,,,,,,,,,,,,,,,10,,,,,,,,,,,,,,,,,,,,,,,,,,,,,,,,,0,2.0,5.0,2.0,3.0,2.0,2.0,7.0,2.0,4.0,2.0,2.0,2.0,2.0,4.0,4.0,1.0,4.0,2.0,2.0,1.0,2.0,1.0,2.0,1.0,2.0,2.0,5.0,2.0,2.0,2.0,2.0,2.0,3,,,,,,,,,,,,,,,,,,,,,,,,,,,,,,,,,1,6.0,7.0,6.0,3.0,6.0,3.0,5.0,7.0,7.0,6.0,4.0,5.0,6.0,6.0,6.0,6.0,6.0,6.0,6.0,6.0,4.0,6.0,4.0,6.0,6.0,3.0,7.0,6.0,4.0,5.0,4.0,4.0,8,,,,,,,,,,,,,,,,,,,,,,,,,,,,,,,,,4,,,,,,,,,,,,,,,,,,,,,,,,,,,,,,,,,14,,,,,,,,,,,,,,,,,,,,,,,,,,,,,,,,,11,,,,,,,,,,,,,,,,,,,,,,,,,,,,,,,,,,701.04,54.5,,,,64.22,,36.53,,154.85,,,,,,,,,,,,,,,,,,,,,,,,215.75,,,,,,170.46,,,,,,,,,,,,,,,4.73,,APPROVED,Female,34.0,FALSE
623,2022-03-22 01:13:52,19,en,1157969234,2022-03-22 01:06:04,2022-03-22 01:13:52,Y,Y,-oth-,12th grade,,9,,,,,,,,,,,,,,,,,,,,,,,,,,,,,,,,,7,,,,,,,,,,,,,,,,,,,,,,,,,,,,,,,,,10,,,,,,,,,,,,,,,,,,,,,,,,,,,,,,,,,3,,,,,,,,,,,,,,,,,,,,,,,,,,,,,,,,,14,,,,,,,,,,,,,,,,,,,,,,,,,,,,,,,,,11,,,,,,,,,,,,,,,,,,,,,,,,,,,,,,,,,2,6.0,6.0,6.0,6.0,5.0,7.0,5.0,7.0,6.0,5.0,6.0,6.0,4.0,4.0,5.0,6.0,6.0,6.0,6.0,6.0,6.0,6.0,6.0,6.0,6.0,6.0,1.0,6.0,6.0,6.0,6.0,7.0,12,,,,,,,,,,,,,,,,,,,,,,,,,,,,,,,,,8,,,,,,,,,,,,,,,,,,,,,,,,,,,,,,,,,4,,,,,,,,,,,,,,,,,,,,,,,,,,,,,,,,,13,,,,,,,,,,,,,,,,,,,,,,,,,,,,,,,,,5,,,,,,,,,,,,,,,,,,,,,,,,,,,,,,,,,0,4.0,7.0,5.0,5.0,5.0,6.0,6.0,2.0,6.0,4.0,5.0,5.0,2.0,6.0,7.0,5.0,4.0,5.0,5.0,3.0,4.0,4.0,4.0,5.0,4.0,6.0,1.0,4.0,7.0,6.0,6.0,6.0,1,6.0,7.0,6.0,7.0,5.0,7.0,1.0,7.0,7.0,7.0,7.0,7.0,6.0,6.0,6.0,6.0,6.0,6.0,6.0,6.0,4.0,6.0,7.0,6.0,7.0,7.0,2.0,6.0,7.0,6.0,7.0,7.0,6,,,,,,,,,,,,,,,,,,,,,,,,,,,,,,,,,,471.09,20.93,,,,19.01,,46.31,,,,,,,,,,,,,,,,,,,,135.14,,,,,,,,,,,,,,,,,,143.81,,,100.13,,,,,,5.76,,APPROVED,Male,22.0,FALSE
624,2022-03-22 01:11:55,19,en,1555104315,2022-03-22 01:06:05,2022-03-22 01:11:55,Y,Y,A1,,,0,3.0,6.0,5.0,2.0,3.0,1.0,7.0,6.0,6.0,1.0,2.0,3.0,3.0,4.0,4.0,2.0,6.0,1.0,3.0,2.0,3.0,2.0,1.0,2.0,3.0,1.0,6.0,2.0,2.0,1.0,2.0,1.0,13,,,,,,,,,,,,,,,,,,,,,,,,,,,,,,,,,2,6.0,7.0,6.0,4.0,6.0,4.0,5.0,6.0,6.0,6.0,6.0,4.0,6.0,6.0,6.0,6.0,6.0,6.0,6.0,6.0,6.0,6.0,6.0,6.0,6.0,6.0,2.0,7.0,6.0,6.0,3.0,3.0,6,,,,,,,,,,,,,,,,,,,,,,,,,,,,,,,,,9,,,,,,,,,,,,,,,,,,,,,,,,,,,,,,,,,1,6.0,6.0,5.0,2.0,5.0,3.0,5.0,5.0,7.0,5.0,2.0,5.0,5.0,6.0,5.0,4.0,5.0,3.0,5.0,5.0,4.0,5.0,3.0,5.0,5.0,1.0,5.0,6.0,3.0,5.0,2.0,6.0,4,,,,,,,,,,,,,,,,,,,,,,,,,,,,,,,,,12,,,,,,,,,,,,,,,,,,,,,,,,,,,,,,,,,5,,,,,,,,,,,,,,,,,,,,,,,,,,,,,,,,,10,,,,,,,,,,,,,,,,,,,,,,,,,,,,,,,,,3,,,,,,,,,,,,,,,,,,,,,,,,,,,,,,,,,8,,,,,,,,,,,,,,,,,,,,,,,,,,,,,,,,,14,,,,,,,,,,,,,,,,,,,,,,,,,,,,,,,,,11,,,,,,,,,,,,,,,,,,,,,,,,,,,,,,,,,7,,,,,,,,,,,,,,,,,,,,,,,,,,,,,,,,,,354.46,82.97,,,,5.88,,42.5,,74.47,,,,,,64.67,,,,,,,,,79.31,,,,,,,,,,,,,,,,,,,,,,,,,,,,,,4.66,,APPROVED,Female,25.0,FALSE
625,2022-03-22 01:11:57,19,en,1894764314,2022-03-22 01:06:06,2022-03-22 01:11:57,Y,Y,A1,,,10,,,,,,,,,,,,,,,,,,,,,,,,,,,,,,,,,8,,,,,,,,,,,,,,,,,,,,,,,,,,,,,,,,,1,6.0,7.0,6.0,5.0,6.0,4.0,2.0,6.0,5.0,5.0,5.0,6.0,6.0,4.0,6.0,4.0,7.0,4.0,5.0,6.0,6.0,5.0,4.0,6.0,5.0,4.0,2.0,6.0,6.0,4.0,6.0,3.0,14,,,,,,,,,,,,,,,,,,,,,,,,,,,,,,,,,9,,,,,,,,,,,,,,,,,,,,,,,,,,,,,,,,,6,,,,,,,,,,,,,,,,,,,,,,,,,,,,,,,,,3,,,,,,,,,,,,,,,,,,,,,,,,,,,,,,,,,13,,,,,,,,,,,,,,,,,,,,,,,,,,,,,,,,,4,,,,,,,,,,,,,,,,,,,,,,,,,,,,,,,,,2,1.0,2.0,2.0,2.0,1.0,1.0,5.0,1.0,4.0,2.0,2.0,1.0,3.0,2.0,3.0,2.0,2.0,3.0,3.0,3.0,2.0,2.0,2.0,2.0,1.0,5.0,4.0,2.0,4.0,4.0,3.0,3.0,11,,,,,,,,,,,,,,,,,,,,,,,,,,,,,,,,,0,3.0,7.0,4.0,4.0,4.0,1.0,4.0,5.0,6.0,3.0,2.0,4.0,3.0,3.0,5.0,3.0,5.0,1.0,4.0,2.0,5.0,4.0,3.0,2.0,4.0,2.0,2.0,3.0,4.0,4.0,3.0,5.0,12,,,,,,,,,,,,,,,,,,,,,,,,,,,,,,,,,5,,,,,,,,,,,,,,,,,,,,,,,,,,,,,,,,,7,,,,,,,,,,,,,,,,,,,,,,,,,,,,,,,,,,355.51,38.45,,,,7.35,,31.68,,,,,,,,82.72,,,,,,,,,,,,,,,,,,,,,77.92,,,,,,111.6,,,,,,,,,,,,5.79,,APPROVED,Male,32.0,FALSE
626,2022-03-22 01:11:31,19,en,281421813,2022-03-22 01:06:06,2022-03-22 01:11:31,Y,Y,A1,,,13,,,,,,,,,,,,,,,,,,,,,,,,,,,,,,,,,4,,,,,,,,,,,,,,,,,,,,,,,,,,,,,,,,,5,,,,,,,,,,,,,,,,,,,,,,,,,,,,,,,,,7,,,,,,,,,,,,,,,,,,,,,,,,,,,,,,,,,2,3.0,2.0,4.0,5.0,3.0,5.0,3.0,4.0,3.0,3.0,2.0,3.0,3.0,2.0,2.0,2.0,3.0,3.0,2.0,3.0,1.0,5.0,4.0,3.0,5.0,5.0,2.0,3.0,3.0,3.0,6.0,5.0,12,,,,,,,,,,,,,,,,,,,,,,,,,,,,,,,,,10,,,,,,,,,,,,,,,,,,,,,,,,,,,,,,,,,6,,,,,,,,,,,,,,,,,,,,,,,,,,,,,,,,,8,,,,,,,,,,,,,,,,,,,,,,,,,,,,,,,,,1,5.0,3.0,5.0,5.0,2.0,3.0,7.0,1.0,2.0,5.0,3.0,5.0,4.0,3.0,6.0,2.0,5.0,3.0,3.0,4.0,3.0,5.0,2.0,3.0,3.0,5.0,6.0,5.0,3.0,4.0,6.0,3.0,0,7.0,7.0,7.0,5.0,7.0,5.0,4.0,5.0,7.0,6.0,7.0,7.0,6.0,6.0,7.0,5.0,7.0,6.0,7.0,7.0,5.0,5.0,6.0,7.0,7.0,6.0,7.0,7.0,7.0,7.0,6.0,4.0,14,,,,,,,,,,,,,,,,,,,,,,,,,,,,,,,,,9,,,,,,,,,,,,,,,,,,,,,,,,,,,,,,,,,11,,,,,,,,,,,,,,,,,,,,,,,,,,,,,,,,,3,,,,,,,,,,,,,,,,,,,,,,,,,,,,,,,,,I would have liked to know what the visuals were measuring. ,328.28,21.77,,,,9.5,,51.47,,,,,,,,,,,,,,62.63,,,,,,,,,,,,,,,78.95,,,78.35,,,,,,,,,,,,,,,25.61,,APPROVED,Female,29.0,FALSE
627,2022-03-22 01:14:18,19,en,574047240,2022-03-22 01:06:07,2022-03-22 01:14:18,Y,Y,-oth-,Current college student ,,0,3.0,6.0,3.0,3.0,4.0,3.0,7.0,4.0,6.0,4.0,2.0,2.0,4.0,4.0,5.0,4.0,6.0,3.0,4.0,4.0,4.0,4.0,1.0,3.0,3.0,3.0,5.0,2.0,3.0,4.0,2.0,1.0,12,,,,,,,,,,,,,,,,,,,,,,,,,,,,,,,,,4,,,,,,,,,,,,,,,,,,,,,,,,,,,,,,,,,6,,,,,,,,,,,,,,,,,,,,,,,,,,,,,,,,,13,,,,,,,,,,,,,,,,,,,,,,,,,,,,,,,,,11,,,,,,,,,,,,,,,,,,,,,,,,,,,,,,,,,3,,,,,,,,,,,,,,,,,,,,,,,,,,,,,,,,,10,,,,,,,,,,,,,,,,,,,,,,,,,,,,,,,,,2,1.0,1.0,1.0,5.0,2.0,6.0,1.0,6.0,2.0,2.0,3.0,2.0,1.0,1.0,5.0,6.0,1.0,1.0,2.0,2.0,1.0,3.0,6.0,1.0,1.0,5.0,2.0,1.0,2.0,4.0,2.0,2.0,14,,,,,,,,,,,,,,,,,,,,,,,,,,,,,,,,,1,5.0,7.0,5.0,4.0,5.0,6.0,5.0,6.0,7.0,5.0,6.0,6.0,6.0,4.0,5.0,5.0,6.0,5.0,5.0,4.0,4.0,6.0,2.0,5.0,6.0,3.0,6.0,4.0,5.0,6.0,4.0,4.0,7,,,,,,,,,,,,,,,,,,,,,,,,,,,,,,,,,5,,,,,,,,,,,,,,,,,,,,,,,,,,,,,,,,,8,,,,,,,,,,,,,,,,,,,,,,,,,,,,,,,,,9,,,,,,,,,,,,,,,,,,,,,,,,,,,,,,,,,,494.63,32.67,,,,49.92,,48.71,,133.31,,,,,,,,,,,,,,,,,,,,,,,,111.29,,,,,,115.95,,,,,,,,,,,,,,,2.78,,APPROVED,Male,22.0,FALSE
628,2022-03-22 01:09:18,19,en,1856981896,2022-03-22 01:06:08,2022-03-22 01:09:18,Y,Y,A1,,,14,,,,,,,,,,,,,,,,,,,,,,,,,,,,,,,,,1,5.0,4.0,5.0,6.0,6.0,6.0,4.0,6.0,6.0,4.0,5.0,5.0,5.0,6.0,5.0,6.0,5.0,6.0,6.0,2.0,6.0,6.0,5.0,6.0,6.0,6.0,3.0,5.0,3.0,5.0,5.0,2.0,11,,,,,,,,,,,,,,,,,,,,,,,,,,,,,,,,,3,,,,,,,,,,,,,,,,,,,,,,,,,,,,,,,,,5,,,,,,,,,,,,,,,,,,,,,,,,,,,,,,,,,6,,,,,,,,,,,,,,,,,,,,,,,,,,,,,,,,,2,5.0,7.0,6.0,2.0,4.0,4.0,6.0,1.0,7.0,3.0,2.0,6.0,5.0,7.0,6.0,2.0,7.0,4.0,5.0,2.0,4.0,6.0,2.0,5.0,5.0,3.0,6.0,3.0,3.0,4.0,3.0,7.0,7,,,,,,,,,,,,,,,,,,,,,,,,,,,,,,,,,0,6.0,2.0,3.0,6.0,2.0,5.0,3.0,6.0,2.0,3.0,6.0,3.0,4.0,3.0,3.0,5.0,5.0,3.0,4.0,2.0,3.0,3.0,6.0,3.0,3.0,6.0,3.0,5.0,4.0,6.0,3.0,2.0,10,,,,,,,,,,,,,,,,,,,,,,,,,,,,,,,,,13,,,,,,,,,,,,,,,,,,,,,,,,,,,,,,,,,9,,,,,,,,,,,,,,,,,,,,,,,,,,,,,,,,,8,,,,,,,,,,,,,,,,,,,,,,,,,,,,,,,,,4,,,,,,,,,,,,,,,,,,,,,,,,,,,,,,,,,12,,,,,,,,,,,,,,,,,,,,,,,,,,,,,,,,,,193.69,10.94,,,,5.53,,19.15,,,,,44.53,,,,,,,,,,,,,,,54.34,,,,,,56.65,,,,,,,,,,,,,,,,,,,,,2.55,,APPROVED,Male,22.0,FALSE
629,2022-03-22 01:14:01,19,en,787059991,2022-03-22 01:06:10,2022-03-22 01:14:01,Y,Y,A2,,,8,,,,,,,,,,,,,,,,,,,,,,,,,,,,,,,,,0,6.0,5.0,6.0,5.0,6.0,6.0,3.0,6.0,3.0,4.0,5.0,6.0,6.0,5.0,5.0,6.0,6.0,6.0,6.0,4.0,5.0,6.0,4.0,6.0,6.0,4.0,4.0,6.0,4.0,5.0,4.0,2.0,11,,,,,,,,,,,,,,,,,,,,,,,,,,,,,,,,,13,,,,,,,,,,,,,,,,,,,,,,,,,,,,,,,,,6,,,,,,,,,,,,,,,,,,,,,,,,,,,,,,,,,10,,,,,,,,,,,,,,,,,,,,,,,,,,,,,,,,,5,,,,,,,,,,,,,,,,,,,,,,,,,,,,,,,,,2,2.0,2.0,3.0,3.0,2.0,3.0,5.0,2.0,2.0,2.0,3.0,2.0,2.0,2.0,2.0,2.0,3.0,2.0,2.0,2.0,2.0,2.0,5.0,2.0,2.0,4.0,2.0,2.0,3.0,4.0,3.0,1.0,3,,,,,,,,,,,,,,,,,,,,,,,,,,,,,,,,,9,,,,,,,,,,,,,,,,,,,,,,,,,,,,,,,,,1,6.0,6.0,6.0,3.0,5.0,2.0,5.0,6.0,6.0,5.0,4.0,6.0,5.0,5.0,5.0,4.0,5.0,6.0,6.0,4.0,6.0,5.0,3.0,5.0,6.0,3.0,5.0,5.0,3.0,4.0,4.0,4.0,14,,,,,,,,,,,,,,,,,,,,,,,,,,,,,,,,,4,,,,,,,,,,,,,,,,,,,,,,,,,,,,,,,,,7,,,,,,,,,,,,,,,,,,,,,,,,,,,,,,,,,12,,,,,,,,,,,,,,,,,,,,,,,,,,,,,,,,,,475.18,48.63,,,,13.23,,76.47,,,,,103.39,,,,,,,,,,,,,,,,,,107.92,,,,,,,,,120.83,,,,,,,,,,,,,,,4.71,,APPROVED,Female,27.0,FALSE
630,2022-03-22 01:24:55,19,en,785993948,2022-03-22 01:06:10,2022-03-22 01:24:55,Y,Y,A1,,,3,,,,,,,,,,,,,,,,,,,,,,,,,,,,,,,,,9,,,,,,,,,,,,,,,,,,,,,,,,,,,,,,,,,5,,,,,,,,,,,,,,,,,,,,,,,,,,,,,,,,,12,,,,,,,,,,,,,,,,,,,,,,,,,,,,,,,,,11,,,,,,,,,,,,,,,,,,,,,,,,,,,,,,,,,2,5.0,6.0,6.0,5.0,6.0,6.0,6.0,7.0,5.0,5.0,5.0,6.0,6.0,6.0,6.0,6.0,6.0,6.0,6.0,5.0,6.0,6.0,6.0,6.0,6.0,5.0,6.0,6.0,5.0,5.0,5.0,6.0,14,,,,,,,,,,,,,,,,,,,,,,,,,,,,,,,,,6,,,,,,,,,,,,,,,,,,,,,,,,,,,,,,,,,0,3.0,2.0,2.0,2.0,1.0,3.0,2.0,6.0,2.0,2.0,2.0,2.0,2.0,3.0,2.0,5.0,3.0,3.0,3.0,1.0,3.0,2.0,5.0,2.0,2.0,3.0,3.0,3.0,5.0,3.0,3.0,2.0,1,6.0,5.0,6.0,5.0,2.0,3.0,6.0,6.0,6.0,3.0,6.0,6.0,6.0,6.0,3.0,5.0,6.0,2.0,5.0,1.0,2.0,2.0,5.0,6.0,5.0,3.0,3.0,6.0,6.0,6.0,3.0,3.0,4,,,,,,,,,,,,,,,,,,,,,,,,,,,,,,,,,8,,,,,,,,,,,,,,,,,,,,,,,,,,,,,,,,,13,,,,,,,,,,,,,,,,,,,,,,,,,,,,,,,,,7,,,,,,,,,,,,,,,,,,,,,,,,,,,,,,,,,10,,,,,,,,,,,,,,,,,,,,,,,,,,,,,,,,,,1130.85,37.7,,,,7.84,,260.95,,,,,,,,,,,,,,,,,92.16,,,,,,,,,641.34,,,87.46,,,,,,,,,,,,,,,,,,3.4,,APPROVED,Female,28.0,FALSE
631,2022-03-22 01:10:08,19,en,1749229415,2022-03-22 01:06:13,2022-03-22 01:10:08,Y,Y,A2,,,0,2.0,4.0,2.0,5.0,2.0,2.0,7.0,5.0,2.0,2.0,2.0,2.0,2.0,2.0,2.0,2.0,4.0,4.0,2.0,2.0,2.0,1.0,2.0,2.0,2.0,2.0,6.0,3.0,2.0,4.0,2.0,1.0,6,,,,,,,,,,,,,,,,,,,,,,,,,,,,,,,,,7,,,,,,,,,,,,,,,,,,,,,,,,,,,,,,,,,10,,,,,,,,,,,,,,,,,,,,,,,,,,,,,,,,,8,,,,,,,,,,,,,,,,,,,,,,,,,,,,,,,,,2,5.0,6.0,4.0,3.0,5.0,4.0,3.0,5.0,6.0,5.0,6.0,6.0,5.0,6.0,6.0,5.0,5.0,5.0,6.0,5.0,4.0,5.0,4.0,4.0,4.0,6.0,6.0,6.0,5.0,6.0,5.0,6.0,13,,,,,,,,,,,,,,,,,,,,,,,,,,,,,,,,,1,6.0,6.0,5.0,6.0,5.0,7.0,7.0,2.0,6.0,6.0,4.0,6.0,7.0,5.0,6.0,6.0,7.0,5.0,6.0,5.0,4.0,6.0,6.0,6.0,6.0,4.0,1.0,6.0,6.0,6.0,7.0,1.0,4,,,,,,,,,,,,,,,,,,,,,,,,,,,,,,,,,5,,,,,,,,,,,,,,,,,,,,,,,,,,,,,,,,,9,,,,,,,,,,,,,,,,,,,,,,,,,,,,,,,,,12,,,,,,,,,,,,,,,,,,,,,,,,,,,,,,,,,11,,,,,,,,,,,,,,,,,,,,,,,,,,,,,,,,,3,,,,,,,,,,,,,,,,,,,,,,,,,,,,,,,,,14,,,,,,,,,,,,,,,,,,,,,,,,,,,,,,,,,,238.76,9.42,,,,4.34,,45.89,,73.55,,,,,,,,,,,,,,,49.92,,,,,,53.1,,,,,,,,,,,,,,,,,,,,,,,,2.54,,APPROVED,Male,32.0,FALSE
632,2022-03-22 01:09:34,19,en,117852674,2022-03-22 01:06:15,2022-03-22 01:09:34,Y,Y,A1,,,13,,,,,,,,,,,,,,,,,,,,,,,,,,,,,,,,,1,5.0,4.0,3.0,4.0,5.0,6.0,3.0,3.0,3.0,3.0,5.0,4.0,4.0,5.0,4.0,4.0,4.0,5.0,5.0,4.0,5.0,6.0,5.0,4.0,5.0,6.0,6.0,5.0,5.0,4.0,6.0,2.0,9,,,,,,,,,,,,,,,,,,,,,,,,,,,,,,,,,14,,,,,,,,,,,,,,,,,,,,,,,,,,,,,,,,,4,,,,,,,,,,,,,,,,,,,,,,,,,,,,,,,,,8,,,,,,,,,,,,,,,,,,,,,,,,,,,,,,,,,6,,,,,,,,,,,,,,,,,,,,,,,,,,,,,,,,,11,,,,,,,,,,,,,,,,,,,,,,,,,,,,,,,,,10,,,,,,,,,,,,,,,,,,,,,,,,,,,,,,,,,3,,,,,,,,,,,,,,,,,,,,,,,,,,,,,,,,,5,,,,,,,,,,,,,,,,,,,,,,,,,,,,,,,,,2,3.0,5.0,5.0,4.0,3.0,3.0,5.0,4.0,3.0,3.0,5.0,4.0,4.0,3.0,4.0,5.0,5.0,4.0,4.0,5.0,5.0,3.0,5.0,4.0,4.0,5.0,4.0,4.0,5.0,5.0,3.0,5.0,7,,,,,,,,,,,,,,,,,,,,,,,,,,,,,,,,,0,3.0,5.0,2.0,3.0,2.0,5.0,3.0,5.0,5.0,3.0,4.0,4.0,3.0,4.0,4.0,4.0,4.0,3.0,3.0,3.0,2.0,2.0,5.0,4.0,3.0,5.0,5.0,2.0,4.0,4.0,5.0,7.0,12,,,,,,,,,,,,,,,,,,,,,,,,,,,,,,,,,,202.4,14.83,,,,6.25,,30.93,,,,,43.87,,,,,,,,,,,,,,,,,,,,,,,,,,,,,,38.35,,,,,,64.4,,,,,,3.77,,APPROVED,Female,26.0,FALSE
633,2022-03-22 01:10:55,19,en,1277012106,2022-03-22 01:06:17,2022-03-22 01:10:55,Y,Y,A1,,,14,,,,,,,,,,,,,,,,,,,,,,,,,,,,,,,,,11,,,,,,,,,,,,,,,,,,,,,,,,,,,,,,,,,12,,,,,,,,,,,,,,,,,,,,,,,,,,,,,,,,,0,3.0,4.0,3.0,6.0,3.0,2.0,4.0,5.0,3.0,3.0,4.0,4.0,3.0,4.0,4.0,3.0,3.0,3.0,4.0,3.0,2.0,5.0,3.0,4.0,3.0,3.0,2.0,6.0,3.0,3.0,5.0,4.0,7,,,,,,,,,,,,,,,,,,,,,,,,,,,,,,,,,2,4.0,3.0,3.0,3.0,3.0,4.0,4.0,2.0,4.0,3.0,3.0,4.0,3.0,3.0,3.0,3.0,4.0,3.0,3.0,3.0,3.0,5.0,3.0,4.0,3.0,5.0,1.0,3.0,5.0,3.0,4.0,6.0,3,,,,,,,,,,,,,,,,,,,,,,,,,,,,,,,,,5,,,,,,,,,,,,,,,,,,,,,,,,,,,,,,,,,13,,,,,,,,,,,,,,,,,,,,,,,,,,,,,,,,,10,,,,,,,,,,,,,,,,,,,,,,,,,,,,,,,,,4,,,,,,,,,,,,,,,,,,,,,,,,,,,,,,,,,1,3.0,6.0,3.0,4.0,4.0,3.0,3.0,5.0,3.0,3.0,3.0,4.0,5.0,4.0,3.0,5.0,4.0,3.0,4.0,3.0,3.0,5.0,2.0,6.0,4.0,2.0,3.0,4.0,3.0,4.0,4.0,5.0,6,,,,,,,,,,,,,,,,,,,,,,,,,,,,,,,,,9,,,,,,,,,,,,,,,,,,,,,,,,,,,,,,,,,8,,,,,,,,,,,,,,,,,,,,,,,,,,,,,,,,,,281.87,29.13,,,,24.89,,42.7,,,,,,,,,,,65.8,,,,,,57.45,,,,,,,,,,,,,,,,,,58.78,,,,,,,,,,,,3.12,,APPROVED,Male,20.0,FALSE
634,2022-03-22 01:09:00,19,en,218759221,2022-03-22 01:06:18,2022-03-22 01:09:00,Y,Y,A1,,,14,,,,,,,,,,,,,,,,,,,,,,,,,,,,,,,,,11,,,,,,,,,,,,,,,,,,,,,,,,,,,,,,,,,3,,,,,,,,,,,,,,,,,,,,,,,,,,,,,,,,,1,6.0,7.0,5.0,4.0,5.0,4.0,4.0,7.0,6.0,5.0,6.0,7.0,3.0,4.0,5.0,4.0,7.0,6.0,5.0,6.0,4.0,6.0,6.0,6.0,4.0,7.0,6.0,6.0,7.0,6.0,5.0,4.0,8,,,,,,,,,,,,,,,,,,,,,,,,,,,,,,,,,10,,,,,,,,,,,,,,,,,,,,,,,,,,,,,,,,,5,,,,,,,,,,,,,,,,,,,,,,,,,,,,,,,,,6,,,,,,,,,,,,,,,,,,,,,,,,,,,,,,,,,12,,,,,,,,,,,,,,,,,,,,,,,,,,,,,,,,,7,,,,,,,,,,,,,,,,,,,,,,,,,,,,,,,,,2,4.0,4.0,5.0,6.0,6.0,5.0,4.0,5.0,5.0,5.0,5.0,4.0,5.0,5.0,3.0,5.0,5.0,4.0,6.0,6.0,6.0,5.0,7.0,6.0,4.0,5.0,5.0,6.0,5.0,5.0,4.0,4.0,9,,,,,,,,,,,,,,,,,,,,,,,,,,,,,,,,,4,,,,,,,,,,,,,,,,,,,,,,,,,,,,,,,,,13,,,,,,,,,,,,,,,,,,,,,,,,,,,,,,,,,0,5.0,5.0,5.0,5.0,5.0,4.0,4.0,4.0,4.0,4.0,4.0,5.0,4.0,4.0,5.0,6.0,4.0,5.0,2.0,3.0,1.0,5.0,5.0,3.0,3.0,7.0,4.0,4.0,4.0,4.0,6.0,1.0,,164.84,9.42,,,,5.64,,23.61,,,,,,,,,,,34.15,,,,,,,,,,,,,,,,,,,,,33.2,,,,,,,,,,,,56.75,,,2.07,,APPROVED,Male,20.0,FALSE
635,2022-03-22 01:14:14,19,en,446236171,2022-03-22 01:06:30,2022-03-22 01:14:14,Y,Y,A1,,,0,2.0,6.0,2.0,4.0,1.0,2.0,7.0,5.0,5.0,1.0,2.0,1.0,1.0,3.0,4.0,1.0,5.0,2.0,2.0,1.0,2.0,2.0,4.0,2.0,2.0,2.0,5.0,2.0,2.0,1.0,4.0,1.0,12,,,,,,,,,,,,,,,,,,,,,,,,,,,,,,,,,10,,,,,,,,,,,,,,,,,,,,,,,,,,,,,,,,,8,,,,,,,,,,,,,,,,,,,,,,,,,,,,,,,,,14,,,,,,,,,,,,,,,,,,,,,,,,,,,,,,,,,1,5.0,5.0,5.0,6.0,6.0,7.0,5.0,5.0,5.0,6.0,6.0,5.0,5.0,4.0,5.0,6.0,6.0,4.0,6.0,5.0,4.0,5.0,5.0,6.0,7.0,4.0,4.0,5.0,4.0,5.0,6.0,6.0,11,,,,,,,,,,,,,,,,,,,,,,,,,,,,,,,,,5,,,,,,,,,,,,,,,,,,,,,,,,,,,,,,,,,7,,,,,,,,,,,,,,,,,,,,,,,,,,,,,,,,,6,,,,,,,,,,,,,,,,,,,,,,,,,,,,,,,,,3,,,,,,,,,,,,,,,,,,,,,,,,,,,,,,,,,9,,,,,,,,,,,,,,,,,,,,,,,,,,,,,,,,,2,3.0,6.0,3.0,4.0,4.0,5.0,7.0,6.0,5.0,3.0,6.0,4.0,4.0,4.0,5.0,4.0,4.0,4.0,4.0,3.0,2.0,3.0,5.0,5.0,3.0,5.0,3.0,3.0,4.0,4.0,4.0,6.0,4,,,,,,,,,,,,,,,,,,,,,,,,,,,,,,,,,13,,,,,,,,,,,,,,,,,,,,,,,,,,,,,,,,,,468.42,106.32,,,,7.88,,40.59,,104.91,,,,,,,,,,,,,,,90.74,,,,,,,,,,,,,,,,,,,,,110.5,,,,,,,,,7.48,,APPROVED,Male,30.0,FALSE
636,2022-03-22 01:19:21,19,en,234756607,2022-03-22 01:06:31,2022-03-22 01:19:21,Y,Y,A1,,,11,,,,,,,,,,,,,,,,,,,,,,,,,,,,,,,,,12,,,,,,,,,,,,,,,,,,,,,,,,,,,,,,,,,7,,,,,,,,,,,,,,,,,,,,,,,,,,,,,,,,,2,7.0,7.0,7.0,6.0,6.0,5.0,5.0,7.0,6.0,6.0,6.0,7.0,7.0,7.0,7.0,6.0,7.0,7.0,7.0,5.0,6.0,5.0,6.0,7.0,6.0,6.0,7.0,7.0,7.0,6.0,6.0,4.0,10,,,,,,,,,,,,,,,,,,,,,,,,,,,,,,,,,9,,,,,,,,,,,,,,,,,,,,,,,,,,,,,,,,,5,,,,,,,,,,,,,,,,,,,,,,,,,,,,,,,,,3,,,,,,,,,,,,,,,,,,,,,,,,,,,,,,,,,1,3.0,1.0,6.0,7.0,3.0,7.0,6.0,5.0,3.0,4.0,5.0,2.0,6.0,3.0,7.0,7.0,5.0,3.0,6.0,2.0,3.0,2.0,7.0,5.0,2.0,7.0,5.0,6.0,7.0,4.0,3.0,2.0,4,,,,,,,,,,,,,,,,,,,,,,,,,,,,,,,,,6,,,,,,,,,,,,,,,,,,,,,,,,,,,,,,,,,13,,,,,,,,,,,,,,,,,,,,,,,,,,,,,,,,,14,,,,,,,,,,,,,,,,,,,,,,,,,,,,,,,,,8,,,,,,,,,,,,,,,,,,,,,,,,,,,,,,,,,0,5.0,7.0,5.0,6.0,5.0,7.0,1.0,5.0,2.0,4.0,7.0,6.0,5.0,5.0,6.0,5.0,3.0,3.0,7.0,5.0,5.0,7.0,6.0,4.0,6.0,2.0,6.0,2.0,7.0,5.0,2.0,1.0,,773.83,272.33,,,,5.88,,22.1,,,,,,,,,,,66.91,,,,,,,,,,,,,,,307.27,,,,,,,,,,,,,,,,,,92.91,,,6.43,,APPROVED,Female,19.0,FALSE
637,2022-03-22 01:16:40,19,en,1312167593,2022-03-22 01:06:37,2022-03-22 01:16:40,Y,Y,A1,,,8,,,,,,,,,,,,,,,,,,,,,,,,,,,,,,,,,14,,,,,,,,,,,,,,,,,,,,,,,,,,,,,,,,,9,,,,,,,,,,,,,,,,,,,,,,,,,,,,,,,,,4,,,,,,,,,,,,,,,,,,,,,,,,,,,,,,,,,6,,,,,,,,,,,,,,,,,,,,,,,,,,,,,,,,,7,,,,,,,,,,,,,,,,,,,,,,,,,,,,,,,,,0,3.0,6.0,2.0,4.0,3.0,2.0,5.0,4.0,4.0,2.0,2.0,3.0,3.0,2.0,3.0,4.0,3.0,2.0,2.0,2.0,4.0,3.0,3.0,4.0,3.0,2.0,4.0,2.0,2.0,2.0,2.0,7.0,2,6.0,4.0,4.0,5.0,4.0,6.0,3.0,3.0,5.0,5.0,3.0,5.0,6.0,6.0,5.0,5.0,5.0,6.0,6.0,6.0,4.0,6.0,5.0,5.0,3.0,2.0,4.0,6.0,2.0,5.0,5.0,1.0,3,,,,,,,,,,,,,,,,,,,,,,,,,,,,,,,,,5,,,,,,,,,,,,,,,,,,,,,,,,,,,,,,,,,11,,,,,,,,,,,,,,,,,,,,,,,,,,,,,,,,,13,,,,,,,,,,,,,,,,,,,,,,,,,,,,,,,,,10,,,,,,,,,,,,,,,,,,,,,,,,,,,,,,,,,12,,,,,,,,,,,,,,,,,,,,,,,,,,,,,,,,,1,4.0,7.0,6.0,4.0,5.0,3.0,6.0,5.0,6.0,4.0,5.0,6.0,6.0,6.0,6.0,4.0,6.0,5.0,5.0,4.0,4.0,5.0,4.0,5.0,5.0,2.0,6.0,4.0,4.0,5.0,4.0,1.0,,607.51,48.85,,,,11.89,,61.67,,,,,,,,,,,,,,,,,,,,187.23,,,155.83,,,,,,,,,,,,,,,,,,,,,137.22,,,4.82,,APPROVED,Male,27.0,FALSE
638,2022-03-22 01:24:18,19,en,1676156523,2022-03-22 01:06:58,2022-03-22 01:24:18,Y,Y,A2,,,0,6.0,7.0,6.0,4.0,5.0,4.0,1.0,5.0,7.0,5.0,4.0,5.0,6.0,6.0,6.0,4.0,7.0,6.0,6.0,4.0,5.0,6.0,4.0,6.0,6.0,5.0,1.0,4.0,4.0,5.0,5.0,1.0,11,,,,,,,,,,,,,,,,,,,,,,,,,,,,,,,,,4,,,,,,,,,,,,,,,,,,,,,,,,,,,,,,,,,6,,,,,,,,,,,,,,,,,,,,,,,,,,,,,,,,,5,,,,,,,,,,,,,,,,,,,,,,,,,,,,,,,,,13,,,,,,,,,,,,,,,,,,,,,,,,,,,,,,,,,7,,,,,,,,,,,,,,,,,,,,,,,,,,,,,,,,,2,2.0,1.0,2.0,4.0,2.0,4.0,5.0,4.0,2.0,2.0,2.0,3.0,3.0,2.0,2.0,3.0,4.0,3.0,4.0,1.0,2.0,3.0,4.0,3.0,3.0,5.0,4.0,4.0,2.0,4.0,4.0,1.0,14,,,,,,,,,,,,,,,,,,,,,,,,,,,,,,,,,1,4.0,5.0,4.0,5.0,4.0,6.0,3.0,6.0,4.0,4.0,5.0,3.0,2.0,2.0,4.0,6.0,4.0,4.0,3.0,3.0,2.0,4.0,5.0,4.0,5.0,5.0,4.0,3.0,5.0,5.0,5.0,3.0,12,,,,,,,,,,,,,,,,,,,,,,,,,,,,,,,,,9,,,,,,,,,,,,,,,,,,,,,,,,,,,,,,,,,8,,,,,,,,,,,,,,,,,,,,,,,,,,,,,,,,,3,,,,,,,,,,,,,,,,,,,,,,,,,,,,,,,,,10,,,,,,,,,,,,,,,,,,,,,,,,,,,,,,,,,-,1042.96,27.04,,,,28.58,,43.2,,306.77,,,,,,,,,,,,,,,,,,,,,247.93,,,,,,379.14,,,,,,,,,,,,,,,,,,10.3,,APPROVED,Female,31.0,FALSE
639,2022-03-22 01:14:54,19,en,1345600398,2022-03-22 01:09:00,2022-03-22 01:14:54,Y,Y,A1,,,11,,,,,,,,,,,,,,,,,,,,,,,,,,,,,,,,,10,,,,,,,,,,,,,,,,,,,,,,,,,,,,,,,,,2,3.0,7.0,6.0,5.0,4.0,4.0,4.0,6.0,7.0,5.0,2.0,3.0,5.0,6.0,5.0,4.0,4.0,4.0,5.0,5.0,7.0,5.0,5.0,5.0,5.0,3.0,4.0,3.0,4.0,3.0,6.0,3.0,7,,,,,,,,,,,,,,,,,,,,,,,,,,,,,,,,,13,,,,,,,,,,,,,,,,,,,,,,,,,,,,,,,,,14,,,,,,,,,,,,,,,,,,,,,,,,,,,,,,,,,0,3.0,5.0,4.0,7.0,7.0,7.0,4.0,7.0,5.0,5.0,6.0,4.0,5.0,6.0,6.0,3.0,7.0,4.0,7.0,4.0,3.0,5.0,6.0,6.0,5.0,6.0,2.0,6.0,7.0,4.0,5.0,7.0,3,,,,,,,,,,,,,,,,,,,,,,,,,,,,,,,,,4,,,,,,,,,,,,,,,,,,,,,,,,,,,,,,,,,1,3.0,5.0,5.0,7.0,6.0,2.0,3.0,7.0,5.0,4.0,6.0,5.0,4.0,7.0,6.0,4.0,7.0,3.0,4.0,3.0,6.0,5.0,5.0,3.0,6.0,5.0,7.0,6.0,6.0,4.0,5.0,3.0,6,,,,,,,,,,,,,,,,,,,,,,,,,,,,,,,,,5,,,,,,,,,,,,,,,,,,,,,,,,,,,,,,,,,9,,,,,,,,,,,,,,,,,,,,,,,,,,,,,,,,,8,,,,,,,,,,,,,,,,,,,,,,,,,,,,,,,,,12,,,,,,,,,,,,,,,,,,,,,,,,,,,,,,,,,,358.11,46.7,,,,9.41,,41.5,,,,,,,,75.81,,,,,,,,,,,,96.07,,,,,,,,,84.82,,,,,,,,,,,,,,,,,,3.8,,APPROVED,Female,21.0,FALSE
640,2022-03-22 01:20:24,19,en,1121716035,2022-03-22 01:09:26,2022-03-22 01:20:24,Y,Y,A1,,,0,2.0,5.0,2.0,4.0,3.0,2.0,7.0,6.0,5.0,2.0,5.0,5.0,3.0,5.0,5.0,5.0,5.0,3.0,3.0,2.0,5.0,2.0,5.0,2.0,2.0,6.0,6.0,2.0,5.0,3.0,6.0,1.0,4,,,,,,,,,,,,,,,,,,,,,,,,,,,,,,,,,10,,,,,,,,,,,,,,,,,,,,,,,,,,,,,,,,,5,,,,,,,,,,,,,,,,,,,,,,,,,,,,,,,,,8,,,,,,,,,,,,,,,,,,,,,,,,,,,,,,,,,13,,,,,,,,,,,,,,,,,,,,,,,,,,,,,,,,,11,,,,,,,,,,,,,,,,,,,,,,,,,,,,,,,,,14,,,,,,,,,,,,,,,,,,,,,,,,,,,,,,,,,12,,,,,,,,,,,,,,,,,,,,,,,,,,,,,,,,,1,5.0,5.0,5.0,5.0,5.0,5.0,2.0,6.0,5.0,5.0,6.0,5.0,4.0,4.0,5.0,5.0,6.0,3.0,5.0,3.0,2.0,5.0,5.0,5.0,5.0,5.0,5.0,5.0,5.0,6.0,6.0,3.0,7,,,,,,,,,,,,,,,,,,,,,,,,,,,,,,,,,9,,,,,,,,,,,,,,,,,,,,,,,,,,,,,,,,,2,5.0,5.0,5.0,6.0,4.0,5.0,2.0,6.0,5.0,5.0,5.0,4.0,5.0,5.0,5.0,4.0,5.0,5.0,5.0,4.0,4.0,5.0,5.0,4.0,5.0,5.0,5.0,4.0,4.0,5.0,5.0,6.0,3,,,,,,,,,,,,,,,,,,,,,,,,,,,,,,,,,6,,,,,,,,,,,,,,,,,,,,,,,,,,,,,,,,,I don't have any comments.,663.06,62.07,,,,15.41,,54.1,,202.86,,,,,,,,,,,,,,,,,,,,,,,,,,,149.32,,,,,,,,,156.88,,,,,,,,,22.42,,APPROVED,Female,22.0,FALSE
641,2022-03-22 01:25:24,19,en,1303808017,2022-03-22 01:15:16,2022-03-22 01:25:24,Y,Y,A1,,,0,2.0,6.0,5.0,3.0,5.0,1.0,5.0,3.0,7.0,5.0,3.0,6.0,3.0,6.0,5.0,1.0,6.0,1.0,2.0,3.0,5.0,5.0,2.0,3.0,3.0,7.0,4.0,5.0,6.0,6.0,3.0,1.0,11,,,,,,,,,,,,,,,,,,,,,,,,,,,,,,,,,7,,,,,,,,,,,,,,,,,,,,,,,,,,,,,,,,,2,5.0,5.0,7.0,7.0,4.0,6.0,5.0,7.0,7.0,5.0,6.0,7.0,6.0,6.0,5.0,6.0,6.0,7.0,5.0,5.0,7.0,6.0,7.0,5.0,6.0,7.0,3.0,6.0,6.0,5.0,7.0,4.0,6,,,,,,,,,,,,,,,,,,,,,,,,,,,,,,,,,9,,,,,,,,,,,,,,,,,,,,,,,,,,,,,,,,,13,,,,,,,,,,,,,,,,,,,,,,,,,,,,,,,,,3,,,,,,,,,,,,,,,,,,,,,,,,,,,,,,,,,12,,,,,,,,,,,,,,,,,,,,,,,,,,,,,,,,,14,,,,,,,,,,,,,,,,,,,,,,,,,,,,,,,,,10,,,,,,,,,,,,,,,,,,,,,,,,,,,,,,,,,8,,,,,,,,,,,,,,,,,,,,,,,,,,,,,,,,,1,3.0,3.0,2.0,3.0,3.0,3.0,5.0,2.0,5.0,4.0,2.0,6.0,3.0,5.0,5.0,6.0,5.0,1.0,1.0,2.0,6.0,5.0,5.0,5.0,3.0,6.0,3.0,3.0,6.0,5.0,3.0,6.0,5,,,,,,,,,,,,,,,,,,,,,,,,,,,,,,,,,4,,,,,,,,,,,,,,,,,,,,,,,,,,,,,,,,,I was able to reverse search the images with google and found out that the second chart (which i have never seen a chart like that before) had something to do with biology,610.55,13.74,,,,11.28,,114.65,,124.14,,,,,,,,,151.12,,,,,,,,,,,,,,,,,,,,,,,,,,,126.13,,,,,,,,,69.49,,APPROVED,Male,24.0,FALSE
642,2022-03-22 01:37:43,19,en,475547818,2022-03-22 01:15:21,2022-03-22 01:37:43,Y,Y,A1,,,6,,,,,,,,,,,,,,,,,,,,,,,,,,,,,,,,,1,6.0,3.0,6.0,4.0,6.0,6.0,4.0,7.0,3.0,4.0,3.0,3.0,6.0,4.0,4.0,5.0,5.0,5.0,6.0,4.0,4.0,6.0,5.0,6.0,6.0,4.0,3.0,6.0,3.0,6.0,6.0,2.0,13,,,,,,,,,,,,,,,,,,,,,,,,,,,,,,,,,2,5.0,3.0,6.0,2.0,4.0,2.0,7.0,4.0,7.0,4.0,3.0,3.0,5.0,4.0,7.0,4.0,6.0,4.0,4.0,4.0,4.0,5.0,4.0,4.0,3.0,4.0,7.0,5.0,2.0,4.0,5.0,4.0,4,,,,,,,,,,,,,,,,,,,,,,,,,,,,,,,,,12,,,,,,,,,,,,,,,,,,,,,,,,,,,,,,,,,9,,,,,,,,,,,,,,,,,,,,,,,,,,,,,,,,,10,,,,,,,,,,,,,,,,,,,,,,,,,,,,,,,,,0,3.0,2.0,2.0,5.0,2.0,4.0,6.0,1.0,3.0,3.0,4.0,2.0,3.0,2.0,4.0,2.0,3.0,3.0,3.0,2.0,2.0,4.0,3.0,2.0,4.0,6.0,2.0,4.0,5.0,4.0,4.0,2.0,5,,,,,,,,,,,,,,,,,,,,,,,,,,,,,,,,,3,,,,,,,,,,,,,,,,,,,,,,,,,,,,,,,,,11,,,,,,,,,,,,,,,,,,,,,,,,,,,,,,,,,7,,,,,,,,,,,,,,,,,,,,,,,,,,,,,,,,,14,,,,,,,,,,,,,,,,,,,,,,,,,,,,,,,,,8,,,,,,,,,,,,,,,,,,,,,,,,,,,,,,,,,,1343.86,881.02,,,,5.14,,16.46,,,,,121.97,,,,,,106.61,,,,,,,,,,,,,,,210.02,,,,,,,,,,,,,,,,,,,,,2.64,,APPROVED,Male,22.0,FALSE
643,2022-03-22 01:21:28,19,en,615447816,2022-03-22 01:15:22,2022-03-22 01:21:28,Y,Y,A1,,,0,2.0,6.0,2.0,2.0,3.0,3.0,6.0,3.0,4.0,2.0,2.0,2.0,2.0,4.0,2.0,3.0,5.0,3.0,2.0,2.0,3.0,3.0,2.0,2.0,5.0,4.0,5.0,2.0,3.0,4.0,4.0,1.0,1,6.0,5.0,5.0,5.0,5.0,6.0,3.0,6.0,5.0,4.0,6.0,5.0,5.0,5.0,6.0,5.0,5.0,5.0,5.0,4.0,5.0,6.0,6.0,5.0,6.0,6.0,5.0,5.0,5.0,5.0,6.0,2.0,11,,,,,,,,,,,,,,,,,,,,,,,,,,,,,,,,,12,,,,,,,,,,,,,,,,,,,,,,,,,,,,,,,,,4,,,,,,,,,,,,,,,,,,,,,,,,,,,,,,,,,9,,,,,,,,,,,,,,,,,,,,,,,,,,,,,,,,,14,,,,,,,,,,,,,,,,,,,,,,,,,,,,,,,,,6,,,,,,,,,,,,,,,,,,,,,,,,,,,,,,,,,13,,,,,,,,,,,,,,,,,,,,,,,,,,,,,,,,,7,,,,,,,,,,,,,,,,,,,,,,,,,,,,,,,,,5,,,,,,,,,,,,,,,,,,,,,,,,,,,,,,,,,2,5.0,4.0,5.0,4.0,4.0,5.0,4.0,5.0,5.0,4.0,4.0,5.0,4.0,5.0,5.0,4.0,5.0,5.0,5.0,4.0,5.0,4.0,4.0,5.0,5.0,5.0,5.0,5.0,5.0,5.0,5.0,5.0,8,,,,,,,,,,,,,,,,,,,,,,,,,,,,,,,,,3,,,,,,,,,,,,,,,,,,,,,,,,,,,,,,,,,10,,,,,,,,,,,,,,,,,,,,,,,,,,,,,,,,,First image is not good for people with OCD.,369.92,33.95,,,,9.32,,17.42,,114.67,,,101.84,,,,,,,,,,,,,,,,,,,,,,,,,,,,,,76.48,,,,,,,,,,,,16.24,,APPROVED,Female,32.0,FALSE
644,2022-03-22 01:21:11,19,en,1236123586,2022-03-22 01:15:23,2022-03-22 01:21:11,Y,Y,-oth-,Some College No degree,,5,,,,,,,,,,,,,,,,,,,,,,,,,,,,,,,,,4,,,,,,,,,,,,,,,,,,,,,,,,,,,,,,,,,13,,,,,,,,,,,,,,,,,,,,,,,,,,,,,,,,,7,,,,,,,,,,,,,,,,,,,,,,,,,,,,,,,,,0,3.0,3.0,1.0,2.0,2.0,1.0,3.0,2.0,4.0,1.0,2.0,1.0,1.0,3.0,3.0,1.0,3.0,2.0,3.0,1.0,2.0,2.0,2.0,2.0,1.0,1.0,5.0,2.0,1.0,2.0,1.0,5.0,10,,,,,,,,,,,,,,,,,,,,,,,,,,,,,,,,,9,,,,,,,,,,,,,,,,,,,,,,,,,,,,,,,,,3,,,,,,,,,,,,,,,,,,,,,,,,,,,,,,,,,8,,,,,,,,,,,,,,,,,,,,,,,,,,,,,,,,,6,,,,,,,,,,,,,,,,,,,,,,,,,,,,,,,,,11,,,,,,,,,,,,,,,,,,,,,,,,,,,,,,,,,1,6.0,6.0,4.0,6.0,6.0,5.0,4.0,6.0,6.0,6.0,4.0,6.0,5.0,6.0,5.0,4.0,5.0,6.0,6.0,7.0,7.0,5.0,6.0,7.0,5.0,6.0,4.0,7.0,5.0,5.0,6.0,5.0,2,3.0,1.0,2.0,3.0,2.0,3.0,4.0,2.0,2.0,2.0,3.0,1.0,2.0,4.0,2.0,2.0,1.0,3.0,3.0,2.0,2.0,1.0,1.0,2.0,2.0,1.0,5.0,2.0,2.0,3.0,1.0,6.0,14,,,,,,,,,,,,,,,,,,,,,,,,,,,,,,,,,12,,,,,,,,,,,,,,,,,,,,,,,,,,,,,,,,,,350.72,15.1,,,,16.47,,60.49,,,,,,,,,,,,,,80.18,,,,,,,,,,,,,,,,,,,,,102.37,,,70.44,,,,,,,,,5.67,,APPROVED,Female,25.0,FALSE
645,2022-03-22 01:24:47,19,en,685421604,2022-03-22 01:15:23,2022-03-22 01:24:47,Y,Y,A1,,,11,,,,,,,,,,,,,,,,,,,,,,,,,,,,,,,,,14,,,,,,,,,,,,,,,,,,,,,,,,,,,,,,,,,0,6.0,6.0,3.0,2.0,5.0,3.0,3.0,7.0,5.0,3.0,4.0,2.0,3.0,3.0,3.0,6.0,3.0,3.0,3.0,5.0,2.0,5.0,5.0,3.0,3.0,4.0,2.0,3.0,3.0,3.0,3.0,3.0,9,,,,,,,,,,,,,,,,,,,,,,,,,,,,,,,,,10,,,,,,,,,,,,,,,,,,,,,,,,,,,,,,,,,8,,,,,,,,,,,,,,,,,,,,,,,,,,,,,,,,,7,,,,,,,,,,,,,,,,,,,,,,,,,,,,,,,,,4,,,,,,,,,,,,,,,,,,,,,,,,,,,,,,,,,3,,,,,,,,,,,,,,,,,,,,,,,,,,,,,,,,,2,6.0,7.0,5.0,6.0,5.0,2.0,6.0,7.0,7.0,5.0,3.0,6.0,5.0,5.0,5.0,7.0,6.0,6.0,5.0,5.0,3.0,5.0,5.0,5.0,3.0,5.0,6.0,6.0,5.0,3.0,5.0,3.0,6,,,,,,,,,,,,,,,,,,,,,,,,,,,,,,,,,1,2.0,5.0,3.0,2.0,2.0,3.0,2.0,2.0,2.0,3.0,3.0,2.0,2.0,2.0,5.0,3.0,3.0,3.0,2.0,3.0,2.0,3.0,3.0,2.0,2.0,2.0,2.0,3.0,3.0,3.0,2.0,5.0,13,,,,,,,,,,,,,,,,,,,,,,,,,,,,,,,,,5,,,,,,,,,,,,,,,,,,,,,,,,,,,,,,,,,12,,,,,,,,,,,,,,,,,,,,,,,,,,,,,,,,,,567.63,37.57,,,,14.26,,154.36,,,,,,,,108.85,,,,,,,,,,,,,,,,,,,,,148.06,,,,,,100.94,,,,,,,,,,,,3.59,,APPROVED,Female,25.0,FALSE
646,2022-03-22 01:20:03,19,en,1216414414,2022-03-22 01:15:24,2022-03-22 01:20:03,Y,Y,A1,,,8,,,,,,,,,,,,,,,,,,,,,,,,,,,,,,,,,5,,,,,,,,,,,,,,,,,,,,,,,,,,,,,,,,,12,,,,,,,,,,,,,,,,,,,,,,,,,,,,,,,,,7,,,,,,,,,,,,,,,,,,,,,,,,,,,,,,,,,3,,,,,,,,,,,,,,,,,,,,,,,,,,,,,,,,,2,4.0,4.0,3.0,3.0,4.0,4.0,4.0,4.0,4.0,4.0,3.0,5.0,5.0,5.0,4.0,3.0,4.0,3.0,5.0,3.0,3.0,3.0,2.0,4.0,3.0,4.0,4.0,3.0,2.0,2.0,4.0,6.0,1,3.0,3.0,4.0,3.0,3.0,3.0,4.0,3.0,4.0,4.0,3.0,2.0,3.0,3.0,3.0,3.0,4.0,3.0,3.0,4.0,3.0,2.0,3.0,3.0,3.0,3.0,4.0,3.0,4.0,4.0,4.0,7.0,0,3.0,2.0,2.0,2.0,3.0,2.0,3.0,2.0,3.0,3.0,2.0,2.0,4.0,4.0,5.0,3.0,3.0,3.0,5.0,3.0,2.0,3.0,2.0,2.0,4.0,2.0,2.0,3.0,2.0,3.0,2.0,1.0,9,,,,,,,,,,,,,,,,,,,,,,,,,,,,,,,,,10,,,,,,,,,,,,,,,,,,,,,,,,,,,,,,,,,6,,,,,,,,,,,,,,,,,,,,,,,,,,,,,,,,,14,,,,,,,,,,,,,,,,,,,,,,,,,,,,,,,,,13,,,,,,,,,,,,,,,,,,,,,,,,,,,,,,,,,11,,,,,,,,,,,,,,,,,,,,,,,,,,,,,,,,,4,,,,,,,,,,,,,,,,,,,,,,,,,,,,,,,,,,284.09,22.66,,,,8.68,,41.9,,,,,,,,,,,,,,,,,45.71,,,87.8,,,72.7,,,,,,,,,,,,,,,,,,,,,,,,4.64,,APPROVED,Male,22.0,FALSE
647,2022-03-22 01:22:33,19,en,1302630025,2022-03-22 01:15:25,2022-03-22 01:22:33,Y,Y,A1,,,6,,,,,,,,,,,,,,,,,,,,,,,,,,,,,,,,,2,5.0,3.0,5.0,7.0,4.0,6.0,3.0,7.0,2.0,4.0,5.0,5.0,4.0,3.0,4.0,5.0,5.0,4.0,5.0,3.0,3.0,6.0,6.0,5.0,4.0,7.0,3.0,6.0,5.0,4.0,5.0,2.0,0,6.0,6.0,7.0,4.0,5.0,5.0,4.0,5.0,7.0,6.0,5.0,5.0,6.0,5.0,6.0,6.0,6.0,5.0,6.0,6.0,5.0,6.0,4.0,6.0,6.0,3.0,5.0,4.0,5.0,6.0,6.0,3.0,5,,,,,,,,,,,,,,,,,,,,,,,,,,,,,,,,,12,,,,,,,,,,,,,,,,,,,,,,,,,,,,,,,,,11,,,,,,,,,,,,,,,,,,,,,,,,,,,,,,,,,1,3.0,4.0,2.0,4.0,1.0,3.0,4.0,6.0,6.0,1.0,2.0,3.0,1.0,1.0,4.0,4.0,5.0,1.0,2.0,2.0,2.0,3.0,3.0,2.0,2.0,3.0,1.0,2.0,2.0,2.0,5.0,5.0,3,,,,,,,,,,,,,,,,,,,,,,,,,,,,,,,,,13,,,,,,,,,,,,,,,,,,,,,,,,,,,,,,,,,4,,,,,,,,,,,,,,,,,,,,,,,,,,,,,,,,,10,,,,,,,,,,,,,,,,,,,,,,,,,,,,,,,,,7,,,,,,,,,,,,,,,,,,,,,,,,,,,,,,,,,14,,,,,,,,,,,,,,,,,,,,,,,,,,,,,,,,,8,,,,,,,,,,,,,,,,,,,,,,,,,,,,,,,,,9,,,,,,,,,,,,,,,,,,,,,,,,,,,,,,,,,no comment,430.58,38.27,,,,6.74,,20.63,,,,,115.35,,,90.28,,,,,,,,,,,,135.05,,,,,,,,,,,,,,,,,,,,,,,,,,,24.26,,APPROVED,Male,26.0,FALSE
648,2022-03-22 01:20:37,19,en,1416072690,2022-03-22 01:15:26,2022-03-22 01:20:37,Y,Y,-oth-,high school,,14,,,,,,,,,,,,,,,,,,,,,,,,,,,,,,,,,7,,,,,,,,,,,,,,,,,,,,,,,,,,,,,,,,,10,,,,,,,,,,,,,,,,,,,,,,,,,,,,,,,,,8,,,,,,,,,,,,,,,,,,,,,,,,,,,,,,,,,5,,,,,,,,,,,,,,,,,,,,,,,,,,,,,,,,,1,4.0,6.0,4.0,3.0,3.0,2.0,7.0,2.0,5.0,4.0,3.0,2.0,5.0,3.0,5.0,3.0,5.0,4.0,4.0,4.0,4.0,4.0,2.0,4.0,4.0,3.0,5.0,4.0,5.0,4.0,4.0,6.0,4,,,,,,,,,,,,,,,,,,,,,,,,,,,,,,,,,12,,,,,,,,,,,,,,,,,,,,,,,,,,,,,,,,,11,,,,,,,,,,,,,,,,,,,,,,,,,,,,,,,,,9,,,,,,,,,,,,,,,,,,,,,,,,,,,,,,,,,2,3.0,5.0,3.0,2.0,3.0,2.0,6.0,1.0,5.0,3.0,3.0,3.0,3.0,3.0,3.0,2.0,2.0,2.0,3.0,3.0,3.0,4.0,2.0,3.0,2.0,3.0,3.0,3.0,5.0,3.0,2.0,4.0,13,,,,,,,,,,,,,,,,,,,,,,,,,,,,,,,,,3,,,,,,,,,,,,,,,,,,,,,,,,,,,,,,,,,0,6.0,4.0,6.0,7.0,6.0,7.0,2.0,7.0,4.0,5.0,7.0,6.0,6.0,5.0,6.0,6.0,6.0,6.0,6.0,5.0,6.0,6.0,7.0,6.0,6.0,7.0,1.0,6.0,6.0,6.0,7.0,7.0,6,,,,,,,,,,,,,,,,,,,,,,,,,,,,,,,,,,315.06,30.68,,,,17.23,,40.71,,,,,,,,,,,,,,,,,71.76,,,,,,,,,,,,,,,71.61,,,,,,,,,80.33,,,,,,2.74,,APPROVED,Male,31.0,FALSE
649,2022-03-22 01:26:35,19,en,461381372,2022-03-22 01:15:26,2022-03-22 01:26:35,Y,Y,A1,,,7,,,,,,,,,,,,,,,,,,,,,,,,,,,,,,,,,4,,,,,,,,,,,,,,,,,,,,,,,,,,,,,,,,,14,,,,,,,,,,,,,,,,,,,,,,,,,,,,,,,,,10,,,,,,,,,,,,,,,,,,,,,,,,,,,,,,,,,11,,,,,,,,,,,,,,,,,,,,,,,,,,,,,,,,,13,,,,,,,,,,,,,,,,,,,,,,,,,,,,,,,,,6,,,,,,,,,,,,,,,,,,,,,,,,,,,,,,,,,8,,,,,,,,,,,,,,,,,,,,,,,,,,,,,,,,,2,5.0,1.0,4.0,4.0,5.0,1.0,4.0,1.0,1.0,1.0,4.0,5.0,4.0,4.0,5.0,1.0,5.0,4.0,1.0,1.0,1.0,1.0,5.0,1.0,5.0,5.0,1.0,5.0,1.0,4.0,1.0,2.0,0,4.0,1.0,1.0,1.0,1.0,1.0,2.0,4.0,5.0,4.0,1.0,4.0,1.0,1.0,5.0,4.0,5.0,5.0,1.0,4.0,1.0,1.0,5.0,3.0,1.0,4.0,2.0,1.0,1.0,1.0,5.0,3.0,9,,,,,,,,,,,,,,,,,,,,,,,,,,,,,,,,,5,,,,,,,,,,,,,,,,,,,,,,,,,,,,,,,,,1,1.0,1.0,1.0,1.0,1.0,1.0,1.0,4.0,5.0,1.0,1.0,6.0,1.0,1.0,5.0,1.0,5.0,1.0,1.0,1.0,1.0,1.0,5.0,1.0,1.0,5.0,1.0,1.0,1.0,1.0,1.0,6.0,3,,,,,,,,,,,,,,,,,,,,,,,,,,,,,,,,,12,,,,,,,,,,,,,,,,,,,,,,,,,,,,,,,,,,674.85,54.85,,,,7.3,,269.49,,,,,,,,,,,,,,,,,,,,,,,,,,124.86,,,108.88,,,,,,,,,103.55,,,,,,,,,5.92,,APPROVED,Female,27.0,FALSE
650,2022-03-22 01:25:58,19,en,1635727626,2022-03-22 01:15:27,2022-03-22 01:25:58,Y,Y,A1,,,10,,,,,,,,,,,,,,,,,,,,,,,,,,,,,,,,,6,,,,,,,,,,,,,,,,,,,,,,,,,,,,,,,,,9,,,,,,,,,,,,,,,,,,,,,,,,,,,,,,,,,2,6.0,7.0,5.0,4.0,6.0,4.0,6.0,7.0,6.0,5.0,5.0,5.0,5.0,6.0,6.0,4.0,6.0,4.0,5.0,5.0,5.0,5.0,5.0,5.0,4.0,5.0,5.0,5.0,6.0,4.0,6.0,4.0,3,,,,,,,,,,,,,,,,,,,,,,,,,,,,,,,,,4,,,,,,,,,,,,,,,,,,,,,,,,,,,,,,,,,14,,,,,,,,,,,,,,,,,,,,,,,,,,,,,,,,,1,3.0,4.0,4.0,5.0,3.0,3.0,6.0,4.0,3.0,5.0,4.0,5.0,4.0,4.0,4.0,5.0,4.0,4.0,4.0,4.0,3.0,4.0,4.0,4.0,4.0,4.0,4.0,4.0,4.0,4.0,5.0,1.0,13,,,,,,,,,,,,,,,,,,,,,,,,,,,,,,,,,11,,,,,,,,,,,,,,,,,,,,,,,,,,,,,,,,,5,,,,,,,,,,,,,,,,,,,,,,,,,,,,,,,,,7,,,,,,,,,,,,,,,,,,,,,,,,,,,,,,,,,0,6.0,7.0,7.0,5.0,6.0,5.0,6.0,5.0,7.0,6.0,5.0,5.0,6.0,7.0,6.0,5.0,6.0,5.0,6.0,6.0,5.0,7.0,6.0,5.0,5.0,7.0,5.0,6.0,7.0,6.0,7.0,6.0,8,,,,,,,,,,,,,,,,,,,,,,,,,,,,,,,,,12,,,,,,,,,,,,,,,,,,,,,,,,,,,,,,,,,,633.34,10.53,,,,13.12,,11.2,,,,,,,,,,,40.5,,,,,,,,,,,,68.31,,,,,,,,,,,,,,,43.41,,,,,,,,,446.27,,APPROVED,Male,32.0,FALSE
651,2022-03-22 01:20:17,19,en,383838230,2022-03-22 01:15:28,2022-03-22 01:20:17,Y,Y,A2,,,2,2.0,3.0,3.0,5.0,3.0,6.0,5.0,4.0,3.0,2.0,3.0,3.0,3.0,3.0,3.0,3.0,4.0,3.0,3.0,4.0,4.0,2.0,4.0,2.0,3.0,6.0,5.0,3.0,6.0,4.0,3.0,1.0,10,,,,,,,,,,,,,,,,,,,,,,,,,,,,,,,,,0,6.0,6.0,6.0,5.0,7.0,6.0,2.0,7.0,5.0,4.0,6.0,6.0,6.0,6.0,4.0,6.0,6.0,6.0,5.0,7.0,7.0,5.0,6.0,6.0,6.0,5.0,4.0,6.0,5.0,4.0,4.0,1.0,7,,,,,,,,,,,,,,,,,,,,,,,,,,,,,,,,,13,,,,,,,,,,,,,,,,,,,,,,,,,,,,,,,,,6,,,,,,,,,,,,,,,,,,,,,,,,,,,,,,,,,4,,,,,,,,,,,,,,,,,,,,,,,,,,,,,,,,,14,,,,,,,,,,,,,,,,,,,,,,,,,,,,,,,,,1,3.0,5.0,5.0,3.0,3.0,3.0,6.0,4.0,4.0,3.0,3.0,3.0,3.0,4.0,4.0,3.0,4.0,4.0,4.0,4.0,4.0,4.0,3.0,3.0,5.0,4.0,3.0,3.0,4.0,3.0,3.0,2.0,8,,,,,,,,,,,,,,,,,,,,,,,,,,,,,,,,,5,,,,,,,,,,,,,,,,,,,,,,,,,,,,,,,,,12,,,,,,,,,,,,,,,,,,,,,,,,,,,,,,,,,3,,,,,,,,,,,,,,,,,,,,,,,,,,,,,,,,,11,,,,,,,,,,,,,,,,,,,,,,,,,,,,,,,,,9,,,,,,,,,,,,,,,,,,,,,,,,,,,,,,,,,,292.54,30.43,,,,4.71,,47.15,,69.93,,,,,,59.42,,,,,,,,,,,,,,,,,,77.33,,,,,,,,,,,,,,,,,,,,,3.57,,APPROVED,Male,25.0,FALSE
652,2022-03-22 01:24:44,19,en,1709916967,2022-03-22 01:15:28,2022-03-22 01:24:44,Y,Y,A1,,,11,,,,,,,,,,,,,,,,,,,,,,,,,,,,,,,,,2,7.0,4.0,7.0,7.0,6.0,7.0,1.0,6.0,2.0,6.0,7.0,7.0,7.0,4.0,2.0,7.0,5.0,7.0,7.0,6.0,4.0,7.0,7.0,7.0,5.0,7.0,1.0,4.0,4.0,7.0,7.0,2.0,6,,,,,,,,,,,,,,,,,,,,,,,,,,,,,,,,,10,,,,,,,,,,,,,,,,,,,,,,,,,,,,,,,,,4,,,,,,,,,,,,,,,,,,,,,,,,,,,,,,,,,0,3.0,7.0,2.0,2.0,2.0,2.0,7.0,3.0,5.0,3.0,2.0,5.0,3.0,3.0,5.0,1.0,6.0,2.0,4.0,3.0,2.0,2.0,2.0,3.0,2.0,2.0,5.0,2.0,2.0,2.0,2.0,6.0,13,,,,,,,,,,,,,,,,,,,,,,,,,,,,,,,,,14,,,,,,,,,,,,,,,,,,,,,,,,,,,,,,,,,7,,,,,,,,,,,,,,,,,,,,,,,,,,,,,,,,,12,,,,,,,,,,,,,,,,,,,,,,,,,,,,,,,,,5,,,,,,,,,,,,,,,,,,,,,,,,,,,,,,,,,9,,,,,,,,,,,,,,,,,,,,,,,,,,,,,,,,,1,2.0,2.0,2.0,2.0,1.0,3.0,3.0,6.0,5.0,2.0,3.0,4.0,2.0,2.0,5.0,2.0,5.0,2.0,2.0,1.0,3.0,2.0,5.0,2.0,2.0,3.0,5.0,1.0,3.0,3.0,2.0,6.0,8,,,,,,,,,,,,,,,,,,,,,,,,,,,,,,,,,3,,,,,,,,,,,,,,,,,,,,,,,,,,,,,,,,,,561.98,26.77,,,,5.72,,40.75,,,,,83.72,,,,,,,,,,,,203.91,,,,,,,,,,,,,,,,,,,,,197.53,,,,,,,,,3.58,,APPROVED,Male,22.0,FALSE
653,2022-03-22 01:22:19,19,en,2044566674,2022-03-22 01:15:28,2022-03-22 01:22:19,Y,Y,A1,,,6,,,,,,,,,,,,,,,,,,,,,,,,,,,,,,,,,2,7.0,7.0,7.0,7.0,7.0,7.0,4.0,7.0,6.0,7.0,7.0,7.0,7.0,7.0,7.0,7.0,7.0,7.0,6.0,7.0,7.0,7.0,7.0,7.0,6.0,7.0,7.0,7.0,6.0,7.0,7.0,2.0,7,,,,,,,,,,,,,,,,,,,,,,,,,,,,,,,,,4,,,,,,,,,,,,,,,,,,,,,,,,,,,,,,,,,9,,,,,,,,,,,,,,,,,,,,,,,,,,,,,,,,,14,,,,,,,,,,,,,,,,,,,,,,,,,,,,,,,,,10,,,,,,,,,,,,,,,,,,,,,,,,,,,,,,,,,11,,,,,,,,,,,,,,,,,,,,,,,,,,,,,,,,,8,,,,,,,,,,,,,,,,,,,,,,,,,,,,,,,,,0,3.0,1.0,2.0,1.0,1.0,2.0,5.0,3.0,3.0,2.0,2.0,5.0,2.0,1.0,1.0,2.0,2.0,2.0,1.0,2.0,1.0,1.0,1.0,2.0,2.0,1.0,2.0,1.0,1.0,2.0,1.0,3.0,3,,,,,,,,,,,,,,,,,,,,,,,,,,,,,,,,,13,,,,,,,,,,,,,,,,,,,,,,,,,,,,,,,,,1,4.0,5.0,5.0,3.0,4.0,5.0,3.0,6.0,4.0,4.0,2.0,5.0,3.0,4.0,4.0,5.0,5.0,5.0,4.0,2.0,3.0,5.0,5.0,3.0,4.0,4.0,6.0,4.0,3.0,3.0,5.0,6.0,5,,,,,,,,,,,,,,,,,,,,,,,,,,,,,,,,,12,,,,,,,,,,,,,,,,,,,,,,,,,,,,,,,,,,415.64,39.31,,,,8.67,,41.84,,,,,73.85,,,,,,,,,,,,,,,,,,,,,,,,136.95,,,,,,,,,104.81,,,,,,,,,10.21,,APPROVED,Male,27.0,FALSE
654,2022-03-22 01:31:08,19,en,899893410,2022-03-22 01:15:29,2022-03-22 01:31:08,Y,Y,A1,,,13,,,,,,,,,,,,,,,,,,,,,,,,,,,,,,,,,5,,,,,,,,,,,,,,,,,,,,,,,,,,,,,,,,,14,,,,,,,,,,,,,,,,,,,,,,,,,,,,,,,,,3,,,,,,,,,,,,,,,,,,,,,,,,,,,,,,,,,12,,,,,,,,,,,,,,,,,,,,,,,,,,,,,,,,,2,5.0,7.0,7.0,5.0,5.0,6.0,4.0,6.0,7.0,5.0,5.0,5.0,5.0,4.0,7.0,4.0,7.0,6.0,5.0,5.0,5.0,5.0,4.0,5.0,6.0,7.0,4.0,4.0,6.0,4.0,6.0,6.0,9,,,,,,,,,,,,,,,,,,,,,,,,,,,,,,,,,6,,,,,,,,,,,,,,,,,,,,,,,,,,,,,,,,,7,,,,,,,,,,,,,,,,,,,,,,,,,,,,,,,,,4,,,,,,,,,,,,,,,,,,,,,,,,,,,,,,,,,11,,,,,,,,,,,,,,,,,,,,,,,,,,,,,,,,,0,4.0,6.0,4.0,4.0,4.0,4.0,4.0,4.0,4.0,4.0,4.0,4.0,4.0,4.0,4.0,4.0,4.0,4.0,4.0,4.0,4.0,4.0,4.0,4.0,4.0,4.0,4.0,4.0,4.0,4.0,4.0,5.0,10,,,,,,,,,,,,,,,,,,,,,,,,,,,,,,,,,8,,,,,,,,,,,,,,,,,,,,,,,,,,,,,,,,,1,1.0,6.0,1.0,4.0,1.0,4.0,4.0,1.0,6.0,1.0,4.0,4.0,1.0,4.0,5.0,1.0,5.0,1.0,1.0,1.0,4.0,1.0,4.0,1.0,1.0,7.0,4.0,1.0,7.0,1.0,4.0,4.0,I found your survey very interesting! Thank you :),943.53,108.55,,,,5.83,,88.14,,,,,,,,,,,,,,,,,183.43,,,,,,,,,,,,,,,,,,175.08,,,,,,,,,295.74,,,86.76,,APPROVED,Female,40.0,FALSE
655,2022-03-22 01:24:30,19,en,1337204521,2022-03-22 01:15:29,2022-03-22 01:24:30,Y,Y,A1,,,5,,,,,,,,,,,,,,,,,,,,,,,,,,,,,,,,,11,,,,,,,,,,,,,,,,,,,,,,,,,,,,,,,,,3,,,,,,,,,,,,,,,,,,,,,,,,,,,,,,,,,6,,,,,,,,,,,,,,,,,,,,,,,,,,,,,,,,,8,,,,,,,,,,,,,,,,,,,,,,,,,,,,,,,,,1,6.0,4.0,5.0,4.0,6.0,3.0,4.0,7.0,5.0,6.0,3.0,6.0,6.0,4.0,6.0,5.0,6.0,4.0,6.0,7.0,6.0,6.0,3.0,6.0,5.0,7.0,6.0,6.0,6.0,6.0,5.0,6.0,13,,,,,,,,,,,,,,,,,,,,,,,,,,,,,,,,,2,2.0,4.0,4.0,6.0,2.0,6.0,7.0,1.0,4.0,2.0,3.0,4.0,2.0,4.0,5.0,2.0,4.0,2.0,4.0,2.0,2.0,4.0,7.0,3.0,3.0,6.0,2.0,4.0,2.0,4.0,5.0,1.0,7,,,,,,,,,,,,,,,,,,,,,,,,,,,,,,,,,4,,,,,,,,,,,,,,,,,,,,,,,,,,,,,,,,,14,,,,,,,,,,,,,,,,,,,,,,,,,,,,,,,,,12,,,,,,,,,,,,,,,,,,,,,,,,,,,,,,,,,9,,,,,,,,,,,,,,,,,,,,,,,,,,,,,,,,,10,,,,,,,,,,,,,,,,,,,,,,,,,,,,,,,,,0,6.0,5.0,6.0,3.0,4.0,5.0,5.0,2.0,5.0,5.0,4.0,6.0,6.0,6.0,6.0,4.0,5.0,4.0,6.0,6.0,4.0,6.0,3.0,6.0,6.0,4.0,6.0,6.0,3.0,6.0,4.0,1.0,,543.89,95.73,,,,6.19,,143.39,,,,,,,,,,,,,,,,,72.1,,,,,,120.81,,,,,,,,,,,,,,,,,,,,,101.64,,,4.03,,APPROVED,Female,25.0,FALSE
656,2022-03-22 01:27:19,19,en,1737149040,2022-03-22 01:15:32,2022-03-22 01:27:19,Y,Y,A1,,,11,,,,,,,,,,,,,,,,,,,,,,,,,,,,,,,,,5,,,,,,,,,,,,,,,,,,,,,,,,,,,,,,,,,4,,,,,,,,,,,,,,,,,,,,,,,,,,,,,,,,,0,6.0,6.0,6.0,3.0,6.0,2.0,6.0,5.0,6.0,4.0,4.0,3.0,4.0,4.0,6.0,4.0,7.0,2.0,5.0,4.0,2.0,6.0,1.0,4.0,6.0,1.0,2.0,2.0,4.0,6.0,6.0,4.0,1,4.0,1.0,2.0,5.0,1.0,1.0,4.0,4.0,3.0,4.0,1.0,5.0,2.0,2.0,1.0,5.0,4.0,2.0,5.0,3.0,4.0,4.0,6.0,4.0,3.0,5.0,3.0,5.0,2.0,4.0,4.0,5.0,8,,,,,,,,,,,,,,,,,,,,,,,,,,,,,,,,,12,,,,,,,,,,,,,,,,,,,,,,,,,,,,,,,,,13,,,,,,,,,,,,,,,,,,,,,,,,,,,,,,,,,3,,,,,,,,,,,,,,,,,,,,,,,,,,,,,,,,,10,,,,,,,,,,,,,,,,,,,,,,,,,,,,,,,,,7,,,,,,,,,,,,,,,,,,,,,,,,,,,,,,,,,9,,,,,,,,,,,,,,,,,,,,,,,,,,,,,,,,,6,,,,,,,,,,,,,,,,,,,,,,,,,,,,,,,,,14,,,,,,,,,,,,,,,,,,,,,,,,,,,,,,,,,2,1.0,1.0,1.0,1.0,1.0,1.0,1.0,1.0,1.0,1.0,1.0,1.0,1.0,1.0,1.0,1.0,1.0,1.0,1.0,1.0,1.0,1.0,1.0,1.0,1.0,1.0,1.0,1.0,1.0,1.0,1.0,1.0,,711.63,413.56,,,,10.94,,53.86,,,,,,,,,,,92.41,,,95.51,,,,,,,,,,,,,,,,,,,,,,,,,,,,,,40.52,,,4.83,,APPROVED,Female,21.0,FALSE
657,2022-03-22 01:34:26,19,en,1768205505,2022-03-22 01:15:32,2022-03-22 01:34:26,Y,Y,-oth-,some college but no degree,,3,,,,,,,,,,,,,,,,,,,,,,,,,,,,,,,,,8,,,,,,,,,,,,,,,,,,,,,,,,,,,,,,,,,14,,,,,,,,,,,,,,,,,,,,,,,,,,,,,,,,,11,,,,,,,,,,,,,,,,,,,,,,,,,,,,,,,,,1,1.0,1.0,2.0,1.0,1.0,1.0,7.0,1.0,2.0,2.0,2.0,1.0,1.0,1.0,1.0,1.0,2.0,2.0,1.0,1.0,1.0,1.0,1.0,1.0,1.0,1.0,7.0,1.0,2.0,1.0,2.0,5.0,9,,,,,,,,,,,,,,,,,,,,,,,,,,,,,,,,,13,,,,,,,,,,,,,,,,,,,,,,,,,,,,,,,,,2,2.0,4.0,2.0,3.0,2.0,2.0,5.0,2.0,5.0,2.0,2.0,1.0,2.0,2.0,2.0,2.0,2.0,1.0,3.0,2.0,2.0,2.0,2.0,1.0,1.0,2.0,3.0,1.0,3.0,2.0,2.0,1.0,6,,,,,,,,,,,,,,,,,,,,,,,,,,,,,,,,,4,,,,,,,,,,,,,,,,,,,,,,,,,,,,,,,,,5,,,,,,,,,,,,,,,,,,,,,,,,,,,,,,,,,7,,,,,,,,,,,,,,,,,,,,,,,,,,,,,,,,,0,6.0,5.0,5.0,3.0,5.0,3.0,5.0,5.0,6.0,5.0,5.0,6.0,6.0,4.0,6.0,6.0,7.0,6.0,6.0,4.0,6.0,5.0,2.0,7.0,5.0,6.0,6.0,6.0,6.0,6.0,5.0,6.0,12,,,,,,,,,,,,,,,,,,,,,,,,,,,,,,,,,10,,,,,,,,,,,,,,,,,,,,,,,,,,,,,,,,,,1137.26,807.12,,,,23.3,,22.3,,,,,,,,,,,,,,97.74,,,,,,,,,84.85,,,,,,,,,,,,,,,97.49,,,,,,,,,4.46,,APPROVED,Female,27.0,FALSE
658,2022-03-22 01:19:39,19,en,1312913317,2022-03-22 01:15:33,2022-03-22 01:19:39,Y,Y,A1,,,3,,,,,,,,,,,,,,,,,,,,,,,,,,,,,,,,,11,,,,,,,,,,,,,,,,,,,,,,,,,,,,,,,,,5,,,,,,,,,,,,,,,,,,,,,,,,,,,,,,,,,10,,,,,,,,,,,,,,,,,,,,,,,,,,,,,,,,,9,,,,,,,,,,,,,,,,,,,,,,,,,,,,,,,,,4,,,,,,,,,,,,,,,,,,,,,,,,,,,,,,,,,13,,,,,,,,,,,,,,,,,,,,,,,,,,,,,,,,,7,,,,,,,,,,,,,,,,,,,,,,,,,,,,,,,,,0,3.0,2.0,4.0,2.0,2.0,2.0,5.0,1.0,3.0,3.0,5.0,5.0,1.0,6.0,4.0,2.0,6.0,3.0,2.0,2.0,2.0,4.0,4.0,1.0,2.0,5.0,6.0,1.0,5.0,2.0,5.0,2.0,14,,,,,,,,,,,,,,,,,,,,,,,,,,,,,,,,,1,6.0,6.0,5.0,6.0,5.0,4.0,5.0,6.0,6.0,4.0,2.0,3.0,5.0,4.0,4.0,6.0,5.0,5.0,6.0,3.0,3.0,6.0,3.0,5.0,4.0,2.0,4.0,4.0,3.0,5.0,5.0,4.0,2,6.0,6.0,6.0,2.0,4.0,3.0,6.0,5.0,5.0,4.0,5.0,5.0,3.0,3.0,6.0,3.0,6.0,6.0,5.0,4.0,4.0,5.0,2.0,4.0,4.0,3.0,6.0,3.0,3.0,5.0,4.0,5.0,8,,,,,,,,,,,,,,,,,,,,,,,,,,,,,,,,,12,,,,,,,,,,,,,,,,,,,,,,,,,,,,,,,,,6,,,,,,,,,,,,,,,,,,,,,,,,,,,,,,,,,,249.5,15.71,,,,6.27,,18.74,,,,,,,,,,,,,,,,,,,,,,,,,,66.05,,,,,,64.16,,,74.96,,,,,,,,,,,,3.61,,APPROVED,Female,22.0,FALSE
659,2022-03-22 01:22:34,19,en,2108691376,2022-03-22 01:15:37,2022-03-22 01:22:34,Y,Y,-oth-,Highschool / Some college (no degree),,13,,,,,,,,,,,,,,,,,,,,,,,,,,,,,,,,,10,,,,,,,,,,,,,,,,,,,,,,,,,,,,,,,,,2,7.0,6.0,7.0,6.0,7.0,6.0,1.0,7.0,7.0,7.0,5.0,6.0,7.0,6.0,7.0,4.0,7.0,6.0,7.0,5.0,6.0,6.0,6.0,7.0,7.0,7.0,5.0,7.0,4.0,4.0,6.0,3.0,6,,,,,,,,,,,,,,,,,,,,,,,,,,,,,,,,,5,,,,,,,,,,,,,,,,,,,,,,,,,,,,,,,,,9,,,,,,,,,,,,,,,,,,,,,,,,,,,,,,,,,14,,,,,,,,,,,,,,,,,,,,,,,,,,,,,,,,,1,3.0,2.0,2.0,3.0,5.0,2.0,7.0,4.0,5.0,4.0,2.0,3.0,5.0,3.0,5.0,4.0,5.0,4.0,4.0,1.0,4.0,4.0,3.0,5.0,3.0,6.0,4.0,5.0,4.0,4.0,5.0,1.0,12,,,,,,,,,,,,,,,,,,,,,,,,,,,,,,,,,3,,,,,,,,,,,,,,,,,,,,,,,,,,,,,,,,,4,,,,,,,,,,,,,,,,,,,,,,,,,,,,,,,,,8,,,,,,,,,,,,,,,,,,,,,,,,,,,,,,,,,11,,,,,,,,,,,,,,,,,,,,,,,,,,,,,,,,,0,3.0,3.0,5.0,3.0,1.0,5.0,5.0,4.0,6.0,3.0,1.0,5.0,5.0,5.0,7.0,3.0,7.0,4.0,5.0,2.0,4.0,4.0,6.0,4.0,2.0,7.0,4.0,5.0,4.0,4.0,6.0,7.0,7,,,,,,,,,,,,,,,,,,,,,,,,,,,,,,,,,,419.69,106.55,,,,24.38,,33.36,,,,,,,,94.47,,,,,,,,,,,,,,,90.0,,,,,,,,,,,,,,,,,,68.27,,,,,,2.66,,APPROVED,Male,27.0,FALSE
660,2022-03-22 01:21:47,19,en,725249924,2022-03-22 01:15:39,2022-03-22 01:21:47,Y,Y,A2,,,8,,,,,,,,,,,,,,,,,,,,,,,,,,,,,,,,,11,,,,,,,,,,,,,,,,,,,,,,,,,,,,,,,,,1,4.0,5.0,5.0,6.0,5.0,5.0,5.0,6.0,5.0,5.0,6.0,5.0,5.0,5.0,5.0,5.0,5.0,6.0,5.0,5.0,5.0,5.0,5.0,4.0,6.0,6.0,5.0,5.0,5.0,6.0,6.0,3.0,14,,,,,,,,,,,,,,,,,,,,,,,,,,,,,,,,,5,,,,,,,,,,,,,,,,,,,,,,,,,,,,,,,,,7,,,,,,,,,,,,,,,,,,,,,,,,,,,,,,,,,10,,,,,,,,,,,,,,,,,,,,,,,,,,,,,,,,,0,5.0,4.0,4.0,2.0,4.0,2.0,4.0,5.0,6.0,4.0,4.0,2.0,3.0,5.0,5.0,4.0,5.0,3.0,4.0,4.0,4.0,4.0,5.0,3.0,3.0,6.0,4.0,4.0,5.0,4.0,4.0,1.0,13,,,,,,,,,,,,,,,,,,,,,,,,,,,,,,,,,6,,,,,,,,,,,,,,,,,,,,,,,,,,,,,,,,,4,,,,,,,,,,,,,,,,,,,,,,,,,,,,,,,,,12,,,,,,,,,,,,,,,,,,,,,,,,,,,,,,,,,2,5.0,5.0,5.0,5.0,6.0,4.0,4.0,2.0,6.0,5.0,6.0,4.0,5.0,5.0,4.0,4.0,6.0,4.0,4.0,5.0,5.0,4.0,6.0,5.0,4.0,6.0,5.0,5.0,6.0,5.0,6.0,6.0,9,,,,,,,,,,,,,,,,,,,,,,,,,,,,,,,,,3,,,,,,,,,,,,,,,,,,,,,,,,,,,,,,,,,,371.67,26.74,,,,7.2,,53.3,,,,,,,,97.71,,,,,,,,,,,,,,,106.32,,,,,,,,,,,,,,,75.37,,,,,,,,,5.03,,APPROVED,Male,65.0,FALSE
661,2022-03-22 01:24:32,19,en,1510121107,2022-03-22 01:15:43,2022-03-22 01:24:32,Y,Y,-oth-,,,1,6.0,7.0,6.0,5.0,5.0,3.0,6.0,6.0,6.0,4.0,5.0,4.0,6.0,5.0,5.0,5.0,7.0,5.0,5.0,5.0,4.0,5.0,2.0,6.0,5.0,3.0,1.0,5.0,5.0,4.0,2.0,1.0,4,,,,,,,,,,,,,,,,,,,,,,,,,,,,,,,,,0,6.0,4.0,5.0,4.0,5.0,3.0,4.0,6.0,5.0,4.0,4.0,6.0,6.0,4.0,5.0,4.0,6.0,5.0,5.0,4.0,5.0,5.0,3.0,6.0,4.0,5.0,1.0,5.0,5.0,6.0,4.0,3.0,14,,,,,,,,,,,,,,,,,,,,,,,,,,,,,,,,,9,,,,,,,,,,,,,,,,,,,,,,,,,,,,,,,,,3,,,,,,,,,,,,,,,,,,,,,,,,,,,,,,,,,13,,,,,,,,,,,,,,,,,,,,,,,,,,,,,,,,,8,,,,,,,,,,,,,,,,,,,,,,,,,,,,,,,,,12,,,,,,,,,,,,,,,,,,,,,,,,,,,,,,,,,11,,,,,,,,,,,,,,,,,,,,,,,,,,,,,,,,,2,3.0,5.0,3.0,3.0,3.0,3.0,4.0,5.0,6.0,3.0,3.0,1.0,3.0,3.0,3.0,4.0,4.0,2.0,3.0,2.0,3.0,3.0,5.0,3.0,2.0,3.0,1.0,2.0,2.0,4.0,1.0,4.0,10,,,,,,,,,,,,,,,,,,,,,,,,,,,,,,,,,6,,,,,,,,,,,,,,,,,,,,,,,,,,,,,,,,,5,,,,,,,,,,,,,,,,,,,,,,,,,,,,,,,,,7,,,,,,,,,,,,,,,,,,,,,,,,,,,,,,,,,,532.48,107.9,,,,105.08,,36.04,,76.58,,,,,,115.24,,,,,,,,,,,,,,,,,,,,,,,,88.45,,,,,,,,,,,,,,,3.19,,APPROVED,Male,23.0,FALSE
662,2022-03-22 01:22:27,19,en,130380487,2022-03-22 01:15:44,2022-03-22 01:22:27,Y,Y,A1,,,5,,,,,,,,,,,,,,,,,,,,,,,,,,,,,,,,,7,,,,,,,,,,,,,,,,,,,,,,,,,,,,,,,,,9,,,,,,,,,,,,,,,,,,,,,,,,,,,,,,,,,13,,,,,,,,,,,,,,,,,,,,,,,,,,,,,,,,,2,2.0,3.0,1.0,2.0,1.0,2.0,7.0,2.0,1.0,1.0,1.0,2.0,2.0,1.0,2.0,3.0,2.0,1.0,3.0,1.0,1.0,2.0,4.0,2.0,2.0,2.0,5.0,2.0,2.0,2.0,1.0,5.0,6,,,,,,,,,,,,,,,,,,,,,,,,,,,,,,,,,14,,,,,,,,,,,,,,,,,,,,,,,,,,,,,,,,,8,,,,,,,,,,,,,,,,,,,,,,,,,,,,,,,,,10,,,,,,,,,,,,,,,,,,,,,,,,,,,,,,,,,1,6.0,7.0,6.0,3.0,7.0,1.0,6.0,6.0,6.0,5.0,6.0,3.0,5.0,6.0,6.0,6.0,6.0,3.0,5.0,4.0,5.0,5.0,2.0,6.0,7.0,6.0,2.0,6.0,7.0,6.0,3.0,3.0,11,,,,,,,,,,,,,,,,,,,,,,,,,,,,,,,,,4,,,,,,,,,,,,,,,,,,,,,,,,,,,,,,,,,3,,,,,,,,,,,,,,,,,,,,,,,,,,,,,,,,,12,,,,,,,,,,,,,,,,,,,,,,,,,,,,,,,,,0,4.0,6.0,5.0,3.0,5.0,3.0,5.0,6.0,4.0,5.0,5.0,2.0,5.0,2.0,2.0,4.0,5.0,5.0,4.0,4.0,2.0,5.0,3.0,5.0,5.0,5.0,1.0,5.0,4.0,5.0,4.0,1.0,,406.29,75.34,,,,9.39,,53.19,,,,,,,,,,,,,,72.73,,,,,,,,,,,,,,,91.98,,,,,,,,,,,,,,,100.06,,,3.6,,APPROVED,Female,21.0,FALSE
663,2022-03-22 01:22:24,19,en,1786033757,2022-03-22 01:16:09,2022-03-22 01:22:24,Y,Y,A1,,,7,,,,,,,,,,,,,,,,,,,,,,,,,,,,,,,,,4,,,,,,,,,,,,,,,,,,,,,,,,,,,,,,,,,1,1.0,2.0,2.0,4.0,5.0,1.0,6.0,5.0,2.0,1.0,7.0,1.0,1.0,1.0,6.0,2.0,4.0,1.0,1.0,2.0,1.0,2.0,1.0,1.0,3.0,1.0,1.0,3.0,1.0,2.0,2.0,3.0,3,,,,,,,,,,,,,,,,,,,,,,,,,,,,,,,,,2,1.0,5.0,2.0,3.0,5.0,3.0,5.0,7.0,7.0,5.0,2.0,4.0,3.0,6.0,2.0,5.0,7.0,4.0,5.0,1.0,2.0,5.0,4.0,5.0,7.0,7.0,1.0,2.0,7.0,1.0,6.0,5.0,14,,,,,,,,,,,,,,,,,,,,,,,,,,,,,,,,,11,,,,,,,,,,,,,,,,,,,,,,,,,,,,,,,,,9,,,,,,,,,,,,,,,,,,,,,,,,,,,,,,,,,10,,,,,,,,,,,,,,,,,,,,,,,,,,,,,,,,,6,,,,,,,,,,,,,,,,,,,,,,,,,,,,,,,,,13,,,,,,,,,,,,,,,,,,,,,,,,,,,,,,,,,5,,,,,,,,,,,,,,,,,,,,,,,,,,,,,,,,,12,,,,,,,,,,,,,,,,,,,,,,,,,,,,,,,,,0,1.0,7.0,1.0,4.0,2.0,1.0,4.0,4.0,5.0,1.0,2.0,2.0,3.0,2.0,2.0,1.0,7.0,1.0,2.0,1.0,2.0,1.0,4.0,2.0,1.0,6.0,1.0,2.0,2.0,1.0,7.0,7.0,8,,,,,,,,,,,,,,,,,,,,,,,,,,,,,,,,,,379.22,8.8,,,,6.03,,39.96,,,,,,,,136.69,,,,,,66.26,,,,,,,,,,,,,,,,,,,,,,,,,,,117.88,,,,,,3.6,,APPROVED,Female,20.0,FALSE
664,2022-03-22 01:32:15,19,en,775564421,2022-03-22 01:16:19,2022-03-22 01:32:15,Y,Y,A1,,,11,,,,,,,,,,,,,,,,,,,,,,,,,,,,,,,,,3,,,,,,,,,,,,,,,,,,,,,,,,,,,,,,,,,13,,,,,,,,,,,,,,,,,,,,,,,,,,,,,,,,,7,,,,,,,,,,,,,,,,,,,,,,,,,,,,,,,,,14,,,,,,,,,,,,,,,,,,,,,,,,,,,,,,,,,6,,,,,,,,,,,,,,,,,,,,,,,,,,,,,,,,,10,,,,,,,,,,,,,,,,,,,,,,,,,,,,,,,,,9,,,,,,,,,,,,,,,,,,,,,,,,,,,,,,,,,12,,,,,,,,,,,,,,,,,,,,,,,,,,,,,,,,,2,5.0,5.0,5.0,6.0,6.0,6.0,5.0,6.0,6.0,4.0,6.0,7.0,4.0,4.0,6.0,6.0,6.0,4.0,4.0,5.0,4.0,5.0,7.0,5.0,5.0,7.0,5.0,6.0,6.0,6.0,6.0,3.0,8,,,,,,,,,,,,,,,,,,,,,,,,,,,,,,,,,0,5.0,6.0,5.0,4.0,4.0,6.0,4.0,5.0,6.0,5.0,5.0,4.0,4.0,4.0,6.0,5.0,5.0,4.0,5.0,4.0,4.0,5.0,4.0,5.0,6.0,5.0,3.0,5.0,5.0,4.0,6.0,5.0,4,,,,,,,,,,,,,,,,,,,,,,,,,,,,,,,,,1,5.0,6.0,6.0,6.0,7.0,7.0,3.0,6.0,6.0,4.0,6.0,7.0,6.0,6.0,7.0,5.0,7.0,5.0,6.0,7.0,5.0,6.0,7.0,7.0,6.0,7.0,6.0,6.0,7.0,6.0,7.0,7.0,5,,,,,,,,,,,,,,,,,,,,,,,,,,,,,,,,,I'm interested in the images that were displayed and where my participation in rating them will help science,957.95,243.31,,,,15.18,,61.21,,,,,,,,,,,,,,,,,,,,,,,,,,,,,160.7,,,,,,225.18,,,,,,169.98,,,,,,82.39,,APPROVED,Male,29.0,FALSE
665,2022-03-22 01:24:55,19,en,1273352588,2022-03-22 01:17:58,2022-03-22 01:24:55,Y,Y,A1,,,11,,,,,,,,,,,,,,,,,,,,,,,,,,,,,,,,,7,,,,,,,,,,,,,,,,,,,,,,,,,,,,,,,,,9,,,,,,,,,,,,,,,,,,,,,,,,,,,,,,,,,13,,,,,,,,,,,,,,,,,,,,,,,,,,,,,,,,,1,5.0,1.0,1.0,1.0,2.0,1.0,7.0,3.0,2.0,1.0,3.0,2.0,2.0,2.0,5.0,1.0,5.0,1.0,2.0,1.0,1.0,2.0,1.0,2.0,2.0,3.0,3.0,3.0,1.0,4.0,2.0,5.0,4,,,,,,,,,,,,,,,,,,,,,,,,,,,,,,,,,10,,,,,,,,,,,,,,,,,,,,,,,,,,,,,,,,,2,5.0,5.0,6.0,5.0,5.0,6.0,2.0,4.0,6.0,2.0,3.0,6.0,4.0,3.0,3.0,5.0,7.0,5.0,3.0,5.0,4.0,6.0,6.0,3.0,4.0,2.0,4.0,5.0,3.0,5.0,6.0,1.0,14,,,,,,,,,,,,,,,,,,,,,,,,,,,,,,,,,5,,,,,,,,,,,,,,,,,,,,,,,,,,,,,,,,,12,,,,,,,,,,,,,,,,,,,,,,,,,,,,,,,,,6,,,,,,,,,,,,,,,,,,,,,,,,,,,,,,,,,8,,,,,,,,,,,,,,,,,,,,,,,,,,,,,,,,,0,2.0,7.0,3.0,3.0,4.0,4.0,6.0,4.0,5.0,3.0,2.0,4.0,6.0,3.0,5.0,2.0,6.0,6.0,4.0,3.0,1.0,4.0,6.0,4.0,4.0,6.0,2.0,4.0,3.0,5.0,4.0,7.0,3,,,,,,,,,,,,,,,,,,,,,,,,,,,,,,,,,,420.27,50.59,,,,8.37,,43.76,,,,,,,,,,,,,,91.97,,,,,,,,,113.7,,,,,,,,,,,,,,,,,,106.59,,,,,,5.29,,APPROVED,Female,22.0,FALSE
666,2022-03-22 01:22:01,19,en,277780862,2022-03-22 01:18:19,2022-03-22 01:22:01,Y,Y,A1,,,12,,,,,,,,,,,,,,,,,,,,,,,,,,,,,,,,,14,,,,,,,,,,,,,,,,,,,,,,,,,,,,,,,,,8,,,,,,,,,,,,,,,,,,,,,,,,,,,,,,,,,13,,,,,,,,,,,,,,,,,,,,,,,,,,,,,,,,,1,1.0,1.0,1.0,1.0,1.0,2.0,6.0,1.0,3.0,1.0,1.0,1.0,1.0,1.0,1.0,1.0,1.0,1.0,1.0,1.0,1.0,1.0,1.0,1.0,1.0,1.0,1.0,1.0,1.0,1.0,1.0,5.0,6,,,,,,,,,,,,,,,,,,,,,,,,,,,,,,,,,11,,,,,,,,,,,,,,,,,,,,,,,,,,,,,,,,,10,,,,,,,,,,,,,,,,,,,,,,,,,,,,,,,,,0,1.0,1.0,1.0,1.0,1.0,1.0,6.0,1.0,1.0,1.0,1.0,1.0,1.0,1.0,1.0,1.0,1.0,1.0,1.0,1.0,1.0,1.0,1.0,1.0,1.0,1.0,1.0,1.0,1.0,1.0,1.0,2.0,5,,,,,,,,,,,,,,,,,,,,,,,,,,,,,,,,,2,2.0,5.0,4.0,2.0,2.0,2.0,5.0,2.0,5.0,2.0,2.0,3.0,2.0,2.0,2.0,2.0,5.0,2.0,2.0,2.0,2.0,2.0,2.0,2.0,2.0,1.0,2.0,2.0,4.0,2.0,2.0,4.0,4,,,,,,,,,,,,,,,,,,,,,,,,,,,,,,,,,9,,,,,,,,,,,,,,,,,,,,,,,,,,,,,,,,,7,,,,,,,,,,,,,,,,,,,,,,,,,,,,,,,,,3,,,,,,,,,,,,,,,,,,,,,,,,,,,,,,,,,None.,224.76,18.2,,,,5.45,,52.51,,,,,,,,,,,,,,44.98,,,,,,,,,,,,46.43,,,,,,50.47,,,,,,,,,,,,,,,6.72,,APPROVED,Male,30.0,FALSE
667,2022-03-22 01:31:43,19,en,2067062362,2022-03-22 01:18:25,2022-03-22 01:31:43,Y,Y,A2,,,4,,,,,,,,,,,,,,,,,,,,,,,,,,,,,,,,,5,,,,,,,,,,,,,,,,,,,,,,,,,,,,,,,,,13,,,,,,,,,,,,,,,,,,,,,,,,,,,,,,,,,3,,,,,,,,,,,,,,,,,,,,,,,,,,,,,,,,,1,7.0,7.0,7.0,6.0,6.0,6.0,3.0,6.0,6.0,7.0,6.0,7.0,6.0,6.0,7.0,5.0,6.0,6.0,7.0,6.0,4.0,6.0,6.0,6.0,7.0,6.0,2.0,6.0,7.0,6.0,6.0,5.0,0,6.0,7.0,6.0,4.0,6.0,3.0,3.0,7.0,7.0,3.0,4.0,3.0,6.0,6.0,6.0,5.0,7.0,6.0,6.0,6.0,4.0,6.0,3.0,5.0,5.0,2.0,4.0,6.0,5.0,4.0,5.0,6.0,11,,,,,,,,,,,,,,,,,,,,,,,,,,,,,,,,,12,,,,,,,,,,,,,,,,,,,,,,,,,,,,,,,,,2,7.0,7.0,7.0,6.0,6.0,6.0,4.0,7.0,7.0,6.0,5.0,4.0,6.0,6.0,7.0,5.0,7.0,4.0,6.0,6.0,6.0,6.0,7.0,6.0,7.0,6.0,2.0,6.0,5.0,5.0,6.0,2.0,14,,,,,,,,,,,,,,,,,,,,,,,,,,,,,,,,,6,,,,,,,,,,,,,,,,,,,,,,,,,,,,,,,,,8,,,,,,,,,,,,,,,,,,,,,,,,,,,,,,,,,7,,,,,,,,,,,,,,,,,,,,,,,,,,,,,,,,,10,,,,,,,,,,,,,,,,,,,,,,,,,,,,,,,,,9,,,,,,,,,,,,,,,,,,,,,,,,,,,,,,,,,,801.93,86.99,,,,8.98,,97.63,,,,,,,,,,,,,,166.61,,,286.87,,,,,,,,,153.12,,,,,,,,,,,,,,,,,,,,,1.73,,APPROVED,Male,25.0,FALSE
668,2022-03-22 01:28:50,19,en,844637599,2022-03-22 01:20:22,2022-03-22 01:28:50,Y,Y,A1,,,12,,,,,,,,,,,,,,,,,,,,,,,,,,,,,,,,,7,,,,,,,,,,,,,,,,,,,,,,,,,,,,,,,,,2,4.0,4.0,6.0,7.0,3.0,7.0,2.0,7.0,5.0,4.0,5.0,5.0,6.0,3.0,4.0,6.0,6.0,6.0,5.0,4.0,4.0,5.0,6.0,5.0,4.0,5.0,5.0,5.0,4.0,6.0,4.0,3.0,13,,,,,,,,,,,,,,,,,,,,,,,,,,,,,,,,,14,,,,,,,,,,,,,,,,,,,,,,,,,,,,,,,,,4,,,,,,,,,,,,,,,,,,,,,,,,,,,,,,,,,5,,,,,,,,,,,,,,,,,,,,,,,,,,,,,,,,,3,,,,,,,,,,,,,,,,,,,,,,,,,,,,,,,,,9,,,,,,,,,,,,,,,,,,,,,,,,,,,,,,,,,10,,,,,,,,,,,,,,,,,,,,,,,,,,,,,,,,,8,,,,,,,,,,,,,,,,,,,,,,,,,,,,,,,,,11,,,,,,,,,,,,,,,,,,,,,,,,,,,,,,,,,1,4.0,3.0,6.0,6.0,2.0,6.0,4.0,5.0,6.0,4.0,2.0,6.0,6.0,4.0,3.0,6.0,5.0,4.0,6.0,3.0,4.0,5.0,7.0,4.0,3.0,6.0,5.0,5.0,3.0,4.0,6.0,6.0,6,,,,,,,,,,,,,,,,,,,,,,,,,,,,,,,,,0,4.0,6.0,5.0,6.0,2.0,1.0,5.0,6.0,5.0,3.0,4.0,6.0,5.0,5.0,4.0,3.0,4.0,4.0,4.0,1.0,3.0,3.0,4.0,4.0,3.0,5.0,5.0,4.0,5.0,3.0,4.0,1.0,,510.7,14.31,,,,26.58,,42.1,,,,,,,,101.21,,,,,,,,,,,,,,,,,,,,,,,,,,,,,,162.61,,,,,,158.73,,,5.16,,APPROVED,Female,27.0,FALSE
669,2022-03-22 01:28:17,19,en,172070265,2022-03-22 01:20:30,2022-03-22 01:28:17,Y,Y,A1,,,3,,,,,,,,,,,,,,,,,,,,,,,,,,,,,,,,,14,,,,,,,,,,,,,,,,,,,,,,,,,,,,,,,,,0,5.0,6.0,4.0,4.0,5.0,3.0,7.0,6.0,6.0,4.0,6.0,3.0,5.0,4.0,6.0,5.0,5.0,2.0,3.0,3.0,2.0,5.0,3.0,5.0,5.0,6.0,5.0,5.0,5.0,5.0,4.0,3.0,10,,,,,,,,,,,,,,,,,,,,,,,,,,,,,,,,,7,,,,,,,,,,,,,,,,,,,,,,,,,,,,,,,,,2,4.0,3.0,4.0,6.0,4.0,7.0,1.0,3.0,3.0,3.0,6.0,4.0,3.0,3.0,3.0,3.0,4.0,4.0,5.0,3.0,3.0,4.0,7.0,5.0,4.0,7.0,3.0,4.0,4.0,4.0,7.0,6.0,5,,,,,,,,,,,,,,,,,,,,,,,,,,,,,,,,,6,,,,,,,,,,,,,,,,,,,,,,,,,,,,,,,,,11,,,,,,,,,,,,,,,,,,,,,,,,,,,,,,,,,4,,,,,,,,,,,,,,,,,,,,,,,,,,,,,,,,,12,,,,,,,,,,,,,,,,,,,,,,,,,,,,,,,,,1,4.0,6.0,3.0,2.0,2.0,2.0,4.0,4.0,5.0,3.0,3.0,3.0,2.0,4.0,4.0,4.0,5.0,1.0,2.0,3.0,3.0,3.0,1.0,4.0,4.0,4.0,4.0,3.0,2.0,2.0,3.0,5.0,9,,,,,,,,,,,,,,,,,,,,,,,,,,,,,,,,,8,,,,,,,,,,,,,,,,,,,,,,,,,,,,,,,,,13,,,,,,,,,,,,,,,,,,,,,,,,,,,,,,,,,,469.5,9.69,,,,13.38,,30.27,,,,,,,,278.33,,,,,,,,,69.52,,,,,,,,,,,,,,,,,,65.25,,,,,,,,,,,,3.06,,APPROVED,Male,28.0,FALSE
670,2022-03-22 01:32:26,19,en,2089271107,2022-03-22 01:26:28,2022-03-22 01:32:26,Y,Y,A1,,,7,,,,,,,,,,,,,,,,,,,,,,,,,,,,,,,,,3,,,,,,,,,,,,,,,,,,,,,,,,,,,,,,,,,6,,,,,,,,,,,,,,,,,,,,,,,,,,,,,,,,,11,,,,,,,,,,,,,,,,,,,,,,,,,,,,,,,,,8,,,,,,,,,,,,,,,,,,,,,,,,,,,,,,,,,2,6.0,6.0,5.0,3.0,5.0,4.0,5.0,3.0,6.0,4.0,2.0,6.0,5.0,5.0,5.0,2.0,5.0,5.0,5.0,5.0,4.0,5.0,5.0,5.0,5.0,4.0,2.0,2.0,3.0,2.0,5.0,6.0,9,,,,,,,,,,,,,,,,,,,,,,,,,,,,,,,,,4,,,,,,,,,,,,,,,,,,,,,,,,,,,,,,,,,14,,,,,,,,,,,,,,,,,,,,,,,,,,,,,,,,,5,,,,,,,,,,,,,,,,,,,,,,,,,,,,,,,,,1,2.0,4.0,2.0,2.0,2.0,1.0,6.0,6.0,6.0,2.0,2.0,2.0,2.0,2.0,2.0,2.0,1.0,2.0,2.0,1.0,2.0,1.0,1.0,2.0,2.0,1.0,2.0,2.0,3.0,2.0,2.0,4.0,0,3.0,6.0,5.0,4.0,3.0,2.0,4.0,2.0,4.0,2.0,5.0,5.0,6.0,5.0,6.0,3.0,5.0,5.0,4.0,4.0,4.0,4.0,2.0,4.0,3.0,2.0,2.0,3.0,4.0,4.0,2.0,5.0,12,,,,,,,,,,,,,,,,,,,,,,,,,,,,,,,,,13,,,,,,,,,,,,,,,,,,,,,,,,,,,,,,,,,10,,,,,,,,,,,,,,,,,,,,,,,,,,,,,,,,,,361.92,30.84,,,,10.65,,47.48,,,,,,,,,,,,,,,,,89.29,,,,,,,,,,,,,,,88.58,,,91.68,,,,,,,,,,,,3.4,,APPROVED,Male,24.0,FALSE
671,2022-03-22 01:34:04,19,en,1768331564,2022-03-22 01:26:28,2022-03-22 01:34:04,Y,Y,A1,,,10,,,,,,,,,,,,,,,,,,,,,,,,,,,,,,,,,8,,,,,,,,,,,,,,,,,,,,,,,,,,,,,,,,,6,,,,,,,,,,,,,,,,,,,,,,,,,,,,,,,,,1,7.0,5.0,5.0,6.0,4.0,6.0,2.0,7.0,7.0,6.0,6.0,6.0,5.0,6.0,6.0,7.0,7.0,6.0,6.0,4.0,4.0,6.0,7.0,5.0,5.0,7.0,5.0,7.0,6.0,4.0,7.0,4.0,5,,,,,,,,,,,,,,,,,,,,,,,,,,,,,,,,,14,,,,,,,,,,,,,,,,,,,,,,,,,,,,,,,,,11,,,,,,,,,,,,,,,,,,,,,,,,,,,,,,,,,2,2.0,5.0,3.0,5.0,4.0,4.0,6.0,6.0,5.0,3.0,3.0,4.0,2.0,4.0,4.0,4.0,5.0,3.0,4.0,3.0,3.0,4.0,2.0,3.0,4.0,4.0,3.0,7.0,4.0,4.0,4.0,1.0,4,,,,,,,,,,,,,,,,,,,,,,,,,,,,,,,,,7,,,,,,,,,,,,,,,,,,,,,,,,,,,,,,,,,0,7.0,6.0,6.0,7.0,6.0,6.0,1.0,7.0,7.0,6.0,5.0,6.0,7.0,6.0,5.0,7.0,6.0,6.0,7.0,5.0,5.0,7.0,6.0,7.0,7.0,6.0,4.0,7.0,6.0,6.0,6.0,4.0,9,,,,,,,,,,,,,,,,,,,,,,,,,,,,,,,,,13,,,,,,,,,,,,,,,,,,,,,,,,,,,,,,,,,3,,,,,,,,,,,,,,,,,,,,,,,,,,,,,,,,,12,,,,,,,,,,,,,,,,,,,,,,,,,,,,,,,,,It was a interesting survey,458.86,53.42,,,,6.99,,31.22,,,,,,,,,,,135.56,,,,,,,,,,,,116.6,,,,,,,,,104.51,,,,,,,,,,,,,,,10.56,,APPROVED,Female,20.0,FALSE
672,2022-03-22 01:32:19,19,en,1982939988,2022-03-22 01:26:29,2022-03-22 01:32:19,Y,Y,-oth-,"some college, no degree",,8,,,,,,,,,,,,,,,,,,,,,,,,,,,,,,,,,2,5.0,4.0,6.0,5.0,5.0,6.0,2.0,6.0,4.0,6.0,5.0,5.0,5.0,5.0,5.0,5.0,5.0,6.0,6.0,5.0,5.0,6.0,7.0,6.0,6.0,6.0,4.0,6.0,4.0,6.0,7.0,2.0,12,,,,,,,,,,,,,,,,,,,,,,,,,,,,,,,,,9,,,,,,,,,,,,,,,,,,,,,,,,,,,,,,,,,5,,,,,,,,,,,,,,,,,,,,,,,,,,,,,,,,,1,7.0,6.0,6.0,5.0,5.0,4.0,5.0,6.0,5.0,6.0,5.0,6.0,5.0,5.0,6.0,5.0,6.0,5.0,5.0,5.0,4.0,6.0,4.0,5.0,6.0,5.0,4.0,5.0,5.0,5.0,5.0,6.0,4,,,,,,,,,,,,,,,,,,,,,,,,,,,,,,,,,7,,,,,,,,,,,,,,,,,,,,,,,,,,,,,,,,,0,2.0,3.0,2.0,3.0,2.0,1.0,7.0,1.0,5.0,3.0,3.0,3.0,2.0,2.0,4.0,2.0,4.0,3.0,3.0,2.0,4.0,2.0,4.0,1.0,2.0,3.0,4.0,2.0,4.0,3.0,3.0,2.0,14,,,,,,,,,,,,,,,,,,,,,,,,,,,,,,,,,11,,,,,,,,,,,,,,,,,,,,,,,,,,,,,,,,,10,,,,,,,,,,,,,,,,,,,,,,,,,,,,,,,,,6,,,,,,,,,,,,,,,,,,,,,,,,,,,,,,,,,3,,,,,,,,,,,,,,,,,,,,,,,,,,,,,,,,,13,,,,,,,,,,,,,,,,,,,,,,,,,,,,,,,,,,353.47,15.46,,,,15.12,,55.26,,,,,77.42,,,,,,,,,,,,60.57,,,,,,,,,122.25,,,,,,,,,,,,,,,,,,,,,7.39,,APPROVED,Male,20.0,FALSE
673,2022-03-22 01:37:31,19,en,939127583,2022-03-22 01:26:30,2022-03-22 01:37:31,Y,Y,-oth-,"no degree, ",,7,,,,,,,,,,,,,,,,,,,,,,,,,,,,,,,,,3,,,,,,,,,,,,,,,,,,,,,,,,,,,,,,,,,8,,,,,,,,,,,,,,,,,,,,,,,,,,,,,,,,,6,,,,,,,,,,,,,,,,,,,,,,,,,,,,,,,,,4,,,,,,,,,,,,,,,,,,,,,,,,,,,,,,,,,10,,,,,,,,,,,,,,,,,,,,,,,,,,,,,,,,,13,,,,,,,,,,,,,,,,,,,,,,,,,,,,,,,,,11,,,,,,,,,,,,,,,,,,,,,,,,,,,,,,,,,0,2.0,2.0,3.0,4.0,1.0,4.0,5.0,4.0,3.0,2.0,4.0,2.0,1.0,4.0,4.0,4.0,4.0,3.0,2.0,1.0,3.0,2.0,4.0,2.0,1.0,4.0,3.0,4.0,4.0,4.0,4.0,2.0,1,4.0,5.0,6.0,3.0,4.0,4.0,4.0,4.0,6.0,4.0,4.0,5.0,5.0,4.0,6.0,3.0,5.0,4.0,5.0,4.0,4.0,4.0,5.0,4.0,4.0,4.0,5.0,5.0,4.0,5.0,6.0,3.0,9,,,,,,,,,,,,,,,,,,,,,,,,,,,,,,,,,12,,,,,,,,,,,,,,,,,,,,,,,,,,,,,,,,,2,6.0,7.0,6.0,4.0,6.0,5.0,2.0,6.0,7.0,5.0,4.0,6.0,6.0,7.0,7.0,6.0,7.0,7.0,6.0,6.0,6.0,6.0,6.0,6.0,5.0,5.0,6.0,5.0,4.0,6.0,6.0,6.0,5,,,,,,,,,,,,,,,,,,,,,,,,,,,,,,,,,14,,,,,,,,,,,,,,,,,,,,,,,,,,,,,,,,,,664.76,98.03,,,,45.43,,30.61,,,,,,,,,,,,,,,,,,,,,,,,,,164.06,,,188.35,,,,,,,,,133.71,,,,,,,,,4.57,,APPROVED,Female,,FALSE
674,2022-03-22 01:32:29,19,en,1202999773,2022-03-22 01:26:33,2022-03-22 01:32:29,Y,Y,-oth-,High School ,,5,,,,,,,,,,,,,,,,,,,,,,,,,,,,,,,,,7,,,,,,,,,,,,,,,,,,,,,,,,,,,,,,,,,0,6.0,7.0,7.0,4.0,6.0,7.0,2.0,6.0,7.0,5.0,6.0,5.0,6.0,6.0,5.0,5.0,7.0,6.0,7.0,5.0,5.0,5.0,4.0,7.0,6.0,4.0,2.0,7.0,5.0,4.0,6.0,5.0,13,,,,,,,,,,,,,,,,,,,,,,,,,,,,,,,,,9,,,,,,,,,,,,,,,,,,,,,,,,,,,,,,,,,10,,,,,,,,,,,,,,,,,,,,,,,,,,,,,,,,,2,3.0,6.0,2.0,4.0,2.0,5.0,5.0,4.0,6.0,3.0,3.0,4.0,3.0,4.0,5.0,3.0,5.0,4.0,2.0,4.0,3.0,4.0,3.0,3.0,3.0,3.0,2.0,2.0,4.0,5.0,5.0,7.0,11,,,,,,,,,,,,,,,,,,,,,,,,,,,,,,,,,8,,,,,,,,,,,,,,,,,,,,,,,,,,,,,,,,,14,,,,,,,,,,,,,,,,,,,,,,,,,,,,,,,,,4,,,,,,,,,,,,,,,,,,,,,,,,,,,,,,,,,6,,,,,,,,,,,,,,,,,,,,,,,,,,,,,,,,,1,4.0,6.0,4.0,4.0,4.0,5.0,5.0,5.0,6.0,4.0,5.0,3.0,5.0,3.0,5.0,4.0,5.0,3.0,4.0,3.0,2.0,5.0,5.0,3.0,4.0,6.0,2.0,6.0,6.0,3.0,5.0,6.0,3,,,,,,,,,,,,,,,,,,,,,,,,,,,,,,,,,12,,,,,,,,,,,,,,,,,,,,,,,,,,,,,,,,,,358.13,60.04,,,,21.13,,39.64,,,,,,,,94.06,,,,,,,,,,,,69.33,,,,,,,,,,,,,,,,,,70.62,,,,,,,,,3.31,,APPROVED,Male,22.0,FALSE
676,2022-03-22 01:34:18,19,en,226033183,2022-03-22 01:26:34,2022-03-22 01:34:18,Y,Y,-oth-,high school,,10,,,,,,,,,,,,,,,,,,,,,,,,,,,,,,,,,13,,,,,,,,,,,,,,,,,,,,,,,,,,,,,,,,,9,,,,,,,,,,,,,,,,,,,,,,,,,,,,,,,,,12,,,,,,,,,,,,,,,,,,,,,,,,,,,,,,,,,1,3.0,3.0,3.0,6.0,2.0,6.0,3.0,6.0,2.0,4.0,4.0,5.0,4.0,4.0,1.0,4.0,4.0,4.0,4.0,4.0,3.0,4.0,6.0,4.0,4.0,6.0,2.0,4.0,3.0,4.0,5.0,5.0,6,,,,,,,,,,,,,,,,,,,,,,,,,,,,,,,,,5,,,,,,,,,,,,,,,,,,,,,,,,,,,,,,,,,2,6.0,6.0,6.0,5.0,4.0,6.0,1.0,4.0,6.0,5.0,3.0,4.0,5.0,5.0,3.0,5.0,5.0,5.0,6.0,4.0,4.0,6.0,6.0,6.0,6.0,4.0,3.0,7.0,2.0,4.0,6.0,1.0,4,,,,,,,,,,,,,,,,,,,,,,,,,,,,,,,,,0,1.0,6.0,4.0,1.0,4.0,1.0,7.0,1.0,6.0,4.0,2.0,1.0,4.0,5.0,5.0,2.0,6.0,1.0,4.0,4.0,2.0,4.0,1.0,5.0,5.0,1.0,4.0,5.0,2.0,4.0,1.0,3.0,14,,,,,,,,,,,,,,,,,,,,,,,,,,,,,,,,,3,,,,,,,,,,,,,,,,,,,,,,,,,,,,,,,,,7,,,,,,,,,,,,,,,,,,,,,,,,,,,,,,,,,11,,,,,,,,,,,,,,,,,,,,,,,,,,,,,,,,,8,,,,,,,,,,,,,,,,,,,,,,,,,,,,,,,,,,467.95,30.82,,,,30.66,,26.32,,,,,,,,,,,,,,175.7,,,,,,,,,92.09,,,,,,108.87,,,,,,,,,,,,,,,,,,3.49,,APPROVED,Female,20.0,FALSE
677,2022-03-22 01:39:27,19,en,973639370,2022-03-22 01:26:35,2022-03-22 01:39:27,Y,Y,A1,,,5,,,,,,,,,,,,,,,,,,,,,,,,,,,,,,,,,4,,,,,,,,,,,,,,,,,,,,,,,,,,,,,,,,,0,7.0,7.0,7.0,7.0,7.0,7.0,5.0,7.0,7.0,7.0,6.0,6.0,7.0,6.0,6.0,7.0,7.0,6.0,7.0,5.0,7.0,6.0,7.0,7.0,6.0,6.0,4.0,7.0,7.0,7.0,7.0,3.0,7,,,,,,,,,,,,,,,,,,,,,,,,,,,,,,,,,2,2.0,5.0,2.0,2.0,3.0,2.0,7.0,5.0,6.0,2.0,2.0,3.0,4.0,2.0,2.0,2.0,3.0,2.0,4.0,2.0,2.0,4.0,1.0,2.0,2.0,3.0,2.0,2.0,2.0,2.0,5.0,5.0,10,,,,,,,,,,,,,,,,,,,,,,,,,,,,,,,,,13,,,,,,,,,,,,,,,,,,,,,,,,,,,,,,,,,12,,,,,,,,,,,,,,,,,,,,,,,,,,,,,,,,,3,,,,,,,,,,,,,,,,,,,,,,,,,,,,,,,,,8,,,,,,,,,,,,,,,,,,,,,,,,,,,,,,,,,6,,,,,,,,,,,,,,,,,,,,,,,,,,,,,,,,,9,,,,,,,,,,,,,,,,,,,,,,,,,,,,,,,,,11,,,,,,,,,,,,,,,,,,,,,,,,,,,,,,,,,14,,,,,,,,,,,,,,,,,,,,,,,,,,,,,,,,,1,5.0,6.0,3.0,6.0,4.0,6.0,4.0,5.0,4.0,4.0,5.0,4.0,4.0,3.0,5.0,5.0,4.0,5.0,3.0,4.0,4.0,5.0,6.0,5.0,2.0,6.0,3.0,4.0,5.0,4.0,6.0,1.0,,763.97,94.53,,,,7.41,,96.46,,,,,,,,160.83,,,,,,105.66,,,,,,,,,,,,,,,,,,,,,,,,,,,,,,294.77,,,4.31,,APPROVED,Female,20.0,FALSE
678,2022-03-22 01:32:24,19,en,886493971,2022-03-22 01:26:36,2022-03-22 01:32:24,Y,Y,A1,,,1,6.0,7.0,7.0,7.0,6.0,2.0,6.0,7.0,7.0,7.0,2.0,7.0,6.0,6.0,6.0,6.0,7.0,2.0,6.0,6.0,6.0,6.0,2.0,6.0,6.0,7.0,2.0,6.0,2.0,7.0,6.0,1.0,2,2.0,2.0,2.0,6.0,1.0,6.0,2.0,6.0,1.0,2.0,2.0,7.0,2.0,2.0,6.0,6.0,6.0,6.0,6.0,2.0,1.0,6.0,6.0,2.0,6.0,6.0,1.0,6.0,6.0,2.0,2.0,2.0,1,3.0,6.0,7.0,7.0,7.0,3.0,5.0,7.0,6.0,6.0,2.0,5.0,6.0,6.0,6.0,5.0,7.0,5.0,5.0,5.0,6.0,6.0,3.0,5.0,6.0,4.0,2.0,5.0,5.0,6.0,6.0,1.0,11,,,,,,,,,,,,,,,,,,,,,,,,,,,,,,,,,8,,,,,,,,,,,,,,,,,,,,,,,,,,,,,,,,,14,,,,,,,,,,,,,,,,,,,,,,,,,,,,,,,,,5,,,,,,,,,,,,,,,,,,,,,,,,,,,,,,,,,13,,,,,,,,,,,,,,,,,,,,,,,,,,,,,,,,,7,,,,,,,,,,,,,,,,,,,,,,,,,,,,,,,,,3,,,,,,,,,,,,,,,,,,,,,,,,,,,,,,,,,12,,,,,,,,,,,,,,,,,,,,,,,,,,,,,,,,,6,,,,,,,,,,,,,,,,,,,,,,,,,,,,,,,,,4,,,,,,,,,,,,,,,,,,,,,,,,,,,,,,,,,10,,,,,,,,,,,,,,,,,,,,,,,,,,,,,,,,,9,,,,,,,,,,,,,,,,,,,,,,,,,,,,,,,,,,404.73,23.76,,,,8.03,,39.18,,40.21,,,48.84,,,241.7,,,,,,,,,,,,,,,,,,,,,,,,,,,,,,,,,,,,,,,3.01,,APPROVED,Male,21.0,FALSE
679,2022-03-22 01:33:49,19,en,425829460,2022-03-22 01:26:37,2022-03-22 01:33:49,Y,Y,A1,,,9,,,,,,,,,,,,,,,,,,,,,,,,,,,,,,,,,3,,,,,,,,,,,,,,,,,,,,,,,,,,,,,,,,,0,7.0,7.0,6.0,3.0,6.0,3.0,6.0,6.0,7.0,6.0,5.0,5.0,6.0,6.0,4.0,6.0,7.0,5.0,6.0,6.0,5.0,6.0,2.0,5.0,7.0,4.0,4.0,6.0,6.0,4.0,6.0,3.0,10,,,,,,,,,,,,,,,,,,,,,,,,,,,,,,,,,8,,,,,,,,,,,,,,,,,,,,,,,,,,,,,,,,,12,,,,,,,,,,,,,,,,,,,,,,,,,,,,,,,,,14,,,,,,,,,,,,,,,,,,,,,,,,,,,,,,,,,11,,,,,,,,,,,,,,,,,,,,,,,,,,,,,,,,,5,,,,,,,,,,,,,,,,,,,,,,,,,,,,,,,,,4,,,,,,,,,,,,,,,,,,,,,,,,,,,,,,,,,2,3.0,5.0,3.0,4.0,3.0,2.0,6.0,2.0,5.0,4.0,5.0,6.0,3.0,3.0,3.0,2.0,5.0,3.0,4.0,4.0,6.0,3.0,2.0,2.0,4.0,1.0,6.0,2.0,6.0,4.0,2.0,4.0,6,,,,,,,,,,,,,,,,,,,,,,,,,,,,,,,,,1,5.0,6.0,6.0,4.0,5.0,2.0,7.0,4.0,5.0,5.0,5.0,6.0,5.0,6.0,6.0,6.0,6.0,6.0,6.0,5.0,6.0,6.0,6.0,6.0,6.0,5.0,4.0,5.0,7.0,5.0,6.0,6.0,7,,,,,,,,,,,,,,,,,,,,,,,,,,,,,,,,,13,,,,,,,,,,,,,,,,,,,,,,,,,,,,,,,,,,434.9,9.11,,,,3.98,,21.68,,,,,,,,63.8,,,,,,,,,,,,,,,,,,,,,,,,278.72,,,,,,54.43,,,,,,,,,3.18,,APPROVED,Male,37.0,FALSE
680,2022-03-22 01:33:25,19,en,1162129661,2022-03-22 01:26:37,2022-03-22 01:33:25,Y,Y,A2,,,7,,,,,,,,,,,,,,,,,,,,,,,,,,,,,,,,,2,7.0,5.0,7.0,7.0,7.0,7.0,2.0,5.0,7.0,7.0,7.0,7.0,7.0,7.0,6.0,6.0,7.0,7.0,7.0,7.0,6.0,7.0,7.0,6.0,7.0,7.0,4.0,6.0,7.0,7.0,7.0,2.0,9,,,,,,,,,,,,,,,,,,,,,,,,,,,,,,,,,14,,,,,,,,,,,,,,,,,,,,,,,,,,,,,,,,,13,,,,,,,,,,,,,,,,,,,,,,,,,,,,,,,,,1,6.0,6.0,6.0,6.0,6.0,6.0,2.0,6.0,6.0,6.0,6.0,6.0,6.0,6.0,6.0,6.0,6.0,6.0,6.0,6.0,6.0,6.0,6.0,6.0,6.0,6.0,5.0,6.0,6.0,6.0,6.0,6.0,12,,,,,,,,,,,,,,,,,,,,,,,,,,,,,,,,,4,,,,,,,,,,,,,,,,,,,,,,,,,,,,,,,,,10,,,,,,,,,,,,,,,,,,,,,,,,,,,,,,,,,0,3.0,4.0,3.0,2.0,2.0,3.0,7.0,3.0,4.0,2.0,4.0,2.0,4.0,3.0,4.0,2.0,4.0,3.0,3.0,4.0,3.0,2.0,2.0,4.0,3.0,2.0,6.0,3.0,6.0,2.0,4.0,3.0,5,,,,,,,,,,,,,,,,,,,,,,,,,,,,,,,,,11,,,,,,,,,,,,,,,,,,,,,,,,,,,,,,,,,6,,,,,,,,,,,,,,,,,,,,,,,,,,,,,,,,,3,,,,,,,,,,,,,,,,,,,,,,,,,,,,,,,,,8,,,,,,,,,,,,,,,,,,,,,,,,,,,,,,,,,,411.47,64.53,,,,15.72,,53.24,,,,,71.17,,,,,,,,,,,,77.74,,,,,,,,,,,,125.23,,,,,,,,,,,,,,,,,,3.84,,APPROVED,Male,35.0,FALSE
681,2022-03-22 01:32:43,19,en,415391093,2022-03-22 01:26:37,2022-03-22 01:32:43,Y,Y,A2,,,12,,,,,,,,,,,,,,,,,,,,,,,,,,,,,,,,,6,,,,,,,,,,,,,,,,,,,,,,,,,,,,,,,,,3,,,,,,,,,,,,,,,,,,,,,,,,,,,,,,,,,7,,,,,,,,,,,,,,,,,,,,,,,,,,,,,,,,,8,,,,,,,,,,,,,,,,,,,,,,,,,,,,,,,,,1,5.0,5.0,4.0,3.0,4.0,3.0,5.0,5.0,5.0,4.0,3.0,5.0,5.0,4.0,5.0,3.0,5.0,4.0,4.0,4.0,4.0,5.0,3.0,4.0,5.0,4.0,4.0,5.0,5.0,4.0,4.0,6.0,0,3.0,5.0,4.0,4.0,3.0,3.0,5.0,4.0,5.0,2.0,2.0,5.0,4.0,4.0,5.0,5.0,6.0,4.0,4.0,3.0,5.0,4.0,4.0,4.0,2.0,5.0,3.0,5.0,2.0,3.0,4.0,7.0,9,,,,,,,,,,,,,,,,,,,,,,,,,,,,,,,,,4,,,,,,,,,,,,,,,,,,,,,,,,,,,,,,,,,13,,,,,,,,,,,,,,,,,,,,,,,,,,,,,,,,,2,4.0,4.0,3.0,3.0,3.0,4.0,5.0,5.0,5.0,3.0,3.0,4.0,4.0,4.0,4.0,4.0,5.0,3.0,4.0,3.0,4.0,3.0,4.0,3.0,3.0,3.0,4.0,4.0,3.0,3.0,4.0,4.0,11,,,,,,,,,,,,,,,,,,,,,,,,,,,,,,,,,14,,,,,,,,,,,,,,,,,,,,,,,,,,,,,,,,,5,,,,,,,,,,,,,,,,,,,,,,,,,,,,,,,,,10,,,,,,,,,,,,,,,,,,,,,,,,,,,,,,,,,,368.53,39.34,,,,7.18,,38.78,,,,,,,,,,,,,,,,,83.14,,,106.55,,,,,,,,,,,,90.45,,,,,,,,,,,,,,,3.09,,APPROVED,Female,25.0,FALSE
682,2022-03-22 01:31:33,19,en,1422889546,2022-03-22 01:26:38,2022-03-22 01:31:33,Y,Y,A1,,,2,5.0,2.0,5.0,4.0,5.0,3.0,2.0,6.0,4.0,4.0,5.0,5.0,5.0,5.0,6.0,5.0,5.0,5.0,5.0,4.0,1.0,4.0,3.0,6.0,4.0,5.0,2.0,5.0,4.0,5.0,5.0,1.0,7,,,,,,,,,,,,,,,,,,,,,,,,,,,,,,,,,1,5.0,5.0,6.0,6.0,5.0,6.0,2.0,6.0,6.0,5.0,5.0,5.0,6.0,4.0,5.0,6.0,6.0,6.0,5.0,4.0,4.0,5.0,6.0,5.0,5.0,6.0,5.0,5.0,4.0,5.0,5.0,3.0,5,,,,,,,,,,,,,,,,,,,,,,,,,,,,,,,,,12,,,,,,,,,,,,,,,,,,,,,,,,,,,,,,,,,8,,,,,,,,,,,,,,,,,,,,,,,,,,,,,,,,,11,,,,,,,,,,,,,,,,,,,,,,,,,,,,,,,,,14,,,,,,,,,,,,,,,,,,,,,,,,,,,,,,,,,4,,,,,,,,,,,,,,,,,,,,,,,,,,,,,,,,,6,,,,,,,,,,,,,,,,,,,,,,,,,,,,,,,,,0,3.0,5.0,3.0,1.0,3.0,2.0,7.0,6.0,5.0,3.0,2.0,4.0,3.0,3.0,5.0,2.0,5.0,2.0,4.0,4.0,3.0,3.0,1.0,4.0,3.0,3.0,6.0,2.0,3.0,3.0,2.0,4.0,9,,,,,,,,,,,,,,,,,,,,,,,,,,,,,,,,,3,,,,,,,,,,,,,,,,,,,,,,,,,,,,,,,,,13,,,,,,,,,,,,,,,,,,,,,,,,,,,,,,,,,10,,,,,,,,,,,,,,,,,,,,,,,,,,,,,,,,,,298.79,11.89,,,,6.81,,31.17,,79.25,,,,,,69.2,,,,,,,,,,,,,,,,,,,,,,,,97.81,,,,,,,,,,,,,,,2.66,,APPROVED,Male,23.0,FALSE
683,2022-03-22 01:32:05,19,en,900130077,2022-03-22 01:26:38,2022-03-22 01:32:05,Y,Y,-oth-,Highschool,,14,,,,,,,,,,,,,,,,,,,,,,,,,,,,,,,,,8,,,,,,,,,,,,,,,,,,,,,,,,,,,,,,,,,2,3.0,6.0,5.0,5.0,5.0,2.0,7.0,5.0,6.0,5.0,6.0,2.0,5.0,5.0,5.0,2.0,6.0,3.0,5.0,5.0,4.0,4.0,2.0,5.0,6.0,6.0,5.0,4.0,5.0,6.0,1.0,3.0,7,,,,,,,,,,,,,,,,,,,,,,,,,,,,,,,,,1,4.0,4.0,2.0,1.0,2.0,1.0,7.0,2.0,3.0,3.0,3.0,2.0,2.0,3.0,6.0,2.0,4.0,1.0,2.0,3.0,2.0,3.0,1.0,2.0,2.0,6.0,5.0,2.0,4.0,5.0,4.0,5.0,12,,,,,,,,,,,,,,,,,,,,,,,,,,,,,,,,,9,,,,,,,,,,,,,,,,,,,,,,,,,,,,,,,,,11,,,,,,,,,,,,,,,,,,,,,,,,,,,,,,,,,6,,,,,,,,,,,,,,,,,,,,,,,,,,,,,,,,,13,,,,,,,,,,,,,,,,,,,,,,,,,,,,,,,,,10,,,,,,,,,,,,,,,,,,,,,,,,,,,,,,,,,4,,,,,,,,,,,,,,,,,,,,,,,,,,,,,,,,,0,5.0,6.0,4.0,2.0,6.0,1.0,7.0,5.0,4.0,4.0,6.0,5.0,4.0,4.0,5.0,1.0,4.0,3.0,5.0,4.0,4.0,4.0,2.0,6.0,4.0,6.0,4.0,6.0,5.0,6.0,3.0,6.0,5,,,,,,,,,,,,,,,,,,,,,,,,,,,,,,,,,3,,,,,,,,,,,,,,,,,,,,,,,,,,,,,,,,,,329.43,19.63,,,,18.24,,17.68,,,,,,,,92.41,,,,,,89.19,,,,,,,,,,,,,,,,,,,,,,,,88.53,,,,,,,,,3.75,,APPROVED,Male,34.0,FALSE
684,2022-03-22 01:38:54,19,en,1094955142,2022-03-22 01:26:39,2022-03-22 01:38:54,Y,Y,-oth-,GCSE,,0,4.0,7.0,1.0,1.0,1.0,4.0,4.0,4.0,7.0,1.0,1.0,1.0,1.0,1.0,5.0,4.0,1.0,1.0,1.0,1.0,1.0,1.0,1.0,1.0,1.0,1.0,5.0,1.0,1.0,4.0,5.0,1.0,1,4.0,1.0,4.0,7.0,4.0,7.0,1.0,7.0,1.0,4.0,1.0,1.0,4.0,1.0,1.0,7.0,6.0,1.0,7.0,4.0,1.0,5.0,7.0,4.0,4.0,7.0,4.0,7.0,1.0,7.0,7.0,2.0,3,,,,,,,,,,,,,,,,,,,,,,,,,,,,,,,,,12,,,,,,,,,,,,,,,,,,,,,,,,,,,,,,,,,5,,,,,,,,,,,,,,,,,,,,,,,,,,,,,,,,,11,,,,,,,,,,,,,,,,,,,,,,,,,,,,,,,,,6,,,,,,,,,,,,,,,,,,,,,,,,,,,,,,,,,2,1.0,1.0,1.0,4.0,1.0,1.0,7.0,1.0,1.0,1.0,1.0,1.0,4.0,1.0,4.0,1.0,1.0,1.0,1.0,1.0,1.0,1.0,4.0,1.0,1.0,1.0,1.0,4.0,1.0,4.0,1.0,1.0,14,,,,,,,,,,,,,,,,,,,,,,,,,,,,,,,,,13,,,,,,,,,,,,,,,,,,,,,,,,,,,,,,,,,4,,,,,,,,,,,,,,,,,,,,,,,,,,,,,,,,,7,,,,,,,,,,,,,,,,,,,,,,,,,,,,,,,,,10,,,,,,,,,,,,,,,,,,,,,,,,,,,,,,,,,9,,,,,,,,,,,,,,,,,,,,,,,,,,,,,,,,,8,,,,,,,,,,,,,,,,,,,,,,,,,,,,,,,,,,737.97,23.36,,,,15.46,,38.89,,89.41,,,472.42,,,,,,,,,,,,,,,,,,94.25,,,,,,,,,,,,,,,,,,,,,,,,4.18,,APPROVED,Female,39.0,FALSE
685,2022-03-22 01:34:15,19,en,1961698962,2022-03-22 01:26:41,2022-03-22 01:34:15,Y,Y,A1,,,7,,,,,,,,,,,,,,,,,,,,,,,,,,,,,,,,,8,,,,,,,,,,,,,,,,,,,,,,,,,,,,,,,,,4,,,,,,,,,,,,,,,,,,,,,,,,,,,,,,,,,12,,,,,,,,,,,,,,,,,,,,,,,,,,,,,,,,,10,,,,,,,,,,,,,,,,,,,,,,,,,,,,,,,,,13,,,,,,,,,,,,,,,,,,,,,,,,,,,,,,,,,1,2.0,3.0,1.0,6.0,3.0,2.0,6.0,6.0,5.0,2.0,2.0,4.0,2.0,4.0,5.0,5.0,5.0,2.0,3.0,2.0,2.0,2.0,6.0,3.0,2.0,3.0,5.0,2.0,3.0,2.0,3.0,7.0,14,,,,,,,,,,,,,,,,,,,,,,,,,,,,,,,,,11,,,,,,,,,,,,,,,,,,,,,,,,,,,,,,,,,3,,,,,,,,,,,,,,,,,,,,,,,,,,,,,,,,,2,5.0,5.0,5.0,2.0,5.0,5.0,2.0,6.0,6.0,5.0,5.0,6.0,3.0,6.0,5.0,2.0,5.0,4.0,5.0,5.0,5.0,5.0,5.0,5.0,6.0,4.0,3.0,5.0,5.0,4.0,5.0,4.0,5,,,,,,,,,,,,,,,,,,,,,,,,,,,,,,,,,0,5.0,6.0,5.0,2.0,3.0,2.0,5.0,5.0,5.0,3.0,2.0,5.0,6.0,3.0,5.0,4.0,6.0,2.0,4.0,2.0,3.0,3.0,3.0,5.0,2.0,5.0,3.0,4.0,3.0,2.0,5.0,6.0,9,,,,,,,,,,,,,,,,,,,,,,,,,,,,,,,,,6,,,,,,,,,,,,,,,,,,,,,,,,,,,,,,,,,"difficult to answer how appealing designs are, as different professional would review this differently",456.8,23.27,,,,5.16,,42.34,,,,,,,,,,,,,,,,,,,,102.15,,,,,,,,,,,,88.43,,,,,,126.56,,,,,,,,,68.89,,APPROVED,Female,52.0,FALSE
686,2022-03-22 01:33:18,19,en,1693959422,2022-03-22 01:26:41,2022-03-22 01:33:18,Y,Y,A1,,,13,,,,,,,,,,,,,,,,,,,,,,,,,,,,,,,,,0,3.0,2.0,4.0,6.0,5.0,6.0,3.0,6.0,2.0,3.0,3.0,3.0,3.0,3.0,3.0,5.0,3.0,3.0,5.0,5.0,4.0,5.0,6.0,5.0,5.0,6.0,2.0,4.0,4.0,4.0,6.0,2.0,6,,,,,,,,,,,,,,,,,,,,,,,,,,,,,,,,,12,,,,,,,,,,,,,,,,,,,,,,,,,,,,,,,,,5,,,,,,,,,,,,,,,,,,,,,,,,,,,,,,,,,7,,,,,,,,,,,,,,,,,,,,,,,,,,,,,,,,,14,,,,,,,,,,,,,,,,,,,,,,,,,,,,,,,,,3,,,,,,,,,,,,,,,,,,,,,,,,,,,,,,,,,8,,,,,,,,,,,,,,,,,,,,,,,,,,,,,,,,,1,6.0,6.0,5.0,3.0,6.0,2.0,6.0,4.0,6.0,4.0,5.0,4.0,5.0,5.0,6.0,4.0,7.0,6.0,6.0,4.0,4.0,4.0,2.0,5.0,6.0,2.0,6.0,5.0,4.0,3.0,5.0,3.0,2,6.0,6.0,5.0,4.0,5.0,2.0,7.0,6.0,6.0,6.0,2.0,5.0,6.0,5.0,5.0,6.0,6.0,4.0,6.0,6.0,2.0,6.0,4.0,5.0,6.0,3.0,4.0,5.0,5.0,4.0,6.0,4.0,11,,,,,,,,,,,,,,,,,,,,,,,,,,,,,,,,,10,,,,,,,,,,,,,,,,,,,,,,,,,,,,,,,,,9,,,,,,,,,,,,,,,,,,,,,,,,,,,,,,,,,4,,,,,,,,,,,,,,,,,,,,,,,,,,,,,,,,,,400.58,43.24,,,,13.32,,50.38,,,,,89.58,,,,,,,,,,,,,,,,,,,,,,,,103.32,,,86.11,,,,,,,,,,,,,,,14.63,,APPROVED,Female,23.0,FALSE
688,2022-03-22 01:31:54,19,en,1847926733,2022-03-22 01:26:41,2022-03-22 01:31:54,Y,Y,A1,,,8,,,,,,,,,,,,,,,,,,,,,,,,,,,,,,,,,0,5.0,5.0,5.0,6.0,5.0,7.0,2.0,7.0,3.0,5.0,6.0,7.0,5.0,2.0,3.0,5.0,5.0,5.0,4.0,5.0,2.0,6.0,7.0,5.0,5.0,7.0,3.0,6.0,6.0,6.0,7.0,2.0,11,,,,,,,,,,,,,,,,,,,,,,,,,,,,,,,,,7,,,,,,,,,,,,,,,,,,,,,,,,,,,,,,,,,2,2.0,2.0,2.0,6.0,3.0,3.0,7.0,5.0,6.0,3.0,5.0,1.0,3.0,3.0,3.0,2.0,2.0,3.0,3.0,3.0,3.0,2.0,2.0,3.0,3.0,5.0,5.0,3.0,5.0,3.0,2.0,5.0,5,,,,,,,,,,,,,,,,,,,,,,,,,,,,,,,,,3,,,,,,,,,,,,,,,,,,,,,,,,,,,,,,,,,14,,,,,,,,,,,,,,,,,,,,,,,,,,,,,,,,,6,,,,,,,,,,,,,,,,,,,,,,,,,,,,,,,,,9,,,,,,,,,,,,,,,,,,,,,,,,,,,,,,,,,10,,,,,,,,,,,,,,,,,,,,,,,,,,,,,,,,,4,,,,,,,,,,,,,,,,,,,,,,,,,,,,,,,,,13,,,,,,,,,,,,,,,,,,,,,,,,,,,,,,,,,1,3.0,5.0,2.0,3.0,2.0,2.0,5.0,2.0,5.0,3.0,2.0,5.0,3.0,6.0,5.0,1.0,6.0,3.0,3.0,3.0,2.0,3.0,3.0,3.0,2.0,5.0,6.0,3.0,2.0,3.0,3.0,7.0,12,,,,,,,,,,,,,,,,,,,,,,,,,,,,,,,,,,317.04,16.76,,,,6.76,,29.06,,,,,99.82,,,,,,,,,86.19,,,,,,,,,,,,,,,,,,,,,,,,,,,75.65,,,,,,2.8,,APPROVED,Male,23.0,FALSE
689,2022-03-22 01:32:32,19,en,335659689,2022-03-22 01:26:41,2022-03-22 01:32:31,Y,Y,A1,,,10,,,,,,,,,,,,,,,,,,,,,,,,,,,,,,,,,2,7.0,7.0,6.0,7.0,7.0,7.0,3.0,7.0,7.0,5.0,7.0,7.0,6.0,6.0,7.0,7.0,6.0,7.0,6.0,7.0,5.0,6.0,6.0,7.0,6.0,7.0,4.0,6.0,6.0,5.0,6.0,2.0,9,,,,,,,,,,,,,,,,,,,,,,,,,,,,,,,,,13,,,,,,,,,,,,,,,,,,,,,,,,,,,,,,,,,1,3.0,6.0,5.0,5.0,6.0,1.0,6.0,7.0,6.0,2.0,6.0,5.0,3.0,4.0,2.0,5.0,4.0,3.0,6.0,2.0,4.0,7.0,4.0,6.0,6.0,7.0,5.0,2.0,3.0,2.0,4.0,5.0,14,,,,,,,,,,,,,,,,,,,,,,,,,,,,,,,,,11,,,,,,,,,,,,,,,,,,,,,,,,,,,,,,,,,4,,,,,,,,,,,,,,,,,,,,,,,,,,,,,,,,,8,,,,,,,,,,,,,,,,,,,,,,,,,,,,,,,,,12,,,,,,,,,,,,,,,,,,,,,,,,,,,,,,,,,3,,,,,,,,,,,,,,,,,,,,,,,,,,,,,,,,,7,,,,,,,,,,,,,,,,,,,,,,,,,,,,,,,,,5,,,,,,,,,,,,,,,,,,,,,,,,,,,,,,,,,0,4.0,7.0,5.0,6.0,2.0,3.0,4.0,6.0,6.0,2.0,1.0,6.0,2.0,1.0,2.0,6.0,6.0,6.0,3.0,1.0,3.0,6.0,2.0,5.0,2.0,4.0,6.0,5.0,4.0,2.0,4.0,7.0,6,,,,,,,,,,,,,,,,,,,,,,,,,,,,,,,,,,355.06,27.21,,,,7.85,,42.35,,,,,89.82,,,,,,,,,74.65,,,,,,,,,,,,,,,,,,,,,,,,,,,109.18,,,,,,4.0,,APPROVED,Female,21.0,FALSE
690,2022-03-22 01:37:05,19,en,452814099,2022-03-22 01:26:50,2022-03-22 01:37:05,Y,Y,A1,,,11,,,,,,,,,,,,,,,,,,,,,,,,,,,,,,,,,9,,,,,,,,,,,,,,,,,,,,,,,,,,,,,,,,,8,,,,,,,,,,,,,,,,,,,,,,,,,,,,,,,,,14,,,,,,,,,,,,,,,,,,,,,,,,,,,,,,,,,1,3.0,2.0,2.0,3.0,2.0,1.0,5.0,3.0,3.0,2.0,2.0,2.0,2.0,2.0,2.0,2.0,4.0,1.0,2.0,2.0,1.0,2.0,2.0,1.0,3.0,1.0,6.0,1.0,1.0,2.0,1.0,5.0,7,,,,,,,,,,,,,,,,,,,,,,,,,,,,,,,,,6,,,,,,,,,,,,,,,,,,,,,,,,,,,,,,,,,12,,,,,,,,,,,,,,,,,,,,,,,,,,,,,,,,,10,,,,,,,,,,,,,,,,,,,,,,,,,,,,,,,,,4,,,,,,,,,,,,,,,,,,,,,,,,,,,,,,,,,2,3.0,4.0,3.0,6.0,3.0,6.0,5.0,5.0,5.0,3.0,3.0,5.0,3.0,3.0,6.0,4.0,3.0,5.0,4.0,4.0,2.0,2.0,6.0,3.0,3.0,4.0,3.0,4.0,4.0,4.0,3.0,4.0,5,,,,,,,,,,,,,,,,,,,,,,,,,,,,,,,,,3,,,,,,,,,,,,,,,,,,,,,,,,,,,,,,,,,0,6.0,7.0,6.0,6.0,6.0,7.0,2.0,7.0,7.0,6.0,6.0,6.0,6.0,5.0,7.0,5.0,7.0,7.0,5.0,6.0,6.0,6.0,7.0,5.0,7.0,7.0,5.0,6.0,5.0,6.0,6.0,7.0,13,,,,,,,,,,,,,,,,,,,,,,,,,,,,,,,,,The information must flow when you have diagrams and there must be attractive colours. The survey was nice and short.,618.85,51.81,,,,9.58,,60.7,,,,,,,,,,,,,,140.97,,,,,,,,,,,,,,,,,,154.16,,,,,,,,,124.78,,,,,,76.85,,APPROVED,Female,24.0,FALSE
692,2022-03-22 01:33:38,19,en,295074408,2022-03-22 01:27:08,2022-03-22 01:33:38,Y,Y,A1,,,9,,,,,,,,,,,,,,,,,,,,,,,,,,,,,,,,,6,,,,,,,,,,,,,,,,,,,,,,,,,,,,,,,,,0,6.0,4.0,5.0,3.0,7.0,2.0,3.0,5.0,3.0,3.0,4.0,4.0,4.0,6.0,1.0,2.0,4.0,7.0,5.0,3.0,5.0,3.0,3.0,4.0,5.0,6.0,7.0,6.0,7.0,4.0,5.0,3.0,3,,,,,,,,,,,,,,,,,,,,,,,,,,,,,,,,,7,,,,,,,,,,,,,,,,,,,,,,,,,,,,,,,,,2,4.0,4.0,6.0,5.0,5.0,5.0,6.0,6.0,5.0,5.0,6.0,6.0,5.0,4.0,5.0,4.0,4.0,4.0,6.0,4.0,3.0,7.0,5.0,5.0,5.0,4.0,4.0,7.0,3.0,4.0,7.0,6.0,8,,,,,,,,,,,,,,,,,,,,,,,,,,,,,,,,,10,,,,,,,,,,,,,,,,,,,,,,,,,,,,,,,,,5,,,,,,,,,,,,,,,,,,,,,,,,,,,,,,,,,1,4.0,5.0,3.0,5.0,5.0,7.0,4.0,6.0,6.0,4.0,5.0,5.0,4.0,5.0,6.0,4.0,5.0,7.0,4.0,4.0,6.0,6.0,7.0,5.0,5.0,3.0,6.0,4.0,5.0,6.0,4.0,3.0,13,,,,,,,,,,,,,,,,,,,,,,,,,,,,,,,,,14,,,,,,,,,,,,,,,,,,,,,,,,,,,,,,,,,4,,,,,,,,,,,,,,,,,,,,,,,,,,,,,,,,,12,,,,,,,,,,,,,,,,,,,,,,,,,,,,,,,,,11,,,,,,,,,,,,,,,,,,,,,,,,,,,,,,,,,I really enjoyed the survey. ,393.74,18.9,,,,9.12,,39.47,,,,,,,,115.38,,,,,,,,,66.79,,,,,,,,,,,,69.12,,,,,,,,,,,,,,,,,,74.96,,APPROVED,Male,24.0,FALSE
693,2022-03-22 01:33:08,19,en,1300117470,2022-03-22 01:27:24,2022-03-22 01:33:08,Y,Y,A1,,,12,,,,,,,,,,,,,,,,,,,,,,,,,,,,,,,,,8,,,,,,,,,,,,,,,,,,,,,,,,,,,,,,,,,7,,,,,,,,,,,,,,,,,,,,,,,,,,,,,,,,,10,,,,,,,,,,,,,,,,,,,,,,,,,,,,,,,,,4,,,,,,,,,,,,,,,,,,,,,,,,,,,,,,,,,3,,,,,,,,,,,,,,,,,,,,,,,,,,,,,,,,,0,3.0,5.0,4.0,3.0,3.0,2.0,7.0,5.0,5.0,3.0,3.0,5.0,2.0,5.0,5.0,2.0,5.0,3.0,4.0,4.0,3.0,5.0,2.0,3.0,3.0,3.0,5.0,2.0,3.0,4.0,3.0,7.0,14,,,,,,,,,,,,,,,,,,,,,,,,,,,,,,,,,6,,,,,,,,,,,,,,,,,,,,,,,,,,,,,,,,,11,,,,,,,,,,,,,,,,,,,,,,,,,,,,,,,,,1,5.0,6.0,5.0,5.0,6.0,6.0,3.0,6.0,6.0,5.0,6.0,6.0,6.0,5.0,5.0,5.0,6.0,6.0,6.0,5.0,5.0,5.0,6.0,6.0,6.0,5.0,5.0,6.0,6.0,5.0,6.0,4.0,5,,,,,,,,,,,,,,,,,,,,,,,,,,,,,,,,,13,,,,,,,,,,,,,,,,,,,,,,,,,,,,,,,,,9,,,,,,,,,,,,,,,,,,,,,,,,,,,,,,,,,2,3.0,5.0,4.0,3.0,3.0,2.0,7.0,5.0,4.0,3.0,3.0,3.0,3.0,4.0,3.0,3.0,5.0,3.0,5.0,3.0,3.0,3.0,1.0,3.0,3.0,3.0,3.0,2.0,3.0,3.0,3.0,1.0,,348.32,21.05,,,,4.87,,37.93,,,,,,,,,,,,,,,,,,,,113.83,,,,,,,,,,,,62.76,,,,,,,,,,,,98.11,,,9.77,,APPROVED,Female,43.0,FALSE
694,2022-03-22 01:38:24,19,en,1426048437,2022-03-22 01:27:38,2022-03-22 01:38:24,Y,Y,A1,,,7,,,,,,,,,,,,,,,,,,,,,,,,,,,,,,,,,5,,,,,,,,,,,,,,,,,,,,,,,,,,,,,,,,,6,,,,,,,,,,,,,,,,,,,,,,,,,,,,,,,,,11,,,,,,,,,,,,,,,,,,,,,,,,,,,,,,,,,9,,,,,,,,,,,,,,,,,,,,,,,,,,,,,,,,,0,7.0,7.0,7.0,6.0,7.0,3.0,7.0,6.0,7.0,6.0,6.0,5.0,7.0,6.0,7.0,6.0,5.0,3.0,7.0,6.0,6.0,7.0,2.0,6.0,7.0,3.0,2.0,6.0,6.0,4.0,4.0,6.0,14,,,,,,,,,,,,,,,,,,,,,,,,,,,,,,,,,3,,,,,,,,,,,,,,,,,,,,,,,,,,,,,,,,,4,,,,,,,,,,,,,,,,,,,,,,,,,,,,,,,,,13,,,,,,,,,,,,,,,,,,,,,,,,,,,,,,,,,1,6.0,7.0,5.0,5.0,5.0,5.0,5.0,6.0,7.0,5.0,5.0,4.0,6.0,6.0,6.0,6.0,6.0,5.0,5.0,6.0,4.0,6.0,5.0,5.0,6.0,2.0,2.0,5.0,3.0,5.0,3.0,4.0,12,,,,,,,,,,,,,,,,,,,,,,,,,,,,,,,,,10,,,,,,,,,,,,,,,,,,,,,,,,,,,,,,,,,8,,,,,,,,,,,,,,,,,,,,,,,,,,,,,,,,,2,2.0,6.0,3.0,2.0,4.0,1.0,7.0,3.0,6.0,2.0,2.0,2.0,3.0,2.0,5.0,3.0,3.0,2.0,3.0,3.0,2.0,3.0,1.0,2.0,2.0,1.0,4.0,2.0,3.0,2.0,1.0,1.0,,648.81,108.22,,,,9.6,,41.31,,,,,,,,,,,,,,,,,244.07,,,,,,,,,,,,,,,113.28,,,,,,,,,,,,124.61,,,7.72,,APPROVED,Male,31.0,FALSE
695,2022-03-22 01:37:25,19,en,2024159267,2022-03-22 01:29:56,2022-03-22 01:37:25,Y,Y,-oth-,A Levels (or equivalent),,3,,,,,,,,,,,,,,,,,,,,,,,,,,,,,,,,,2,6.0,2.0,5.0,6.0,5.0,6.0,2.0,7.0,2.0,5.0,4.0,6.0,6.0,5.0,6.0,6.0,7.0,6.0,6.0,5.0,6.0,6.0,6.0,6.0,5.0,6.0,6.0,5.0,6.0,6.0,6.0,2.0,13,,,,,,,,,,,,,,,,,,,,,,,,,,,,,,,,,1,5.0,6.0,5.0,4.0,4.0,3.0,6.0,5.0,5.0,3.0,3.0,6.0,5.0,5.0,5.0,4.0,6.0,3.0,4.0,3.0,5.0,3.0,3.0,4.0,5.0,4.0,6.0,3.0,6.0,4.0,4.0,4.0,5,,,,,,,,,,,,,,,,,,,,,,,,,,,,,,,,,8,,,,,,,,,,,,,,,,,,,,,,,,,,,,,,,,,14,,,,,,,,,,,,,,,,,,,,,,,,,,,,,,,,,9,,,,,,,,,,,,,,,,,,,,,,,,,,,,,,,,,11,,,,,,,,,,,,,,,,,,,,,,,,,,,,,,,,,0,5.0,7.0,4.0,2.0,5.0,2.0,5.0,2.0,6.0,3.0,2.0,6.0,5.0,6.0,6.0,2.0,6.0,5.0,5.0,2.0,5.0,4.0,3.0,4.0,4.0,4.0,6.0,3.0,4.0,5.0,4.0,3.0,10,,,,,,,,,,,,,,,,,,,,,,,,,,,,,,,,,4,,,,,,,,,,,,,,,,,,,,,,,,,,,,,,,,,7,,,,,,,,,,,,,,,,,,,,,,,,,,,,,,,,,6,,,,,,,,,,,,,,,,,,,,,,,,,,,,,,,,,12,,,,,,,,,,,,,,,,,,,,,,,,,,,,,,,,,No comments.,451.2,20.39,,,,43.83,,33.67,,,,,93.15,,,,,,118.39,,,,,,,,,,,,,,,,,,134.44,,,,,,,,,,,,,,,,,,7.33,,APPROVED,Male,27.0,FALSE
696,2022-03-22 01:38:56,19,en,1309324929,2022-03-22 01:32:32,2022-03-22 01:38:56,Y,Y,A1,,,0,3.0,6.0,2.0,3.0,2.0,2.0,7.0,5.0,7.0,2.0,2.0,3.0,3.0,5.0,5.0,2.0,6.0,3.0,3.0,3.0,4.0,3.0,1.0,2.0,2.0,2.0,7.0,2.0,3.0,2.0,3.0,1.0,12,,,,,,,,,,,,,,,,,,,,,,,,,,,,,,,,,10,,,,,,,,,,,,,,,,,,,,,,,,,,,,,,,,,8,,,,,,,,,,,,,,,,,,,,,,,,,,,,,,,,,14,,,,,,,,,,,,,,,,,,,,,,,,,,,,,,,,,4,,,,,,,,,,,,,,,,,,,,,,,,,,,,,,,,,11,,,,,,,,,,,,,,,,,,,,,,,,,,,,,,,,,1,5.0,5.0,5.0,4.0,4.0,3.0,6.0,3.0,6.0,5.0,3.0,5.0,5.0,5.0,5.0,3.0,6.0,5.0,5.0,4.0,4.0,5.0,3.0,4.0,5.0,2.0,6.0,5.0,3.0,5.0,3.0,1.0,2,5.0,5.0,4.0,5.0,4.0,5.0,3.0,4.0,6.0,4.0,5.0,5.0,4.0,5.0,5.0,5.0,5.0,4.0,5.0,3.0,4.0,4.0,5.0,4.0,3.0,6.0,6.0,4.0,6.0,5.0,5.0,2.0,6,,,,,,,,,,,,,,,,,,,,,,,,,,,,,,,,,13,,,,,,,,,,,,,,,,,,,,,,,,,,,,,,,,,9,,,,,,,,,,,,,,,,,,,,,,,,,,,,,,,,,3,,,,,,,,,,,,,,,,,,,,,,,,,,,,,,,,,7,,,,,,,,,,,,,,,,,,,,,,,,,,,,,,,,,5,,,,,,,,,,,,,,,,,,,,,,,,,,,,,,,,,,386.84,42.67,,,,4.13,,24.29,,73.66,,,,,,,,,,,,,,,,,,,,,108.38,,,130.4,,,,,,,,,,,,,,,,,,,,,3.31,,APPROVED,Female,28.0,FALSE
697,2022-03-22 01:43:28,19,en,1202886552,2022-03-22 01:37:56,2022-03-22 01:43:28,Y,Y,A1,,,10,,,,,,,,,,,,,,,,,,,,,,,,,,,,,,,,,9,,,,,,,,,,,,,,,,,,,,,,,,,,,,,,,,,12,,,,,,,,,,,,,,,,,,,,,,,,,,,,,,,,,8,,,,,,,,,,,,,,,,,,,,,,,,,,,,,,,,,11,,,,,,,,,,,,,,,,,,,,,,,,,,,,,,,,,1,6.0,1.0,1.0,1.0,1.0,3.0,1.0,5.0,5.0,4.0,1.0,1.0,1.0,1.0,1.0,1.0,6.0,3.0,4.0,2.0,1.0,4.0,5.0,2.0,2.0,7.0,1.0,1.0,1.0,1.0,4.0,6.0,13,,,,,,,,,,,,,,,,,,,,,,,,,,,,,,,,,5,,,,,,,,,,,,,,,,,,,,,,,,,,,,,,,,,14,,,,,,,,,,,,,,,,,,,,,,,,,,,,,,,,,3,,,,,,,,,,,,,,,,,,,,,,,,,,,,,,,,,7,,,,,,,,,,,,,,,,,,,,,,,,,,,,,,,,,2,4.0,4.0,5.0,3.0,4.0,3.0,4.0,4.0,5.0,4.0,1.0,4.0,4.0,4.0,3.0,1.0,5.0,3.0,5.0,4.0,5.0,5.0,3.0,4.0,4.0,1.0,5.0,1.0,1.0,1.0,2.0,5.0,6,,,,,,,,,,,,,,,,,,,,,,,,,,,,,,,,,0,1.0,1.0,1.0,1.0,1.0,1.0,1.0,1.0,1.0,1.0,1.0,1.0,1.0,1.0,1.0,1.0,4.0,1.0,1.0,1.0,1.0,1.0,1.0,1.0,1.0,1.0,1.0,1.0,1.0,1.0,1.0,7.0,4,,,,,,,,,,,,,,,,,,,,,,,,,,,,,,,,,,336.46,14.43,,,,5.06,,37.06,,,,,,,,,,,,,,,,,69.27,,,,,,,,,,,,,,,,,,148.63,,,,,,57.96,,,,,,4.05,,APPROVED,Male,24.0,FALSE
698,2022-03-22 01:45:56,19,en,2147141040,2022-03-22 01:37:59,2022-03-22 01:45:56,Y,Y,A1,,,10,,,,,,,,,,,,,,,,,,,,,,,,,,,,,,,,,14,,,,,,,,,,,,,,,,,,,,,,,,,,,,,,,,,2,5.0,6.0,6.0,5.0,5.0,7.0,4.0,6.0,6.0,5.0,5.0,6.0,5.0,6.0,6.0,7.0,6.0,5.0,5.0,5.0,5.0,6.0,6.0,5.0,5.0,4.0,4.0,6.0,6.0,6.0,6.0,3.0,3,,,,,,,,,,,,,,,,,,,,,,,,,,,,,,,,,0,4.0,4.0,3.0,3.0,4.0,3.0,5.0,5.0,4.0,4.0,3.0,3.0,4.0,4.0,3.0,2.0,3.0,3.0,2.0,3.0,3.0,3.0,3.0,3.0,3.0,4.0,3.0,4.0,3.0,4.0,3.0,5.0,13,,,,,,,,,,,,,,,,,,,,,,,,,,,,,,,,,1,4.0,3.0,5.0,4.0,5.0,5.0,3.0,6.0,5.0,5.0,4.0,3.0,4.0,5.0,4.0,4.0,3.0,3.0,3.0,4.0,4.0,4.0,4.0,4.0,5.0,4.0,5.0,4.0,4.0,4.0,4.0,7.0,5,,,,,,,,,,,,,,,,,,,,,,,,,,,,,,,,,4,,,,,,,,,,,,,,,,,,,,,,,,,,,,,,,,,9,,,,,,,,,,,,,,,,,,,,,,,,,,,,,,,,,7,,,,,,,,,,,,,,,,,,,,,,,,,,,,,,,,,6,,,,,,,,,,,,,,,,,,,,,,,,,,,,,,,,,12,,,,,,,,,,,,,,,,,,,,,,,,,,,,,,,,,8,,,,,,,,,,,,,,,,,,,,,,,,,,,,,,,,,11,,,,,,,,,,,,,,,,,,,,,,,,,,,,,,,,,,479.17,43.25,,,,15.39,,104.53,,,,,,,,86.02,,,,,,115.37,,,,,,97.11,,,,,,,,,,,,,,,,,,,,,,,,,,,17.5,,APPROVED,Male,27.0,FALSE
699,2022-03-22 01:44:12,19,en,572825129,2022-03-22 01:38:02,2022-03-22 01:44:12,Y,Y,A1,,,2,2.0,7.0,3.0,2.0,2.0,1.0,1.0,6.0,2.0,2.0,2.0,1.0,2.0,1.0,3.0,2.0,2.0,1.0,2.0,2.0,2.0,1.0,1.0,1.0,2.0,4.0,2.0,2.0,1.0,3.0,2.0,1.0,7,,,,,,,,,,,,,,,,,,,,,,,,,,,,,,,,,12,,,,,,,,,,,,,,,,,,,,,,,,,,,,,,,,,5,,,,,,,,,,,,,,,,,,,,,,,,,,,,,,,,,13,,,,,,,,,,,,,,,,,,,,,,,,,,,,,,,,,3,,,,,,,,,,,,,,,,,,,,,,,,,,,,,,,,,10,,,,,,,,,,,,,,,,,,,,,,,,,,,,,,,,,11,,,,,,,,,,,,,,,,,,,,,,,,,,,,,,,,,0,2.0,2.0,2.0,2.0,2.0,5.0,2.0,1.0,1.0,2.0,3.0,2.0,1.0,1.0,3.0,2.0,2.0,1.0,1.0,2.0,2.0,2.0,2.0,2.0,1.0,7.0,1.0,2.0,2.0,2.0,3.0,2.0,14,,,,,,,,,,,,,,,,,,,,,,,,,,,,,,,,,9,,,,,,,,,,,,,,,,,,,,,,,,,,,,,,,,,1,5.0,7.0,6.0,5.0,6.0,6.0,4.0,1.0,7.0,7.0,7.0,6.0,6.0,6.0,5.0,5.0,7.0,6.0,6.0,3.0,7.0,6.0,6.0,5.0,5.0,7.0,5.0,5.0,6.0,7.0,6.0,5.0,6,,,,,,,,,,,,,,,,,,,,,,,,,,,,,,,,,4,,,,,,,,,,,,,,,,,,,,,,,,,,,,,,,,,8,,,,,,,,,,,,,,,,,,,,,,,,,,,,,,,,,,372.4,17.03,,,,14.13,,121.25,,36.61,,,,,,,,,,,,,,,,,,,,,,,,135.22,,,,,,,,,43.71,,,,,,,,,,,,4.45,,APPROVED,Female,24.0,FALSE
700,2022-03-22 01:41:03,19,en,2076308917,2022-03-22 01:38:02,2022-03-22 01:41:03,Y,Y,A2,,,10,,,,,,,,,,,,,,,,,,,,,,,,,,,,,,,,,1,5.0,5.0,5.0,5.0,5.0,5.0,2.0,5.0,5.0,5.0,5.0,5.0,5.0,5.0,5.0,5.0,5.0,5.0,5.0,5.0,5.0,5.0,5.0,5.0,5.0,5.0,4.0,5.0,5.0,5.0,5.0,2.0,6,,,,,,,,,,,,,,,,,,,,,,,,,,,,,,,,,4,,,,,,,,,,,,,,,,,,,,,,,,,,,,,,,,,2,5.0,5.0,5.0,5.0,5.0,5.0,5.0,5.0,5.0,5.0,5.0,5.0,5.0,5.0,5.0,5.0,5.0,5.0,5.0,5.0,5.0,5.0,5.0,5.0,5.0,5.0,5.0,5.0,3.0,5.0,5.0,5.0,7,,,,,,,,,,,,,,,,,,,,,,,,,,,,,,,,,11,,,,,,,,,,,,,,,,,,,,,,,,,,,,,,,,,13,,,,,,,,,,,,,,,,,,,,,,,,,,,,,,,,,12,,,,,,,,,,,,,,,,,,,,,,,,,,,,,,,,,9,,,,,,,,,,,,,,,,,,,,,,,,,,,,,,,,,14,,,,,,,,,,,,,,,,,,,,,,,,,,,,,,,,,8,,,,,,,,,,,,,,,,,,,,,,,,,,,,,,,,,3,,,,,,,,,,,,,,,,,,,,,,,,,,,,,,,,,5,,,,,,,,,,,,,,,,,,,,,,,,,,,,,,,,,0,6.0,6.0,6.0,5.0,6.0,3.0,5.0,6.0,5.0,5.0,6.0,4.0,5.0,5.0,5.0,5.0,6.0,5.0,5.0,6.0,5.0,6.0,3.0,6.0,6.0,5.0,5.0,6.0,5.0,5.0,5.0,1.0,,183.93,16.45,,,,8.35,,23.55,,,,,39.72,,,,,,,,,34.41,,,,,,,,,,,,,,,,,,,,,,,,,,,,,,58.83,,,2.62,,APPROVED,Male,23.0,FALSE
701,2022-03-22 01:46:05,19,en,803023262,2022-03-22 01:38:03,2022-03-22 01:46:05,Y,Y,A1,,,9,,,,,,,,,,,,,,,,,,,,,,,,,,,,,,,,,0,4.0,3.0,5.0,5.0,4.0,6.0,2.0,5.0,4.0,4.0,5.0,4.0,5.0,4.0,4.0,4.0,5.0,4.0,5.0,4.0,3.0,5.0,6.0,5.0,4.0,5.0,3.0,5.0,4.0,5.0,5.0,2.0,14,,,,,,,,,,,,,,,,,,,,,,,,,,,,,,,,,8,,,,,,,,,,,,,,,,,,,,,,,,,,,,,,,,,2,2.0,3.0,2.0,3.0,2.0,3.0,6.0,4.0,3.0,2.0,3.0,4.0,2.0,3.0,2.0,2.0,3.0,2.0,2.0,2.0,2.0,3.0,4.0,2.0,2.0,4.0,3.0,2.0,4.0,3.0,2.0,5.0,1,4.0,5.0,5.0,3.0,5.0,3.0,5.0,4.0,6.0,4.0,3.0,5.0,4.0,5.0,5.0,3.0,5.0,3.0,4.0,4.0,3.0,4.0,3.0,4.0,5.0,4.0,6.0,4.0,5.0,4.0,3.0,6.0,5,,,,,,,,,,,,,,,,,,,,,,,,,,,,,,,,,4,,,,,,,,,,,,,,,,,,,,,,,,,,,,,,,,,13,,,,,,,,,,,,,,,,,,,,,,,,,,,,,,,,,11,,,,,,,,,,,,,,,,,,,,,,,,,,,,,,,,,10,,,,,,,,,,,,,,,,,,,,,,,,,,,,,,,,,7,,,,,,,,,,,,,,,,,,,,,,,,,,,,,,,,,3,,,,,,,,,,,,,,,,,,,,,,,,,,,,,,,,,12,,,,,,,,,,,,,,,,,,,,,,,,,,,,,,,,,6,,,,,,,,,,,,,,,,,,,,,,,,,,,,,,,,,,485.69,78.44,,,,7.16,,45.87,,,,,122.69,,,,,,,,,100.35,,,124.76,,,,,,,,,,,,,,,,,,,,,,,,,,,,,,6.42,,APPROVED,Male,37.0,FALSE
702,2022-03-22 01:43:56,19,en,1755091261,2022-03-22 01:38:03,2022-03-22 01:43:56,Y,Y,A2,,,5,,,,,,,,,,,,,,,,,,,,,,,,,,,,,,,,,3,,,,,,,,,,,,,,,,,,,,,,,,,,,,,,,,,13,,,,,,,,,,,,,,,,,,,,,,,,,,,,,,,,,12,,,,,,,,,,,,,,,,,,,,,,,,,,,,,,,,,4,,,,,,,,,,,,,,,,,,,,,,,,,,,,,,,,,7,,,,,,,,,,,,,,,,,,,,,,,,,,,,,,,,,11,,,,,,,,,,,,,,,,,,,,,,,,,,,,,,,,,9,,,,,,,,,,,,,,,,,,,,,,,,,,,,,,,,,10,,,,,,,,,,,,,,,,,,,,,,,,,,,,,,,,,8,,,,,,,,,,,,,,,,,,,,,,,,,,,,,,,,,0,2.0,6.0,2.0,4.0,2.0,5.0,5.0,5.0,6.0,3.0,3.0,4.0,4.0,4.0,4.0,5.0,5.0,4.0,5.0,2.0,4.0,3.0,4.0,3.0,2.0,2.0,5.0,3.0,4.0,3.0,3.0,4.0,1,5.0,5.0,5.0,4.0,6.0,5.0,4.0,5.0,5.0,5.0,5.0,5.0,5.0,5.0,5.0,5.0,5.0,6.0,5.0,5.0,4.0,5.0,4.0,5.0,6.0,6.0,3.0,5.0,5.0,4.0,3.0,5.0,2,2.0,2.0,3.0,4.0,3.0,3.0,4.0,5.0,5.0,4.0,3.0,3.0,4.0,4.0,3.0,4.0,5.0,4.0,5.0,2.0,3.0,4.0,5.0,4.0,2.0,6.0,4.0,4.0,4.0,3.0,5.0,6.0,6,,,,,,,,,,,,,,,,,,,,,,,,,,,,,,,,,14,,,,,,,,,,,,,,,,,,,,,,,,,,,,,,,,,,357.16,24.32,,,,5.11,,43.81,,,,,,,,,,,,,,,,,,,,,,,,,,,,,,,,106.37,,,81.95,,,90.97,,,,,,,,,4.63,,APPROVED,Male,34.0,FALSE
703,2022-03-22 01:48:39,19,en,54769534,2022-03-22 01:38:04,2022-03-22 01:48:39,Y,Y,A2,,,14,,,,,,,,,,,,,,,,,,,,,,,,,,,,,,,,,11,,,,,,,,,,,,,,,,,,,,,,,,,,,,,,,,,5,,,,,,,,,,,,,,,,,,,,,,,,,,,,,,,,,2,5.0,5.0,5.0,5.0,6.0,4.0,4.0,6.0,5.0,3.0,5.0,3.0,5.0,3.0,4.0,4.0,4.0,3.0,5.0,4.0,3.0,3.0,5.0,4.0,4.0,4.0,3.0,3.0,3.0,3.0,4.0,4.0,0,2.0,2.0,2.0,2.0,2.0,2.0,6.0,5.0,4.0,2.0,1.0,2.0,2.0,2.0,3.0,1.0,4.0,2.0,1.0,2.0,2.0,2.0,1.0,2.0,1.0,4.0,2.0,2.0,3.0,2.0,3.0,5.0,3,,,,,,,,,,,,,,,,,,,,,,,,,,,,,,,,,9,,,,,,,,,,,,,,,,,,,,,,,,,,,,,,,,,7,,,,,,,,,,,,,,,,,,,,,,,,,,,,,,,,,6,,,,,,,,,,,,,,,,,,,,,,,,,,,,,,,,,1,2.0,2.0,2.0,2.0,2.0,2.0,5.0,1.0,2.0,2.0,4.0,2.0,2.0,2.0,2.0,2.0,2.0,2.0,2.0,2.0,2.0,2.0,1.0,1.0,2.0,1.0,2.0,2.0,2.0,2.0,1.0,3.0,13,,,,,,,,,,,,,,,,,,,,,,,,,,,,,,,,,10,,,,,,,,,,,,,,,,,,,,,,,,,,,,,,,,,8,,,,,,,,,,,,,,,,,,,,,,,,,,,,,,,,,4,,,,,,,,,,,,,,,,,,,,,,,,,,,,,,,,,12,,,,,,,,,,,,,,,,,,,,,,,,,,,,,,,,,,639.39,302.47,,,,17.84,,23.52,,,,,,,,,,,85.96,,,103.28,,,,,,,,,,,,,,,102.73,,,,,,,,,,,,,,,,,,3.59,,APPROVED,Male,25.0,FALSE
704,2022-03-22 01:41:20,19,en,280310517,2022-03-22 01:38:06,2022-03-22 01:41:20,Y,Y,A2,,,11,,,,,,,,,,,,,,,,,,,,,,,,,,,,,,,,,6,,,,,,,,,,,,,,,,,,,,,,,,,,,,,,,,,0,5.0,5.0,5.0,5.0,5.0,4.0,4.0,5.0,5.0,5.0,5.0,5.0,5.0,5.0,5.0,5.0,5.0,5.0,5.0,5.0,5.0,5.0,4.0,5.0,5.0,5.0,4.0,5.0,5.0,5.0,5.0,1.0,9,,,,,,,,,,,,,,,,,,,,,,,,,,,,,,,,,14,,,,,,,,,,,,,,,,,,,,,,,,,,,,,,,,,13,,,,,,,,,,,,,,,,,,,,,,,,,,,,,,,,,3,,,,,,,,,,,,,,,,,,,,,,,,,,,,,,,,,10,,,,,,,,,,,,,,,,,,,,,,,,,,,,,,,,,7,,,,,,,,,,,,,,,,,,,,,,,,,,,,,,,,,4,,,,,,,,,,,,,,,,,,,,,,,,,,,,,,,,,1,5.0,5.0,5.0,5.0,5.0,5.0,5.0,5.0,5.0,5.0,5.0,5.0,5.0,5.0,5.0,5.0,5.0,5.0,5.0,5.0,5.0,5.0,5.0,5.0,5.0,5.0,5.0,5.0,5.0,5.0,5.0,4.0,12,,,,,,,,,,,,,,,,,,,,,,,,,,,,,,,,,2,5.0,5.0,5.0,5.0,5.0,5.0,3.0,5.0,5.0,5.0,5.0,5.0,5.0,5.0,4.0,5.0,5.0,5.0,5.0,4.0,5.0,5.0,5.0,5.0,5.0,5.0,4.0,5.0,4.0,5.0,5.0,6.0,5,,,,,,,,,,,,,,,,,,,,,,,,,,,,,,,,,8,,,,,,,,,,,,,,,,,,,,,,,,,,,,,,,,,,196.18,10.32,,,,5.61,,44.52,,,,,,,,45.44,,,,,,,,,,,,,,,,,,,,,,,,40.98,,,,,,47.08,,,,,,,,,2.23,,APPROVED,Female,25.0,FALSE
706,2022-03-22 01:49:53,19,en,1877819216,2022-03-22 01:38:06,2022-03-22 01:49:53,Y,Y,-oth-,High School Certificate,,9,,,,,,,,,,,,,,,,,,,,,,,,,,,,,,,,,1,6.0,4.0,7.0,7.0,5.0,6.0,2.0,6.0,5.0,5.0,6.0,7.0,6.0,5.0,5.0,6.0,7.0,5.0,6.0,7.0,5.0,5.0,7.0,6.0,6.0,7.0,5.0,6.0,7.0,6.0,7.0,2.0,8,,,,,,,,,,,,,,,,,,,,,,,,,,,,,,,,,2,6.0,7.0,5.0,4.0,6.0,3.0,7.0,6.0,7.0,6.0,5.0,6.0,5.0,4.0,7.0,5.0,6.0,5.0,5.0,5.0,5.0,6.0,3.0,6.0,6.0,3.0,6.0,5.0,6.0,5.0,3.0,4.0,10,,,,,,,,,,,,,,,,,,,,,,,,,,,,,,,,,5,,,,,,,,,,,,,,,,,,,,,,,,,,,,,,,,,6,,,,,,,,,,,,,,,,,,,,,,,,,,,,,,,,,12,,,,,,,,,,,,,,,,,,,,,,,,,,,,,,,,,11,,,,,,,,,,,,,,,,,,,,,,,,,,,,,,,,,0,2.0,4.0,1.0,2.0,2.0,1.0,6.0,2.0,4.0,2.0,2.0,3.0,2.0,4.0,5.0,2.0,5.0,2.0,2.0,1.0,4.0,2.0,1.0,2.0,2.0,5.0,5.0,3.0,5.0,4.0,3.0,3.0,13,,,,,,,,,,,,,,,,,,,,,,,,,,,,,,,,,3,,,,,,,,,,,,,,,,,,,,,,,,,,,,,,,,,14,,,,,,,,,,,,,,,,,,,,,,,,,,,,,,,,,7,,,,,,,,,,,,,,,,,,,,,,,,,,,,,,,,,4,,,,,,,,,,,,,,,,,,,,,,,,,,,,,,,,,,711.17,226.76,,,,29.72,,63.07,,,,,92.32,,,,,,129.9,,,,,,,,,,,,,,,,,,162.52,,,,,,,,,,,,,,,,,,6.88,,APPROVED,Male,30.0,FALSE
707,2022-03-22 01:43:26,19,en,1200148606,2022-03-22 01:38:07,2022-03-22 01:43:26,Y,Y,A1,,,3,,,,,,,,,,,,,,,,,,,,,,,,,,,,,,,,,4,,,,,,,,,,,,,,,,,,,,,,,,,,,,,,,,,10,,,,,,,,,,,,,,,,,,,,,,,,,,,,,,,,,11,,,,,,,,,,,,,,,,,,,,,,,,,,,,,,,,,9,,,,,,,,,,,,,,,,,,,,,,,,,,,,,,,,,6,,,,,,,,,,,,,,,,,,,,,,,,,,,,,,,,,2,2.0,5.0,2.0,2.0,2.0,6.0,2.0,6.0,5.0,2.0,2.0,2.0,2.0,2.0,2.0,5.0,2.0,2.0,2.0,2.0,2.0,2.0,5.0,2.0,2.0,2.0,4.0,2.0,5.0,2.0,2.0,7.0,5,,,,,,,,,,,,,,,,,,,,,,,,,,,,,,,,,7,,,,,,,,,,,,,,,,,,,,,,,,,,,,,,,,,8,,,,,,,,,,,,,,,,,,,,,,,,,,,,,,,,,0,2.0,2.0,2.0,2.0,2.0,2.0,7.0,6.0,2.0,2.0,2.0,3.0,2.0,2.0,2.0,1.0,5.0,2.0,2.0,2.0,2.0,2.0,1.0,2.0,2.0,2.0,4.0,2.0,2.0,2.0,1.0,4.0,1,6.0,6.0,6.0,7.0,6.0,6.0,4.0,7.0,6.0,6.0,6.0,6.0,6.0,6.0,6.0,6.0,6.0,6.0,6.0,6.0,6.0,6.0,6.0,6.0,6.0,6.0,4.0,7.0,6.0,6.0,5.0,5.0,12,,,,,,,,,,,,,,,,,,,,,,,,,,,,,,,,,13,,,,,,,,,,,,,,,,,,,,,,,,,,,,,,,,,14,,,,,,,,,,,,,,,,,,,,,,,,,,,,,,,,,,323.27,17.53,,,,5.44,,32.4,,,,,,,,,,,,,,,,,,,,119.87,,,,,,,,,,,,70.79,,,73.61,,,,,,,,,,,,3.63,,APPROVED,Male,49.0,FALSE
709,2022-03-22 01:41:53,19,en,2049711698,2022-03-22 01:38:08,2022-03-22 01:41:53,Y,Y,A1,,,6,,,,,,,,,,,,,,,,,,,,,,,,,,,,,,,,,5,,,,,,,,,,,,,,,,,,,,,,,,,,,,,,,,,7,,,,,,,,,,,,,,,,,,,,,,,,,,,,,,,,,14,,,,,,,,,,,,,,,,,,,,,,,,,,,,,,,,,8,,,,,,,,,,,,,,,,,,,,,,,,,,,,,,,,,10,,,,,,,,,,,,,,,,,,,,,,,,,,,,,,,,,9,,,,,,,,,,,,,,,,,,,,,,,,,,,,,,,,,1,4.0,3.0,6.0,5.0,3.0,3.0,3.0,2.0,6.0,3.0,3.0,5.0,4.0,2.0,5.0,2.0,6.0,5.0,5.0,3.0,4.0,5.0,5.0,3.0,5.0,5.0,3.0,5.0,5.0,3.0,5.0,1.0,0,3.0,2.0,3.0,3.0,1.0,1.0,2.0,1.0,3.0,2.0,3.0,3.0,1.0,2.0,3.0,3.0,2.0,2.0,3.0,1.0,3.0,3.0,1.0,3.0,3.0,1.0,3.0,3.0,3.0,3.0,1.0,2.0,13,,,,,,,,,,,,,,,,,,,,,,,,,,,,,,,,,4,,,,,,,,,,,,,,,,,,,,,,,,,,,,,,,,,11,,,,,,,,,,,,,,,,,,,,,,,,,,,,,,,,,12,,,,,,,,,,,,,,,,,,,,,,,,,,,,,,,,,3,,,,,,,,,,,,,,,,,,,,,,,,,,,,,,,,,2,5.0,7.0,5.0,5.0,5.0,3.0,3.0,6.0,6.0,3.0,3.0,5.0,6.0,5.0,6.0,6.0,6.0,2.0,5.0,3.0,2.0,5.0,1.0,2.0,5.0,5.0,3.0,2.0,5.0,3.0,6.0,1.0,,228.17,18.36,,,,6.07,,18.91,,,,,,,,,,,,,,,,,,,,,,,55.91,,,70.49,,,,,,,,,,,,,,,,,,56.24,,,2.19,,APPROVED,Male,20.0,FALSE
710,2022-03-22 01:42:47,19,en,1962064948,2022-03-22 01:38:09,2022-03-22 01:42:47,Y,Y,A1,,,11,,,,,,,,,,,,,,,,,,,,,,,,,,,,,,,,,6,,,,,,,,,,,,,,,,,,,,,,,,,,,,,,,,,8,,,,,,,,,,,,,,,,,,,,,,,,,,,,,,,,,4,,,,,,,,,,,,,,,,,,,,,,,,,,,,,,,,,5,,,,,,,,,,,,,,,,,,,,,,,,,,,,,,,,,13,,,,,,,,,,,,,,,,,,,,,,,,,,,,,,,,,12,,,,,,,,,,,,,,,,,,,,,,,,,,,,,,,,,10,,,,,,,,,,,,,,,,,,,,,,,,,,,,,,,,,14,,,,,,,,,,,,,,,,,,,,,,,,,,,,,,,,,9,,,,,,,,,,,,,,,,,,,,,,,,,,,,,,,,,7,,,,,,,,,,,,,,,,,,,,,,,,,,,,,,,,,0,6.0,6.0,7.0,3.0,7.0,7.0,2.0,7.0,5.0,4.0,6.0,6.0,7.0,4.0,5.0,6.0,6.0,7.0,6.0,7.0,4.0,5.0,4.0,6.0,7.0,4.0,4.0,6.0,4.0,5.0,6.0,5.0,2,5.0,6.0,5.0,6.0,6.0,6.0,5.0,6.0,6.0,3.0,5.0,7.0,4.0,6.0,7.0,3.0,6.0,5.0,4.0,5.0,4.0,6.0,6.0,4.0,5.0,6.0,7.0,4.0,6.0,5.0,5.0,6.0,1,1.0,5.0,1.0,5.0,3.0,3.0,4.0,5.0,5.0,2.0,3.0,6.0,2.0,2.0,5.0,2.0,4.0,1.0,3.0,2.0,4.0,2.0,5.0,1.0,1.0,6.0,5.0,2.0,5.0,2.0,5.0,7.0,3,,,,,,,,,,,,,,,,,,,,,,,,,,,,,,,,,,281.54,30.74,,,,8.22,,41.38,,,,,,,,,,,,,,,,,,,,,,,,,,,,,,,,,,,64.24,,,66.78,,,65.57,,,,,,4.61,,APPROVED,Female,56.0,FALSE
711,2022-03-22 01:47:48,19,en,901016424,2022-03-22 01:38:10,2022-03-22 01:47:48,Y,Y,A3,,,3,,,,,,,,,,,,,,,,,,,,,,,,,,,,,,,,,13,,,,,,,,,,,,,,,,,,,,,,,,,,,,,,,,,12,,,,,,,,,,,,,,,,,,,,,,,,,,,,,,,,,1,6.0,6.0,6.0,6.0,6.0,5.0,2.0,6.0,6.0,6.0,5.0,6.0,6.0,5.0,6.0,6.0,7.0,6.0,6.0,6.0,6.0,6.0,5.0,6.0,6.0,6.0,6.0,6.0,6.0,6.0,6.0,4.0,6,,,,,,,,,,,,,,,,,,,,,,,,,,,,,,,,,8,,,,,,,,,,,,,,,,,,,,,,,,,,,,,,,,,7,,,,,,,,,,,,,,,,,,,,,,,,,,,,,,,,,10,,,,,,,,,,,,,,,,,,,,,,,,,,,,,,,,,0,1.0,3.0,1.0,2.0,1.0,1.0,6.0,1.0,1.0,2.0,1.0,2.0,1.0,1.0,3.0,1.0,3.0,1.0,1.0,1.0,1.0,1.0,1.0,1.0,2.0,1.0,5.0,1.0,1.0,1.0,1.0,2.0,9,,,,,,,,,,,,,,,,,,,,,,,,,,,,,,,,,4,,,,,,,,,,,,,,,,,,,,,,,,,,,,,,,,,14,,,,,,,,,,,,,,,,,,,,,,,,,,,,,,,,,11,,,,,,,,,,,,,,,,,,,,,,,,,,,,,,,,,2,1.0,3.0,1.0,1.0,2.0,2.0,6.0,5.0,2.0,2.0,1.0,2.0,1.0,2.0,1.0,2.0,5.0,4.0,1.0,1.0,1.0,1.0,2.0,1.0,2.0,4.0,2.0,1.0,1.0,1.0,3.0,7.0,5,,,,,,,,,,,,,,,,,,,,,,,,,,,,,,,,,,581.73,81.22,,,,7.88,,68.48,,,,,,,,,,,105.53,,,,,,,,,,,,,,,125.81,,,,,,,,,,,,,,,184.56,,,,,,8.25,,APPROVED,Female,20.0,FALSE
712,2022-03-22 01:41:24,19,en,1485179942,2022-03-22 01:38:12,2022-03-22 01:41:24,Y,Y,A1,,,9,,,,,,,,,,,,,,,,,,,,,,,,,,,,,,,,,13,,,,,,,,,,,,,,,,,,,,,,,,,,,,,,,,,10,,,,,,,,,,,,,,,,,,,,,,,,,,,,,,,,,1,2.0,2.0,2.0,2.0,2.0,2.0,6.0,2.0,6.0,2.0,5.0,3.0,3.0,3.0,4.0,4.0,3.0,2.0,2.0,4.0,2.0,2.0,2.0,2.0,5.0,7.0,2.0,4.0,1.0,2.0,4.0,4.0,5,,,,,,,,,,,,,,,,,,,,,,,,,,,,,,,,,11,,,,,,,,,,,,,,,,,,,,,,,,,,,,,,,,,14,,,,,,,,,,,,,,,,,,,,,,,,,,,,,,,,,12,,,,,,,,,,,,,,,,,,,,,,,,,,,,,,,,,8,,,,,,,,,,,,,,,,,,,,,,,,,,,,,,,,,3,,,,,,,,,,,,,,,,,,,,,,,,,,,,,,,,,4,,,,,,,,,,,,,,,,,,,,,,,,,,,,,,,,,2,2.0,2.0,1.0,1.0,2.0,1.0,6.0,1.0,2.0,1.0,1.0,1.0,2.0,1.0,1.0,1.0,2.0,2.0,1.0,1.0,2.0,2.0,2.0,2.0,1.0,6.0,2.0,2.0,2.0,2.0,1.0,5.0,7,,,,,,,,,,,,,,,,,,,,,,,,,,,,,,,,,0,5.0,7.0,6.0,6.0,6.0,6.0,2.0,7.0,7.0,7.0,6.0,7.0,6.0,6.0,6.0,6.0,6.0,5.0,7.0,6.0,7.0,7.0,7.0,6.0,6.0,7.0,6.0,6.0,6.0,6.0,7.0,7.0,6,,,,,,,,,,,,,,,,,,,,,,,,,,,,,,,,,,196.34,12.74,,,,7.94,,20.78,,,,,,,,,,,53.88,,,,,,,,,,,,,,,,,,,,,,,,48.89,,,,,,48.49,,,,,,3.62,,APPROVED,Male,27.0,FALSE
713,2022-03-22 01:44:03,19,en,1527482393,2022-03-22 01:38:13,2022-03-22 01:44:03,Y,Y,A1,,,3,,,,,,,,,,,,,,,,,,,,,,,,,,,,,,,,,0,7.0,5.0,6.0,6.0,7.0,7.0,6.0,7.0,4.0,6.0,6.0,6.0,7.0,5.0,5.0,7.0,6.0,6.0,7.0,6.0,4.0,6.0,6.0,6.0,6.0,6.0,4.0,7.0,6.0,6.0,7.0,2.0,4,,,,,,,,,,,,,,,,,,,,,,,,,,,,,,,,,6,,,,,,,,,,,,,,,,,,,,,,,,,,,,,,,,,10,,,,,,,,,,,,,,,,,,,,,,,,,,,,,,,,,7,,,,,,,,,,,,,,,,,,,,,,,,,,,,,,,,,11,,,,,,,,,,,,,,,,,,,,,,,,,,,,,,,,,2,1.0,1.0,1.0,6.0,3.0,3.0,3.0,4.0,3.0,1.0,2.0,3.0,5.0,1.0,2.0,5.0,3.0,1.0,4.0,3.0,2.0,2.0,1.0,5.0,4.0,1.0,3.0,3.0,1.0,4.0,3.0,1.0,9,,,,,,,,,,,,,,,,,,,,,,,,,,,,,,,,,8,,,,,,,,,,,,,,,,,,,,,,,,,,,,,,,,,5,,,,,,,,,,,,,,,,,,,,,,,,,,,,,,,,,12,,,,,,,,,,,,,,,,,,,,,,,,,,,,,,,,,14,,,,,,,,,,,,,,,,,,,,,,,,,,,,,,,,,13,,,,,,,,,,,,,,,,,,,,,,,,,,,,,,,,,1,6.0,7.0,6.0,7.0,6.0,6.0,6.0,7.0,7.0,6.0,6.0,6.0,7.0,7.0,7.0,7.0,7.0,7.0,6.0,6.0,6.0,6.0,6.0,6.0,6.0,6.0,7.0,7.0,6.0,7.0,6.0,1.0,,354.1,52.58,,,,8.22,,30.99,,,,,93.66,,,,,,,,,,,,,,,,,,88.88,,,,,,,,,,,,,,,,,,,,,74.82,,,4.95,,APPROVED,Female,25.0,FALSE
714,2022-03-22 01:43:51,19,en,410061135,2022-03-22 01:38:13,2022-03-22 01:43:51,Y,Y,-oth-,high school,,4,,,,,,,,,,,,,,,,,,,,,,,,,,,,,,,,,11,,,,,,,,,,,,,,,,,,,,,,,,,,,,,,,,,14,,,,,,,,,,,,,,,,,,,,,,,,,,,,,,,,,1,7.0,7.0,7.0,5.0,7.0,5.0,1.0,7.0,7.0,7.0,7.0,7.0,7.0,7.0,7.0,7.0,7.0,7.0,7.0,7.0,7.0,7.0,7.0,7.0,7.0,7.0,1.0,7.0,7.0,6.0,7.0,4.0,9,,,,,,,,,,,,,,,,,,,,,,,,,,,,,,,,,10,,,,,,,,,,,,,,,,,,,,,,,,,,,,,,,,,2,4.0,5.0,3.0,6.0,1.0,5.0,6.0,1.0,4.0,4.0,1.0,4.0,3.0,1.0,2.0,5.0,1.0,3.0,3.0,1.0,4.0,5.0,6.0,3.0,1.0,1.0,1.0,2.0,1.0,6.0,4.0,7.0,7,,,,,,,,,,,,,,,,,,,,,,,,,,,,,,,,,5,,,,,,,,,,,,,,,,,,,,,,,,,,,,,,,,,12,,,,,,,,,,,,,,,,,,,,,,,,,,,,,,,,,8,,,,,,,,,,,,,,,,,,,,,,,,,,,,,,,,,6,,,,,,,,,,,,,,,,,,,,,,,,,,,,,,,,,0,7.0,7.0,7.0,7.0,7.0,7.0,1.0,7.0,7.0,7.0,5.0,7.0,7.0,7.0,7.0,7.0,7.0,7.0,5.0,5.0,6.0,6.0,7.0,7.0,5.0,7.0,1.0,7.0,6.0,7.0,7.0,6.0,13,,,,,,,,,,,,,,,,,,,,,,,,,,,,,,,,,3,,,,,,,,,,,,,,,,,,,,,,,,,,,,,,,,,,343.23,21.73,,,,18.82,,50.57,,,,,,,,,,,70.76,,,,,,,,,79.58,,,,,,,,,,,,,,,,,,98.55,,,,,,,,,3.22,,APPROVED,Female,36.0,FALSE
715,2022-03-22 01:47:39,19,en,781023789,2022-03-22 01:38:13,2022-03-22 01:47:39,Y,Y,-oth-,High School Diploma,,13,,,,,,,,,,,,,,,,,,,,,,,,,,,,,,,,,8,,,,,,,,,,,,,,,,,,,,,,,,,,,,,,,,,10,,,,,,,,,,,,,,,,,,,,,,,,,,,,,,,,,7,,,,,,,,,,,,,,,,,,,,,,,,,,,,,,,,,11,,,,,,,,,,,,,,,,,,,,,,,,,,,,,,,,,0,3.0,6.0,3.0,3.0,6.0,2.0,6.0,5.0,5.0,4.0,5.0,5.0,3.0,6.0,6.0,3.0,6.0,4.0,4.0,5.0,4.0,3.0,3.0,3.0,6.0,3.0,5.0,4.0,5.0,4.0,3.0,6.0,3,,,,,,,,,,,,,,,,,,,,,,,,,,,,,,,,,2,3.0,2.0,2.0,4.0,2.0,5.0,6.0,3.0,3.0,3.0,1.0,3.0,4.0,5.0,4.0,2.0,5.0,3.0,3.0,2.0,3.0,3.0,5.0,3.0,1.0,5.0,3.0,4.0,4.0,3.0,4.0,1.0,12,,,,,,,,,,,,,,,,,,,,,,,,,,,,,,,,,4,,,,,,,,,,,,,,,,,,,,,,,,,,,,,,,,,9,,,,,,,,,,,,,,,,,,,,,,,,,,,,,,,,,14,,,,,,,,,,,,,,,,,,,,,,,,,,,,,,,,,5,,,,,,,,,,,,,,,,,,,,,,,,,,,,,,,,,6,,,,,,,,,,,,,,,,,,,,,,,,,,,,,,,,,1,5.0,6.0,5.0,3.0,5.0,5.0,5.0,5.0,6.0,4.0,5.0,5.0,5.0,5.0,6.0,3.0,6.0,3.0,4.0,5.0,4.0,4.0,2.0,4.0,5.0,5.0,5.0,4.0,6.0,5.0,4.0,1.0,,569.28,79.94,,,,81.57,,43.24,,,,,,,,,,,,,,,,,150.21,,,,,,112.42,,,,,,,,,,,,,,,,,,,,,98.49,,,3.41,,APPROVED,Male,36.0,FALSE
716,2022-03-22 01:42:47,19,en,1637432981,2022-03-22 01:38:14,2022-03-22 01:42:47,Y,Y,A1,,,4,,,,,,,,,,,,,,,,,,,,,,,,,,,,,,,,,12,,,,,,,,,,,,,,,,,,,,,,,,,,,,,,,,,2,6.0,7.0,6.0,5.0,7.0,7.0,4.0,7.0,7.0,7.0,5.0,7.0,6.0,6.0,6.0,6.0,7.0,6.0,7.0,7.0,7.0,7.0,7.0,6.0,7.0,2.0,6.0,7.0,3.0,7.0,3.0,3.0,5,,,,,,,,,,,,,,,,,,,,,,,,,,,,,,,,,13,,,,,,,,,,,,,,,,,,,,,,,,,,,,,,,,,2,1.0,6.0,3.0,2.0,6.0,1.0,1.0,7.0,7.0,1.0,1.0,6.0,5.0,5.0,7.0,1.0,7.0,5.0,6.0,1.0,5.0,1.0,1.0,2.0,6.0,4.0,1.0,1.0,2.0,5.0,1.0,6.0,9,,,,,,,,,,,,,,,,,,,,,,,,,,,,,,,,,6,,,,,,,,,,,,,,,,,,,,,,,,,,,,,,,,,11,,,,,,,,,,,,,,,,,,,,,,,,,,,,,,,,,14,,,,,,,,,,,,,,,,,,,,,,,,,,,,,,,,,10,,,,,,,,,,,,,,,,,,,,,,,,,,,,,,,,,3,,,,,,,,,,,,,,,,,,,,,,,,,,,,,,,,,2,6.0,1.0,7.0,7.0,7.0,6.0,2.0,2.0,7.0,7.0,7.0,7.0,5.0,7.0,7.0,6.0,7.0,6.0,6.0,7.0,7.0,6.0,7.0,7.0,7.0,7.0,6.0,7.0,7.0,7.0,6.0,6.0,8,,,,,,,,,,,,,,,,,,,,,,,,,,,,,,,,,7,,,,,,,,,,,,,,,,,,,,,,,,,,,,,,,,,Everything was perfect. Thank You.,279.78,16.55,,,,6.88,,32.93,,,,,,,,59.44,,,,,,,,,87.82,,,,,,,,,,,,,,,,,,,,,57.16,,,,,,,,,19.0,,APPROVED,Male,22.0,FALSE
718,2022-03-22 01:45:54,19,en,2057820185,2022-03-22 01:38:17,2022-03-22 01:45:54,Y,Y,A1,,,0,3.0,5.0,7.0,1.0,2.0,2.0,5.0,2.0,5.0,1.0,2.0,5.0,1.0,2.0,3.0,1.0,3.0,5.0,2.0,1.0,1.0,2.0,1.0,2.0,4.0,1.0,1.0,1.0,2.0,1.0,2.0,1.0,2,4.0,5.0,5.0,4.0,4.0,5.0,5.0,5.0,5.0,4.0,4.0,5.0,5.0,3.0,4.0,5.0,4.0,5.0,5.0,5.0,4.0,4.0,5.0,5.0,5.0,5.0,5.0,4.0,4.0,5.0,4.0,2.0,11,,,,,,,,,,,,,,,,,,,,,,,,,,,,,,,,,7,,,,,,,,,,,,,,,,,,,,,,,,,,,,,,,,,3,,,,,,,,,,,,,,,,,,,,,,,,,,,,,,,,,6,,,,,,,,,,,,,,,,,,,,,,,,,,,,,,,,,14,,,,,,,,,,,,,,,,,,,,,,,,,,,,,,,,,1,1.0,1.0,2.0,3.0,3.0,2.0,6.0,1.0,1.0,2.0,1.0,1.0,1.0,1.0,1.0,1.0,2.0,1.0,2.0,1.0,1.0,1.0,1.0,1.0,2.0,3.0,3.0,1.0,2.0,3.0,2.0,1.0,8,,,,,,,,,,,,,,,,,,,,,,,,,,,,,,,,,12,,,,,,,,,,,,,,,,,,,,,,,,,,,,,,,,,5,,,,,,,,,,,,,,,,,,,,,,,,,,,,,,,,,4,,,,,,,,,,,,,,,,,,,,,,,,,,,,,,,,,9,,,,,,,,,,,,,,,,,,,,,,,,,,,,,,,,,13,,,,,,,,,,,,,,,,,,,,,,,,,,,,,,,,,10,,,,,,,,,,,,,,,,,,,,,,,,,,,,,,,,,not applicable,459.51,32.46,,,,11.36,,52.12,,116.65,,,108.31,,,,,,,,,,,,,,,,,,125.27,,,,,,,,,,,,,,,,,,,,,,,,13.34,,APPROVED,Female,24.0,FALSE
719,2022-03-22 01:44:08,19,en,468587413,2022-03-22 01:38:19,2022-03-22 01:44:08,Y,Y,A1,,,5,,,,,,,,,,,,,,,,,,,,,,,,,,,,,,,,,13,,,,,,,,,,,,,,,,,,,,,,,,,,,,,,,,,3,,,,,,,,,,,,,,,,,,,,,,,,,,,,,,,,,10,,,,,,,,,,,,,,,,,,,,,,,,,,,,,,,,,4,,,,,,,,,,,,,,,,,,,,,,,,,,,,,,,,,2,3.0,5.0,3.0,3.0,2.0,1.0,6.0,5.0,5.0,2.0,2.0,2.0,2.0,3.0,5.0,2.0,4.0,3.0,5.0,2.0,3.0,4.0,4.0,2.0,3.0,3.0,4.0,2.0,2.0,2.0,4.0,6.0,14,,,,,,,,,,,,,,,,,,,,,,,,,,,,,,,,,7,,,,,,,,,,,,,,,,,,,,,,,,,,,,,,,,,6,,,,,,,,,,,,,,,,,,,,,,,,,,,,,,,,,0,3.0,6.0,5.0,2.0,2.0,2.0,6.0,1.0,5.0,3.0,2.0,2.0,3.0,2.0,3.0,2.0,5.0,2.0,4.0,2.0,3.0,2.0,1.0,2.0,2.0,4.0,2.0,2.0,4.0,2.0,4.0,3.0,12,,,,,,,,,,,,,,,,,,,,,,,,,,,,,,,,,9,,,,,,,,,,,,,,,,,,,,,,,,,,,,,,,,,11,,,,,,,,,,,,,,,,,,,,,,,,,,,,,,,,,8,,,,,,,,,,,,,,,,,,,,,,,,,,,,,,,,,1,5.0,5.0,5.0,3.0,4.0,3.0,5.0,5.0,6.0,5.0,3.0,3.0,6.0,5.0,5.0,3.0,5.0,3.0,5.0,4.0,3.0,5.0,3.0,5.0,4.0,5.0,3.0,5.0,4.0,3.0,4.0,3.0,Everything was fine.,353.01,30.8,,,,9.51,,55.09,,,,,,,,,,,,,,,,,69.88,,,,,,,,,,,,101.18,,,,,,,,,,,,,,,75.59,,,10.96,,APPROVED,Female,20.0,FALSE
720,2022-03-22 01:41:50,19,en,2146491524,2022-03-22 01:38:20,2022-03-22 01:41:50,Y,Y,A1,,,1,1.0,3.0,1.0,1.0,1.0,1.0,6.0,1.0,2.0,1.0,1.0,3.0,1.0,1.0,1.0,2.0,1.0,1.0,1.0,1.0,2.0,1.0,1.0,1.0,2.0,1.0,1.0,1.0,2.0,1.0,2.0,1.0,8,,,,,,,,,,,,,,,,,,,,,,,,,,,,,,,,,4,,,,,,,,,,,,,,,,,,,,,,,,,,,,,,,,,10,,,,,,,,,,,,,,,,,,,,,,,,,,,,,,,,,9,,,,,,,,,,,,,,,,,,,,,,,,,,,,,,,,,6,,,,,,,,,,,,,,,,,,,,,,,,,,,,,,,,,7,,,,,,,,,,,,,,,,,,,,,,,,,,,,,,,,,13,,,,,,,,,,,,,,,,,,,,,,,,,,,,,,,,,3,,,,,,,,,,,,,,,,,,,,,,,,,,,,,,,,,5,,,,,,,,,,,,,,,,,,,,,,,,,,,,,,,,,12,,,,,,,,,,,,,,,,,,,,,,,,,,,,,,,,,14,,,,,,,,,,,,,,,,,,,,,,,,,,,,,,,,,11,,,,,,,,,,,,,,,,,,,,,,,,,,,,,,,,,2,1.0,5.0,1.0,1.0,1.0,1.0,2.0,1.0,5.0,1.0,1.0,1.0,1.0,1.0,1.0,1.0,3.0,1.0,1.0,1.0,1.0,1.0,5.0,1.0,1.0,3.0,1.0,1.0,1.0,1.0,6.0,7.0,0,1.0,3.0,2.0,2.0,2.0,2.0,6.0,2.0,2.0,2.0,2.0,1.0,1.0,2.0,2.0,2.0,3.0,2.0,2.0,1.0,2.0,2.0,2.0,1.0,2.0,2.0,3.0,2.0,2.0,3.0,2.0,1.0,Those were not the images I was expecting to look at. None of them were pleasant. ,212.79,13.46,,,,3.49,,17.58,,40.47,,,,,,,,,,,,,,,,,,,,,,,,,,,,,,,,,,,,,,,68.03,,,48.61,,,21.15,,APPROVED,Female,20.0,FALSE
721,2022-03-22 01:44:48,19,en,1446951954,2022-03-22 01:39:07,2022-03-22 01:44:48,Y,Y,-oth-,high school diploma,,2,6.0,7.0,6.0,3.0,7.0,3.0,4.0,7.0,7.0,5.0,3.0,5.0,5.0,7.0,3.0,4.0,7.0,4.0,4.0,3.0,1.0,5.0,1.0,4.0,7.0,1.0,2.0,4.0,3.0,4.0,5.0,1.0,13,,,,,,,,,,,,,,,,,,,,,,,,,,,,,,,,,0,6.0,7.0,3.0,2.0,7.0,2.0,4.0,7.0,7.0,4.0,6.0,2.0,7.0,6.0,4.0,5.0,6.0,2.0,4.0,3.0,2.0,5.0,3.0,6.0,7.0,1.0,3.0,3.0,1.0,6.0,2.0,3.0,11,,,,,,,,,,,,,,,,,,,,,,,,,,,,,,,,,3,,,,,,,,,,,,,,,,,,,,,,,,,,,,,,,,,9,,,,,,,,,,,,,,,,,,,,,,,,,,,,,,,,,7,,,,,,,,,,,,,,,,,,,,,,,,,,,,,,,,,6,,,,,,,,,,,,,,,,,,,,,,,,,,,,,,,,,8,,,,,,,,,,,,,,,,,,,,,,,,,,,,,,,,,4,,,,,,,,,,,,,,,,,,,,,,,,,,,,,,,,,1,5.0,7.0,7.0,1.0,6.0,3.0,3.0,7.0,7.0,4.0,2.0,5.0,5.0,7.0,6.0,5.0,7.0,2.0,7.0,3.0,4.0,5.0,3.0,6.0,3.0,1.0,3.0,3.0,2.0,5.0,6.0,4.0,5,,,,,,,,,,,,,,,,,,,,,,,,,,,,,,,,,12,,,,,,,,,,,,,,,,,,,,,,,,,,,,,,,,,14,,,,,,,,,,,,,,,,,,,,,,,,,,,,,,,,,10,,,,,,,,,,,,,,,,,,,,,,,,,,,,,,,,,,345.23,12.96,,,,8.79,,28.74,,144.67,,,,,,72.72,,,,,,,,,,,,,,,,,,,,,,,,73.05,,,,,,,,,,,,,,,4.3,,APPROVED,Female,25.0,FALSE
722,2022-03-22 01:54:20,19,en,1278151561,2022-03-22 01:40:43,2022-03-22 01:54:20,Y,Y,A1,,,10,,,,,,,,,,,,,,,,,,,,,,,,,,,,,,,,,2,4.0,4.0,4.0,5.0,3.0,5.0,5.0,6.0,3.0,3.0,3.0,4.0,4.0,4.0,3.0,5.0,5.0,3.0,4.0,2.0,2.0,5.0,5.0,4.0,3.0,6.0,4.0,2.0,2.0,5.0,6.0,2.0,1,6.0,5.0,6.0,6.0,5.0,7.0,3.0,6.0,6.0,5.0,5.0,7.0,6.0,6.0,4.0,5.0,6.0,6.0,7.0,5.0,5.0,6.0,6.0,6.0,6.0,5.0,5.0,6.0,3.0,6.0,5.0,3.0,8,,,,,,,,,,,,,,,,,,,,,,,,,,,,,,,,,13,,,,,,,,,,,,,,,,,,,,,,,,,,,,,,,,,11,,,,,,,,,,,,,,,,,,,,,,,,,,,,,,,,,7,,,,,,,,,,,,,,,,,,,,,,,,,,,,,,,,,12,,,,,,,,,,,,,,,,,,,,,,,,,,,,,,,,,6,,,,,,,,,,,,,,,,,,,,,,,,,,,,,,,,,9,,,,,,,,,,,,,,,,,,,,,,,,,,,,,,,,,4,,,,,,,,,,,,,,,,,,,,,,,,,,,,,,,,,5,,,,,,,,,,,,,,,,,,,,,,,,,,,,,,,,,3,,,,,,,,,,,,,,,,,,,,,,,,,,,,,,,,,14,,,,,,,,,,,,,,,,,,,,,,,,,,,,,,,,,0,2.0,3.0,1.0,1.0,3.0,3.0,5.0,4.0,3.0,2.0,4.0,2.0,2.0,5.0,3.0,2.0,3.0,2.0,2.0,3.0,1.0,2.0,2.0,2.0,2.0,3.0,5.0,2.0,2.0,1.0,2.0,1.0,,819.97,219.88,,,,10.98,,61.32,,,,,113.41,,,109.13,,,,,,,,,,,,,,,,,,,,,,,,,,,,,,,,,,,,299.47,,,5.78,,APPROVED,Male,32.0,FALSE
723,2022-03-22 01:52:59,19,en,1658783763,2022-03-22 01:41:04,2022-03-22 01:52:59,Y,Y,-oth-,High School,,0,2.0,6.0,3.0,3.0,3.0,1.0,5.0,3.0,5.0,1.0,1.0,3.0,3.0,2.0,3.0,2.0,3.0,1.0,1.0,1.0,1.0,3.0,2.0,3.0,3.0,1.0,2.0,3.0,1.0,3.0,3.0,1.0,13,,,,,,,,,,,,,,,,,,,,,,,,,,,,,,,,,14,,,,,,,,,,,,,,,,,,,,,,,,,,,,,,,,,7,,,,,,,,,,,,,,,,,,,,,,,,,,,,,,,,,3,,,,,,,,,,,,,,,,,,,,,,,,,,,,,,,,,11,,,,,,,,,,,,,,,,,,,,,,,,,,,,,,,,,8,,,,,,,,,,,,,,,,,,,,,,,,,,,,,,,,,5,,,,,,,,,,,,,,,,,,,,,,,,,,,,,,,,,12,,,,,,,,,,,,,,,,,,,,,,,,,,,,,,,,,4,,,,,,,,,,,,,,,,,,,,,,,,,,,,,,,,,10,,,,,,,,,,,,,,,,,,,,,,,,,,,,,,,,,2,3.0,5.0,3.0,3.0,3.0,5.0,6.0,3.0,3.0,3.0,3.0,5.0,3.0,6.0,2.0,3.0,6.0,3.0,3.0,2.0,2.0,5.0,3.0,5.0,5.0,2.0,3.0,5.0,2.0,5.0,3.0,5.0,6,,,,,,,,,,,,,,,,,,,,,,,,,,,,,,,,,9,,,,,,,,,,,,,,,,,,,,,,,,,,,,,,,,,1,5.0,7.0,6.0,5.0,6.0,5.0,3.0,3.0,5.0,5.0,5.0,5.0,5.0,6.0,1.0,5.0,6.0,6.0,5.0,3.0,3.0,6.0,3.0,6.0,6.0,3.0,5.0,3.0,5.0,6.0,4.0,1.0,"I completed the study, there were no technical errors.
It was a very interesting study. I would be happy to participate in similar studies in the future. Thank you for the opportunity to be part of this study. :)

Best regards",718.49,52.03,,,,110.17,,49.71,,149.53,,,,,,,,,,,,,,,,,,,,,,,,,,,,,,,,,120.86,,,,,,,,,120.63,,,115.56,,APPROVED,Male,32.0,FALSE
724,2022-03-22 01:49:49,19,en,236605761,2022-03-22 01:41:05,2022-03-22 01:49:49,Y,Y,A1,,,10,,,,,,,,,,,,,,,,,,,,,,,,,,,,,,,,,8,,,,,,,,,,,,,,,,,,,,,,,,,,,,,,,,,5,,,,,,,,,,,,,,,,,,,,,,,,,,,,,,,,,0,2.0,4.0,2.0,3.0,4.0,1.0,6.0,4.0,4.0,2.0,2.0,4.0,1.0,2.0,4.0,2.0,5.0,2.0,2.0,2.0,2.0,4.0,2.0,2.0,2.0,4.0,4.0,2.0,4.0,3.0,4.0,4.0,12,,,,,,,,,,,,,,,,,,,,,,,,,,,,,,,,,9,,,,,,,,,,,,,,,,,,,,,,,,,,,,,,,,,13,,,,,,,,,,,,,,,,,,,,,,,,,,,,,,,,,7,,,,,,,,,,,,,,,,,,,,,,,,,,,,,,,,,1,2.0,2.0,2.0,2.0,2.0,2.0,6.0,2.0,2.0,2.0,2.0,2.0,2.0,2.0,2.0,2.0,4.0,2.0,2.0,2.0,2.0,2.0,4.0,2.0,2.0,4.0,2.0,2.0,4.0,2.0,4.0,2.0,2,2.0,2.0,2.0,2.0,2.0,2.0,7.0,2.0,4.0,2.0,2.0,2.0,2.0,2.0,2.0,2.0,2.0,2.0,2.0,2.0,2.0,2.0,4.0,2.0,2.0,4.0,2.0,2.0,4.0,2.0,4.0,3.0,11,,,,,,,,,,,,,,,,,,,,,,,,,,,,,,,,,4,,,,,,,,,,,,,,,,,,,,,,,,,,,,,,,,,14,,,,,,,,,,,,,,,,,,,,,,,,,,,,,,,,,6,,,,,,,,,,,,,,,,,,,,,,,,,,,,,,,,,3,,,,,,,,,,,,,,,,,,,,,,,,,,,,,,,,,,527.17,137.45,,,,10.33,,63.43,,,,,,,,,,,119.83,,,,,,,,,,,,,,,104.59,,,86.76,,,,,,,,,,,,,,,,,,4.78,,APPROVED,Female,38.0,FALSE
725,2022-03-22 01:49:11,19,en,1942771667,2022-03-22 01:41:10,2022-03-22 01:49:11,Y,Y,A1,,,1,4.0,7.0,4.0,4.0,3.0,3.0,6.0,4.0,7.0,4.0,2.0,5.0,5.0,5.0,7.0,2.0,7.0,7.0,5.0,3.0,5.0,5.0,4.0,5.0,4.0,5.0,6.0,6.0,2.0,2.0,2.0,1.0,7,,,,,,,,,,,,,,,,,,,,,,,,,,,,,,,,,9,,,,,,,,,,,,,,,,,,,,,,,,,,,,,,,,,3,,,,,,,,,,,,,,,,,,,,,,,,,,,,,,,,,11,,,,,,,,,,,,,,,,,,,,,,,,,,,,,,,,,12,,,,,,,,,,,,,,,,,,,,,,,,,,,,,,,,,5,,,,,,,,,,,,,,,,,,,,,,,,,,,,,,,,,13,,,,,,,,,,,,,,,,,,,,,,,,,,,,,,,,,4,,,,,,,,,,,,,,,,,,,,,,,,,,,,,,,,,0,3.0,5.0,3.0,1.0,4.0,1.0,6.0,1.0,1.0,2.0,2.0,4.0,2.0,5.0,5.0,1.0,5.0,1.0,2.0,1.0,4.0,3.0,5.0,2.0,1.0,2.0,5.0,5.0,2.0,1.0,1.0,3.0,10,,,,,,,,,,,,,,,,,,,,,,,,,,,,,,,,,14,,,,,,,,,,,,,,,,,,,,,,,,,,,,,,,,,8,,,,,,,,,,,,,,,,,,,,,,,,,,,,,,,,,6,,,,,,,,,,,,,,,,,,,,,,,,,,,,,,,,,2,4.0,7.0,7.0,4.0,3.0,4.0,4.0,2.0,5.0,2.0,2.0,5.0,5.0,5.0,6.0,5.0,6.0,6.0,5.0,2.0,2.0,4.0,3.0,3.0,2.0,4.0,6.0,5.0,1.0,2.0,2.0,1.0,,484.19,123.27,,,,7.42,,57.68,,86.74,,,,,,,,,,,,,,,,,,,,,,,,,,,88.57,,,,,,,,,,,,,,,106.44,,,14.07,,APPROVED,Female,26.0,FALSE
726,2022-03-22 01:56:38,19,en,1596754924,2022-03-22 01:46:21,2022-03-22 01:56:38,Y,Y,A1,,,5,,,,,,,,,,,,,,,,,,,,,,,,,,,,,,,,,9,,,,,,,,,,,,,,,,,,,,,,,,,,,,,,,,,3,,,,,,,,,,,,,,,,,,,,,,,,,,,,,,,,,4,,,,,,,,,,,,,,,,,,,,,,,,,,,,,,,,,6,,,,,,,,,,,,,,,,,,,,,,,,,,,,,,,,,1,4.0,4.0,4.0,5.0,4.0,5.0,5.0,6.0,3.0,4.0,2.0,4.0,6.0,2.0,3.0,6.0,5.0,5.0,5.0,3.0,3.0,5.0,5.0,5.0,5.0,1.0,2.0,5.0,2.0,4.0,3.0,6.0,7,,,,,,,,,,,,,,,,,,,,,,,,,,,,,,,,,13,,,,,,,,,,,,,,,,,,,,,,,,,,,,,,,,,8,,,,,,,,,,,,,,,,,,,,,,,,,,,,,,,,,1,5.0,5.0,4.0,2.0,3.0,2.0,6.0,3.0,5.0,3.0,2.0,4.0,5.0,3.0,2.0,1.0,4.0,2.0,3.0,3.0,2.0,5.0,1.0,2.0,4.0,2.0,6.0,2.0,2.0,3.0,2.0,3.0,14,,,,,,,,,,,,,,,,,,,,,,,,,,,,,,,,,2,5.0,6.0,5.0,4.0,6.0,3.0,5.0,5.0,7.0,5.0,2.0,5.0,6.0,5.0,6.0,3.0,6.0,5.0,6.0,4.0,4.0,6.0,3.0,6.0,6.0,3.0,6.0,5.0,2.0,5.0,4.0,5.0,10,,,,,,,,,,,,,,,,,,,,,,,,,,,,,,,,,11,,,,,,,,,,,,,,,,,,,,,,,,,,,,,,,,,12,,,,,,,,,,,,,,,,,,,,,,,,,,,,,,,,,"No comments, just a thank you for letting me participate!",623.51,105.12,,,,9.62,,67.6,,,,,,,,,,,,,,,,,132.02,,,,,,,,,,,,191.66,,,,,,93.08,,,,,,,,,,,,24.41,,APPROVED,Male,25.0,FALSE
727,2022-03-22 01:54:07,19,en,1085825632,2022-03-22 01:46:22,2022-03-22 01:54:07,Y,Y,A1,,,8,,,,,,,,,,,,,,,,,,,,,,,,,,,,,,,,,14,,,,,,,,,,,,,,,,,,,,,,,,,,,,,,,,,7,,,,,,,,,,,,,,,,,,,,,,,,,,,,,,,,,12,,,,,,,,,,,,,,,,,,,,,,,,,,,,,,,,,5,,,,,,,,,,,,,,,,,,,,,,,,,,,,,,,,,9,,,,,,,,,,,,,,,,,,,,,,,,,,,,,,,,,4,,,,,,,,,,,,,,,,,,,,,,,,,,,,,,,,,11,,,,,,,,,,,,,,,,,,,,,,,,,,,,,,,,,10,,,,,,,,,,,,,,,,,,,,,,,,,,,,,,,,,3,,,,,,,,,,,,,,,,,,,,,,,,,,,,,,,,,1,6.0,7.0,6.0,6.0,6.0,6.0,1.0,6.0,7.0,6.0,6.0,6.0,6.0,6.0,6.0,6.0,6.0,5.0,6.0,6.0,6.0,6.0,6.0,6.0,6.0,5.0,2.0,7.0,7.0,5.0,7.0,4.0,6,,,,,,,,,,,,,,,,,,,,,,,,,,,,,,,,,2,3.0,5.0,2.0,2.0,3.0,4.0,6.0,5.0,3.0,3.0,3.0,3.0,3.0,4.0,2.0,2.0,3.0,2.0,2.0,3.0,4.0,3.0,5.0,3.0,3.0,5.0,5.0,3.0,5.0,2.0,3.0,6.0,13,,,,,,,,,,,,,,,,,,,,,,,,,,,,,,,,,0,4.0,6.0,3.0,5.0,4.0,5.0,1.0,2.0,5.0,2.0,5.0,5.0,5.0,5.0,5.0,5.0,5.0,2.0,3.0,3.0,4.0,5.0,6.0,3.0,4.0,6.0,5.0,5.0,5.0,3.0,6.0,1.0,,468.64,25.2,,,,7.34,,69.67,,,,,,,,,,,,,,,,,,,,,,,,,,,,,,,,90.74,,,,,,108.7,,,,,,147.19,,,19.8,,APPROVED,Female,24.0,FALSE
728,2022-03-22 01:53:15,19,en,656239983,2022-03-22 01:46:23,2022-03-22 01:53:15,Y,Y,A2,,,11,,,,,,,,,,,,,,,,,,,,,,,,,,,,,,,,,10,,,,,,,,,,,,,,,,,,,,,,,,,,,,,,,,,14,,,,,,,,,,,,,,,,,,,,,,,,,,,,,,,,,1,7.0,7.0,7.0,7.0,7.0,7.0,2.0,7.0,7.0,4.0,7.0,7.0,7.0,7.0,7.0,7.0,7.0,5.0,4.0,5.0,5.0,5.0,7.0,4.0,6.0,7.0,5.0,7.0,7.0,7.0,7.0,4.0,6,,,,,,,,,,,,,,,,,,,,,,,,,,,,,,,,,0,7.0,7.0,7.0,5.0,7.0,3.0,7.0,7.0,7.0,4.0,6.0,7.0,7.0,7.0,7.0,7.0,7.0,6.0,6.0,7.0,4.0,7.0,6.0,7.0,7.0,5.0,7.0,7.0,7.0,6.0,7.0,6.0,2,3.0,5.0,1.0,7.0,4.0,1.0,6.0,7.0,7.0,1.0,6.0,4.0,3.0,4.0,4.0,7.0,5.0,3.0,1.0,2.0,3.0,4.0,7.0,2.0,1.0,4.0,4.0,2.0,7.0,2.0,4.0,7.0,13,,,,,,,,,,,,,,,,,,,,,,,,,,,,,,,,,7,,,,,,,,,,,,,,,,,,,,,,,,,,,,,,,,,4,,,,,,,,,,,,,,,,,,,,,,,,,,,,,,,,,12,,,,,,,,,,,,,,,,,,,,,,,,,,,,,,,,,9,,,,,,,,,,,,,,,,,,,,,,,,,,,,,,,,,5,,,,,,,,,,,,,,,,,,,,,,,,,,,,,,,,,3,,,,,,,,,,,,,,,,,,,,,,,,,,,,,,,,,8,,,,,,,,,,,,,,,,,,,,,,,,,,,,,,,,,"I am interested in knowing what the third visualization (the yellow, weird one) is actually about and how people get information from it!",414.56,19.84,,,,6.16,,33.07,,,,,,,,,,,84.35,,,,,,138.04,,,84.39,,,,,,,,,,,,,,,,,,,,,,,,,,,48.71,,APPROVED,Female,27.0,FALSE
729,2022-03-22 02:00:29,19,en,992401073,2022-03-22 01:46:26,2022-03-22 02:00:29,Y,Y,A1,,,5,,,,,,,,,,,,,,,,,,,,,,,,,,,,,,,,,0,3.0,5.0,2.0,2.0,4.0,5.0,6.0,3.0,2.0,3.0,5.0,4.0,3.0,2.0,2.0,3.0,3.0,2.0,3.0,2.0,3.0,3.0,2.0,3.0,4.0,3.0,2.0,5.0,4.0,2.0,2.0,2.0,1,6.0,6.0,5.0,6.0,5.0,5.0,6.0,4.0,7.0,6.0,5.0,4.0,6.0,5.0,5.0,3.0,5.0,3.0,6.0,5.0,3.0,6.0,6.0,5.0,6.0,6.0,4.0,6.0,5.0,4.0,7.0,3.0,2,4.0,6.0,2.0,2.0,4.0,4.0,6.0,5.0,5.0,4.0,2.0,3.0,3.0,4.0,3.0,2.0,6.0,2.0,3.0,3.0,3.0,3.0,2.0,3.0,3.0,6.0,4.0,4.0,3.0,5.0,4.0,4.0,10,,,,,,,,,,,,,,,,,,,,,,,,,,,,,,,,,8,,,,,,,,,,,,,,,,,,,,,,,,,,,,,,,,,6,,,,,,,,,,,,,,,,,,,,,,,,,,,,,,,,,7,,,,,,,,,,,,,,,,,,,,,,,,,,,,,,,,,3,,,,,,,,,,,,,,,,,,,,,,,,,,,,,,,,,12,,,,,,,,,,,,,,,,,,,,,,,,,,,,,,,,,13,,,,,,,,,,,,,,,,,,,,,,,,,,,,,,,,,9,,,,,,,,,,,,,,,,,,,,,,,,,,,,,,,,,11,,,,,,,,,,,,,,,,,,,,,,,,,,,,,,,,,4,,,,,,,,,,,,,,,,,,,,,,,,,,,,,,,,,14,,,,,,,,,,,,,,,,,,,,,,,,,,,,,,,,,,847.55,23.05,,,,19.58,,38.0,,,,,253.78,,,204.97,,,305.31,,,,,,,,,,,,,,,,,,,,,,,,,,,,,,,,,,,,2.86,,APPROVED,Male,20.0,FALSE
730,2022-03-22 01:49:41,19,en,646643968,2022-03-22 01:46:28,2022-03-22 01:49:41,Y,Y,A1,,,1,5.0,5.0,5.0,3.0,5.0,5.0,5.0,5.0,5.0,5.0,5.0,5.0,5.0,5.0,5.0,5.0,5.0,5.0,5.0,5.0,5.0,5.0,3.0,5.0,5.0,4.0,5.0,6.0,5.0,5.0,5.0,1.0,13,,,,,,,,,,,,,,,,,,,,,,,,,,,,,,,,,12,,,,,,,,,,,,,,,,,,,,,,,,,,,,,,,,,11,,,,,,,,,,,,,,,,,,,,,,,,,,,,,,,,,7,,,,,,,,,,,,,,,,,,,,,,,,,,,,,,,,,14,,,,,,,,,,,,,,,,,,,,,,,,,,,,,,,,,0,1.0,1.0,1.0,1.0,1.0,1.0,5.0,4.0,1.0,2.0,1.0,1.0,2.0,1.0,1.0,2.0,2.0,2.0,1.0,1.0,1.0,2.0,5.0,2.0,2.0,2.0,1.0,1.0,1.0,1.0,2.0,7.0,10,,,,,,,,,,,,,,,,,,,,,,,,,,,,,,,,,2,1.0,1.0,1.0,5.0,1.0,3.0,1.0,3.0,1.0,1.0,1.0,1.0,1.0,3.0,1.0,1.0,2.0,1.0,2.0,3.0,1.0,3.0,6.0,5.0,1.0,7.0,1.0,5.0,5.0,3.0,5.0,2.0,9,,,,,,,,,,,,,,,,,,,,,,,,,,,,,,,,,6,,,,,,,,,,,,,,,,,,,,,,,,,,,,,,,,,3,,,,,,,,,,,,,,,,,,,,,,,,,,,,,,,,,8,,,,,,,,,,,,,,,,,,,,,,,,,,,,,,,,,4,,,,,,,,,,,,,,,,,,,,,,,,,,,,,,,,,5,,,,,,,,,,,,,,,,,,,,,,,,,,,,,,,,,,194.85,15.08,,,,4.24,,11.9,,66.97,,,,,,,,,,,,,,,,,,42.94,,,,,,51.1,,,,,,,,,,,,,,,,,,,,,2.62,,APPROVED,Male,21.0,FALSE
731,2022-03-22 01:51:21,19,en,315864620,2022-03-22 01:46:32,2022-03-22 01:51:21,Y,Y,A1,,,5,,,,,,,,,,,,,,,,,,,,,,,,,,,,,,,,,3,,,,,,,,,,,,,,,,,,,,,,,,,,,,,,,,,10,,,,,,,,,,,,,,,,,,,,,,,,,,,,,,,,,6,,,,,,,,,,,,,,,,,,,,,,,,,,,,,,,,,11,,,,,,,,,,,,,,,,,,,,,,,,,,,,,,,,,9,,,,,,,,,,,,,,,,,,,,,,,,,,,,,,,,,0,5.0,6.0,6.0,4.0,6.0,4.0,7.0,6.0,6.0,4.0,5.0,6.0,4.0,6.0,7.0,4.0,7.0,5.0,4.0,4.0,4.0,5.0,5.0,4.0,6.0,5.0,5.0,6.0,5.0,5.0,6.0,7.0,4,,,,,,,,,,,,,,,,,,,,,,,,,,,,,,,,,2,5.0,3.0,3.0,4.0,3.0,6.0,6.0,3.0,4.0,4.0,4.0,6.0,4.0,4.0,4.0,4.0,5.0,4.0,5.0,4.0,3.0,2.0,5.0,4.0,2.0,6.0,4.0,3.0,5.0,4.0,5.0,2.0,12,,,,,,,,,,,,,,,,,,,,,,,,,,,,,,,,,7,,,,,,,,,,,,,,,,,,,,,,,,,,,,,,,,,8,,,,,,,,,,,,,,,,,,,,,,,,,,,,,,,,,13,,,,,,,,,,,,,,,,,,,,,,,,,,,,,,,,,1,6.0,5.0,5.0,5.0,4.0,6.0,5.0,6.0,5.0,4.0,5.0,5.0,6.0,4.0,7.0,5.0,7.0,6.0,6.0,4.0,4.0,6.0,6.0,4.0,4.0,7.0,4.0,4.0,4.0,5.0,7.0,7.0,14,,,,,,,,,,,,,,,,,,,,,,,,,,,,,,,,,,292.91,16.73,,,,13.33,,19.9,,,,,,,,,,,,,,,,,,,,100.73,,,,,,72.6,,,,,,,,,,,,,,,65.74,,,,,,3.88,,APPROVED,Female,21.0,FALSE
732,2022-03-22 01:56:02,19,en,1629504496,2022-03-22 01:46:33,2022-03-22 01:56:02,Y,Y,A2,,,11,,,,,,,,,,,,,,,,,,,,,,,,,,,,,,,,,9,,,,,,,,,,,,,,,,,,,,,,,,,,,,,,,,,3,,,,,,,,,,,,,,,,,,,,,,,,,,,,,,,,,0,5.0,6.0,5.0,5.0,6.0,3.0,6.0,5.0,5.0,3.0,6.0,5.0,5.0,3.0,6.0,5.0,4.0,4.0,4.0,4.0,3.0,5.0,5.0,5.0,5.0,4.0,3.0,3.0,6.0,4.0,6.0,4.0,2,6.0,4.0,5.0,5.0,3.0,6.0,1.0,7.0,7.0,6.0,5.0,6.0,6.0,4.0,6.0,5.0,6.0,5.0,7.0,4.0,4.0,6.0,6.0,6.0,6.0,6.0,3.0,5.0,5.0,5.0,6.0,5.0,7,,,,,,,,,,,,,,,,,,,,,,,,,,,,,,,,,12,,,,,,,,,,,,,,,,,,,,,,,,,,,,,,,,,5,,,,,,,,,,,,,,,,,,,,,,,,,,,,,,,,,6,,,,,,,,,,,,,,,,,,,,,,,,,,,,,,,,,8,,,,,,,,,,,,,,,,,,,,,,,,,,,,,,,,,13,,,,,,,,,,,,,,,,,,,,,,,,,,,,,,,,,1,5.0,2.0,5.0,5.0,3.0,2.0,6.0,4.0,6.0,3.0,4.0,4.0,3.0,3.0,4.0,6.0,4.0,3.0,5.0,1.0,1.0,3.0,4.0,3.0,2.0,4.0,2.0,2.0,3.0,1.0,4.0,5.0,14,,,,,,,,,,,,,,,,,,,,,,,,,,,,,,,,,10,,,,,,,,,,,,,,,,,,,,,,,,,,,,,,,,,4,,,,,,,,,,,,,,,,,,,,,,,,,,,,,,,,,,574.2,108.03,,,,20.82,,41.9,,,,,,,,,,,112.18,,,154.3,,,,,,,,,,,,,,,,,,,,,132.76,,,,,,,,,,,,4.21,,APPROVED,Female,39.0,FALSE
733,2022-03-22 01:51:41,19,en,2108441349,2022-03-22 01:46:34,2022-03-22 01:51:41,Y,Y,A2,,,6,,,,,,,,,,,,,,,,,,,,,,,,,,,,,,,,,4,,,,,,,,,,,,,,,,,,,,,,,,,,,,,,,,,1,6.0,7.0,5.0,6.0,4.0,5.0,6.0,5.0,6.0,3.0,3.0,5.0,6.0,5.0,5.0,5.0,6.0,5.0,5.0,3.0,5.0,5.0,5.0,5.0,3.0,4.0,5.0,5.0,6.0,4.0,3.0,3.0,7,,,,,,,,,,,,,,,,,,,,,,,,,,,,,,,,,2,5.0,5.0,4.0,1.0,2.0,2.0,7.0,5.0,5.0,2.0,5.0,2.0,1.0,3.0,3.0,5.0,3.0,2.0,4.0,1.0,3.0,5.0,5.0,2.0,3.0,6.0,2.0,3.0,5.0,4.0,3.0,3.0,11,,,,,,,,,,,,,,,,,,,,,,,,,,,,,,,,,13,,,,,,,,,,,,,,,,,,,,,,,,,,,,,,,,,14,,,,,,,,,,,,,,,,,,,,,,,,,,,,,,,,,0,1.0,5.0,3.0,3.0,3.0,5.0,6.0,2.0,4.0,1.0,5.0,3.0,2.0,3.0,3.0,5.0,6.0,2.0,2.0,1.0,3.0,4.0,5.0,2.0,1.0,5.0,4.0,3.0,2.0,4.0,2.0,2.0,10,,,,,,,,,,,,,,,,,,,,,,,,,,,,,,,,,9,,,,,,,,,,,,,,,,,,,,,,,,,,,,,,,,,12,,,,,,,,,,,,,,,,,,,,,,,,,,,,,,,,,5,,,,,,,,,,,,,,,,,,,,,,,,,,,,,,,,,3,,,,,,,,,,,,,,,,,,,,,,,,,,,,,,,,,8,,,,,,,,,,,,,,,,,,,,,,,,,,,,,,,,,,311.06,54.42,,,,12.95,,26.89,,,,,,,,69.05,,,,,,69.41,,,,,,,,,,,,74.41,,,,,,,,,,,,,,,,,,,,,3.93,,APPROVED,Male,34.0,FALSE
734,2022-03-22 01:50:07,19,en,472959885,2022-03-22 01:46:35,2022-03-22 01:50:07,Y,Y,A1,,,4,,,,,,,,,,,,,,,,,,,,,,,,,,,,,,,,,7,,,,,,,,,,,,,,,,,,,,,,,,,,,,,,,,,13,,,,,,,,,,,,,,,,,,,,,,,,,,,,,,,,,2,6.0,7.0,6.0,4.0,5.0,5.0,5.0,6.0,6.0,6.0,4.0,6.0,4.0,5.0,5.0,6.0,5.0,4.0,5.0,5.0,3.0,4.0,3.0,5.0,5.0,5.0,4.0,5.0,4.0,5.0,4.0,4.0,12,,,,,,,,,,,,,,,,,,,,,,,,,,,,,,,,,8,,,,,,,,,,,,,,,,,,,,,,,,,,,,,,,,,5,,,,,,,,,,,,,,,,,,,,,,,,,,,,,,,,,3,,,,,,,,,,,,,,,,,,,,,,,,,,,,,,,,,14,,,,,,,,,,,,,,,,,,,,,,,,,,,,,,,,,1,3.0,4.0,3.0,5.0,3.0,1.0,7.0,4.0,4.0,4.0,2.0,5.0,4.0,3.0,6.0,4.0,5.0,2.0,4.0,3.0,3.0,4.0,3.0,3.0,4.0,5.0,5.0,4.0,3.0,4.0,3.0,3.0,10,,,,,,,,,,,,,,,,,,,,,,,,,,,,,,,,,9,,,,,,,,,,,,,,,,,,,,,,,,,,,,,,,,,11,,,,,,,,,,,,,,,,,,,,,,,,,,,,,,,,,0,4.0,5.0,3.0,4.0,4.0,4.0,5.0,5.0,5.0,4.0,3.0,5.0,4.0,5.0,5.0,4.0,6.0,4.0,3.0,3.0,4.0,3.0,4.0,4.0,5.0,6.0,6.0,5.0,4.0,4.0,5.0,7.0,6,,,,,,,,,,,,,,,,,,,,,,,,,,,,,,,,,,215.83,20.06,,,,5.46,,20.01,,,,,,,,,,,58.33,,,,,,,,,,,,,,,,,,59.18,,,,,,,,,,,,49.88,,,,,,2.91,,APPROVED,Male,39.0,FALSE
735,2022-03-22 01:50:11,19,en,635786023,2022-03-22 01:46:35,2022-03-22 01:50:11,Y,Y,A1,,,6,,,,,,,,,,,,,,,,,,,,,,,,,,,,,,,,,14,,,,,,,,,,,,,,,,,,,,,,,,,,,,,,,,,10,,,,,,,,,,,,,,,,,,,,,,,,,,,,,,,,,7,,,,,,,,,,,,,,,,,,,,,,,,,,,,,,,,,0,5.0,7.0,5.0,3.0,6.0,2.0,6.0,5.0,6.0,3.0,5.0,4.0,5.0,5.0,6.0,3.0,5.0,6.0,5.0,5.0,5.0,3.0,1.0,3.0,6.0,3.0,3.0,6.0,5.0,5.0,6.0,5.0,11,,,,,,,,,,,,,,,,,,,,,,,,,,,,,,,,,1,5.0,2.0,5.0,6.0,4.0,5.0,2.0,7.0,1.0,5.0,6.0,3.0,6.0,1.0,2.0,7.0,7.0,3.0,3.0,4.0,3.0,5.0,7.0,6.0,5.0,7.0,3.0,6.0,2.0,6.0,5.0,7.0,9,,,,,,,,,,,,,,,,,,,,,,,,,,,,,,,,,5,,,,,,,,,,,,,,,,,,,,,,,,,,,,,,,,,13,,,,,,,,,,,,,,,,,,,,,,,,,,,,,,,,,4,,,,,,,,,,,,,,,,,,,,,,,,,,,,,,,,,8,,,,,,,,,,,,,,,,,,,,,,,,,,,,,,,,,3,,,,,,,,,,,,,,,,,,,,,,,,,,,,,,,,,2,1.0,2.0,2.0,1.0,1.0,2.0,5.0,3.0,1.0,2.0,1.0,1.0,5.0,3.0,3.0,2.0,5.0,1.0,1.0,1.0,1.0,1.0,1.0,1.0,1.0,1.0,6.0,3.0,1.0,1.0,5.0,7.0,12,,,,,,,,,,,,,,,,,,,,,,,,,,,,,,,,,Good luck!,219.04,25.7,,,,4.81,,21.88,,,,,,,,,,,,,,57.46,,,,,,50.02,,,,,,,,,,,,,,,,,,,,,51.04,,,,,,8.13,,APPROVED,Female,25.0,FALSE
736,2022-03-22 01:50:23,19,en,1995838009,2022-03-22 01:46:36,2022-03-22 01:50:23,Y,Y,A2,,,10,,,,,,,,,,,,,,,,,,,,,,,,,,,,,,,,,5,,,,,,,,,,,,,,,,,,,,,,,,,,,,,,,,,13,,,,,,,,,,,,,,,,,,,,,,,,,,,,,,,,,3,,,,,,,,,,,,,,,,,,,,,,,,,,,,,,,,,0,5.0,6.0,4.0,6.0,3.0,7.0,5.0,7.0,6.0,6.0,6.0,4.0,4.0,6.0,5.0,6.0,5.0,6.0,7.0,6.0,5.0,6.0,5.0,5.0,4.0,3.0,6.0,5.0,7.0,5.0,4.0,5.0,14,,,,,,,,,,,,,,,,,,,,,,,,,,,,,,,,,6,,,,,,,,,,,,,,,,,,,,,,,,,,,,,,,,,1,5.0,5.0,4.0,7.0,6.0,5.0,4.0,5.0,3.0,4.0,6.0,5.0,6.0,5.0,3.0,6.0,5.0,5.0,6.0,6.0,5.0,5.0,6.0,2.0,6.0,7.0,4.0,4.0,7.0,5.0,4.0,1.0,4,,,,,,,,,,,,,,,,,,,,,,,,,,,,,,,,,2,6.0,4.0,4.0,6.0,7.0,6.0,4.0,4.0,6.0,4.0,3.0,4.0,6.0,5.0,5.0,4.0,4.0,5.0,5.0,4.0,5.0,5.0,3.0,5.0,4.0,5.0,6.0,6.0,4.0,3.0,5.0,3.0,7,,,,,,,,,,,,,,,,,,,,,,,,,,,,,,,,,11,,,,,,,,,,,,,,,,,,,,,,,,,,,,,,,,,12,,,,,,,,,,,,,,,,,,,,,,,,,,,,,,,,,9,,,,,,,,,,,,,,,,,,,,,,,,,,,,,,,,,8,,,,,,,,,,,,,,,,,,,,,,,,,,,,,,,,,,229.61,59.4,,,,3.77,,16.4,,,,,,,,,,,,,,48.05,,,,,,,,,40.43,,,,,,52.3,,,,,,,,,,,,,,,,,,9.26,,APPROVED,Male,30.0,FALSE
737,2022-03-22 01:52:00,19,en,1867141954,2022-03-22 01:46:37,2022-03-22 01:52:00,Y,Y,-oth-,High school pursuing bachelor's right now,,1,2.0,2.0,2.0,2.0,3.0,2.0,6.0,5.0,4.0,3.0,2.0,2.0,2.0,2.0,5.0,2.0,5.0,2.0,2.0,2.0,2.0,4.0,5.0,2.0,2.0,5.0,5.0,2.0,2.0,2.0,5.0,1.0,10,,,,,,,,,,,,,,,,,,,,,,,,,,,,,,,,,7,,,,,,,,,,,,,,,,,,,,,,,,,,,,,,,,,2,5.0,6.0,6.0,6.0,6.0,6.0,2.0,6.0,4.0,6.0,6.0,6.0,6.0,5.0,6.0,6.0,6.0,6.0,6.0,6.0,5.0,6.0,6.0,5.0,6.0,6.0,6.0,3.0,5.0,6.0,6.0,4.0,6,,,,,,,,,,,,,,,,,,,,,,,,,,,,,,,,,5,,,,,,,,,,,,,,,,,,,,,,,,,,,,,,,,,0,3.0,5.0,2.0,3.0,2.0,5.0,5.0,6.0,4.0,2.0,2.0,3.0,3.0,2.0,5.0,5.0,5.0,2.0,4.0,2.0,2.0,2.0,4.0,3.0,2.0,6.0,2.0,2.0,2.0,3.0,4.0,7.0,13,,,,,,,,,,,,,,,,,,,,,,,,,,,,,,,,,11,,,,,,,,,,,,,,,,,,,,,,,,,,,,,,,,,3,,,,,,,,,,,,,,,,,,,,,,,,,,,,,,,,,4,,,,,,,,,,,,,,,,,,,,,,,,,,,,,,,,,8,,,,,,,,,,,,,,,,,,,,,,,,,,,,,,,,,14,,,,,,,,,,,,,,,,,,,,,,,,,,,,,,,,,12,,,,,,,,,,,,,,,,,,,,,,,,,,,,,,,,,9,,,,,,,,,,,,,,,,,,,,,,,,,,,,,,,,,,326.75,12.49,,,,20.85,,22.68,,87.9,,,,,,,,,63.04,,,,,,,,,116.19,,,,,,,,,,,,,,,,,,,,,,,,,,,3.6,,APPROVED,Female,21.0,FALSE
738,2022-03-22 02:01:29,19,en,1415500419,2022-03-22 01:46:39,2022-03-22 02:01:29,Y,Y,-oth-,Bachelor Finalist,,6,,,,,,,,,,,,,,,,,,,,,,,,,,,,,,,,,3,,,,,,,,,,,,,,,,,,,,,,,,,,,,,,,,,0,2.0,5.0,2.0,3.0,4.0,2.0,6.0,4.0,5.0,3.0,5.0,2.0,2.0,3.0,3.0,3.0,4.0,2.0,3.0,2.0,3.0,2.0,2.0,2.0,5.0,5.0,1.0,3.0,5.0,2.0,3.0,3.0,11,,,,,,,,,,,,,,,,,,,,,,,,,,,,,,,,,4,,,,,,,,,,,,,,,,,,,,,,,,,,,,,,,,,13,,,,,,,,,,,,,,,,,,,,,,,,,,,,,,,,,8,,,,,,,,,,,,,,,,,,,,,,,,,,,,,,,,,1,2.0,3.0,2.0,2.0,1.0,1.0,6.0,5.0,3.0,1.0,2.0,2.0,2.0,4.0,4.0,3.0,2.0,2.0,3.0,3.0,2.0,2.0,2.0,2.0,1.0,2.0,2.0,2.0,3.0,2.0,2.0,7.0,7,,,,,,,,,,,,,,,,,,,,,,,,,,,,,,,,,9,,,,,,,,,,,,,,,,,,,,,,,,,,,,,,,,,12,,,,,,,,,,,,,,,,,,,,,,,,,,,,,,,,,5,,,,,,,,,,,,,,,,,,,,,,,,,,,,,,,,,14,,,,,,,,,,,,,,,,,,,,,,,,,,,,,,,,,10,,,,,,,,,,,,,,,,,,,,,,,,,,,,,,,,,2,5.0,4.0,3.0,2.0,4.0,3.0,5.0,6.0,5.0,3.0,4.0,5.0,3.0,6.0,5.0,5.0,5.0,2.0,5.0,3.0,3.0,5.0,2.0,3.0,5.0,5.0,2.0,6.0,5.0,4.0,3.0,1.0,,894.08,511.46,,,,19.46,,41.69,,,,,,,,133.45,,,,,,,,,,,,,,,89.81,,,,,,,,,,,,,,,,,,,,,90.92,,,7.29,,APPROVED,Male,22.0,FALSE
739,2022-03-22 01:50:39,19,en,964438444,2022-03-22 01:46:39,2022-03-22 01:50:39,Y,Y,A1,,,0,5.0,6.0,6.0,2.0,5.0,2.0,6.0,5.0,6.0,4.0,6.0,5.0,7.0,6.0,5.0,5.0,6.0,6.0,6.0,4.0,5.0,6.0,2.0,5.0,6.0,1.0,2.0,5.0,2.0,5.0,5.0,1.0,14,,,,,,,,,,,,,,,,,,,,,,,,,,,,,,,,,4,,,,,,,,,,,,,,,,,,,,,,,,,,,,,,,,,5,,,,,,,,,,,,,,,,,,,,,,,,,,,,,,,,,10,,,,,,,,,,,,,,,,,,,,,,,,,,,,,,,,,9,,,,,,,,,,,,,,,,,,,,,,,,,,,,,,,,,13,,,,,,,,,,,,,,,,,,,,,,,,,,,,,,,,,3,,,,,,,,,,,,,,,,,,,,,,,,,,,,,,,,,8,,,,,,,,,,,,,,,,,,,,,,,,,,,,,,,,,6,,,,,,,,,,,,,,,,,,,,,,,,,,,,,,,,,1,2.0,4.0,2.0,5.0,1.0,3.0,6.0,2.0,5.0,3.0,3.0,3.0,2.0,2.0,2.0,2.0,5.0,3.0,4.0,2.0,3.0,3.0,5.0,5.0,2.0,6.0,2.0,2.0,6.0,5.0,6.0,4.0,7,,,,,,,,,,,,,,,,,,,,,,,,,,,,,,,,,12,,,,,,,,,,,,,,,,,,,,,,,,,,,,,,,,,2,2.0,5.0,3.0,5.0,3.0,2.0,1.0,5.0,6.0,2.0,3.0,5.0,3.0,5.0,3.0,2.0,5.0,3.0,2.0,2.0,3.0,3.0,3.0,2.0,3.0,3.0,2.0,5.0,3.0,2.0,5.0,7.0,11,,,,,,,,,,,,,,,,,,,,,,,,,,,,,,,,,,242.73,21.38,,,,8.56,,38.62,,61.39,,,,,,,,,,,,,,,,,,,,,,,,,,,,,,56.07,,,,,,,,,54.11,,,,,,2.6,,APPROVED,Male,19.0,FALSE
740,2022-03-22 01:51:52,19,en,526088530,2022-03-22 01:46:39,2022-03-22 01:51:52,Y,Y,A1,,,7,,,,,,,,,,,,,,,,,,,,,,,,,,,,,,,,,14,,,,,,,,,,,,,,,,,,,,,,,,,,,,,,,,,10,,,,,,,,,,,,,,,,,,,,,,,,,,,,,,,,,13,,,,,,,,,,,,,,,,,,,,,,,,,,,,,,,,,2,3.0,2.0,5.0,2.0,3.0,3.0,6.0,5.0,5.0,5.0,3.0,5.0,6.0,3.0,5.0,2.0,3.0,3.0,3.0,3.0,2.0,5.0,3.0,5.0,5.0,2.0,2.0,3.0,2.0,3.0,3.0,5.0,1,6.0,5.0,6.0,7.0,5.0,7.0,2.0,7.0,5.0,5.0,6.0,6.0,6.0,6.0,6.0,5.0,6.0,6.0,6.0,6.0,5.0,6.0,7.0,6.0,6.0,7.0,5.0,6.0,6.0,6.0,6.0,6.0,4,,,,,,,,,,,,,,,,,,,,,,,,,,,,,,,,,3,,,,,,,,,,,,,,,,,,,,,,,,,,,,,,,,,12,,,,,,,,,,,,,,,,,,,,,,,,,,,,,,,,,11,,,,,,,,,,,,,,,,,,,,,,,,,,,,,,,,,5,,,,,,,,,,,,,,,,,,,,,,,,,,,,,,,,,0,5.0,6.0,5.0,5.0,5.0,5.0,2.0,6.0,6.0,5.0,5.0,3.0,5.0,3.0,6.0,3.0,5.0,5.0,5.0,5.0,2.0,5.0,6.0,5.0,5.0,5.0,3.0,5.0,6.0,5.0,5.0,5.0,8,,,,,,,,,,,,,,,,,,,,,,,,,,,,,,,,,9,,,,,,,,,,,,,,,,,,,,,,,,,,,,,,,,,6,,,,,,,,,,,,,,,,,,,,,,,,,,,,,,,,,,316.2,15.13,,,,4.22,,30.34,,,,,,,,,,,,,,83.37,,,79.73,,,,,,,,,,,,,,,,,,100.69,,,,,,,,,,,,2.72,,APPROVED,Female,31.0,FALSE
741,2022-03-22 02:09:29,19,en,989583144,2022-03-22 01:46:39,2022-03-22 02:09:29,Y,Y,A1,,,3,,,,,,,,,,,,,,,,,,,,,,,,,,,,,,,,,1,5.0,4.0,6.0,6.0,6.0,6.0,4.0,6.0,4.0,5.0,7.0,5.0,6.0,6.0,5.0,7.0,7.0,6.0,5.0,6.0,6.0,6.0,7.0,5.0,6.0,7.0,6.0,6.0,5.0,6.0,6.0,2.0,5,,,,,,,,,,,,,,,,,,,,,,,,,,,,,,,,,0,3.0,5.0,4.0,1.0,3.0,2.0,3.0,2.0,4.0,1.0,2.0,2.0,3.0,4.0,4.0,1.0,4.0,3.0,2.0,1.0,2.0,2.0,1.0,1.0,4.0,4.0,2.0,2.0,3.0,3.0,2.0,4.0,12,,,,,,,,,,,,,,,,,,,,,,,,,,,,,,,,,11,,,,,,,,,,,,,,,,,,,,,,,,,,,,,,,,,7,,,,,,,,,,,,,,,,,,,,,,,,,,,,,,,,,14,,,,,,,,,,,,,,,,,,,,,,,,,,,,,,,,,8,,,,,,,,,,,,,,,,,,,,,,,,,,,,,,,,,9,,,,,,,,,,,,,,,,,,,,,,,,,,,,,,,,,10,,,,,,,,,,,,,,,,,,,,,,,,,,,,,,,,,4,,,,,,,,,,,,,,,,,,,,,,,,,,,,,,,,,13,,,,,,,,,,,,,,,,,,,,,,,,,,,,,,,,,2,4.0,5.0,4.0,4.0,3.0,3.0,5.0,5.0,5.0,4.0,3.0,4.0,5.0,5.0,4.0,4.0,5.0,3.0,4.0,4.0,4.0,5.0,5.0,4.0,4.0,3.0,4.0,4.0,2.0,4.0,4.0,7.0,6,,,,,,,,,,,,,,,,,,,,,,,,,,,,,,,,,,1374.77,203.54,,,,14.33,,373.55,,,,,300.17,,,,,,389.64,,,,,,,,,,,,,,,,,,,,,,,,,,,,,,88.81,,,,,,4.73,,APPROVED,Female,24.0,FALSE
743,2022-03-22 01:51:54,19,en,767227151,2022-03-22 01:46:42,2022-03-22 01:51:54,Y,Y,A1,,,13,,,,,,,,,,,,,,,,,,,,,,,,,,,,,,,,,9,,,,,,,,,,,,,,,,,,,,,,,,,,,,,,,,,0,1.0,4.0,1.0,2.0,1.0,1.0,7.0,5.0,4.0,1.0,1.0,2.0,1.0,1.0,1.0,1.0,4.0,1.0,1.0,1.0,1.0,1.0,1.0,1.0,1.0,4.0,7.0,1.0,2.0,4.0,1.0,3.0,12,,,,,,,,,,,,,,,,,,,,,,,,,,,,,,,,,6,,,,,,,,,,,,,,,,,,,,,,,,,,,,,,,,,1,6.0,7.0,7.0,4.0,7.0,2.0,6.0,6.0,7.0,5.0,2.0,6.0,5.0,4.0,7.0,5.0,7.0,5.0,6.0,4.0,4.0,4.0,4.0,6.0,7.0,4.0,6.0,4.0,7.0,6.0,6.0,6.0,2,1.0,5.0,1.0,6.0,1.0,1.0,6.0,7.0,5.0,1.0,2.0,1.0,1.0,1.0,2.0,2.0,1.0,1.0,1.0,1.0,1.0,1.0,6.0,1.0,1.0,5.0,7.0,1.0,1.0,1.0,4.0,7.0,3,,,,,,,,,,,,,,,,,,,,,,,,,,,,,,,,,11,,,,,,,,,,,,,,,,,,,,,,,,,,,,,,,,,14,,,,,,,,,,,,,,,,,,,,,,,,,,,,,,,,,7,,,,,,,,,,,,,,,,,,,,,,,,,,,,,,,,,5,,,,,,,,,,,,,,,,,,,,,,,,,,,,,,,,,8,,,,,,,,,,,,,,,,,,,,,,,,,,,,,,,,,4,,,,,,,,,,,,,,,,,,,,,,,,,,,,,,,,,10,,,,,,,,,,,,,,,,,,,,,,,,,,,,,,,,,,315.91,12.32,,,,5.78,,27.26,,,,,,,,102.04,,,,,,,,,96.7,,,66.21,,,,,,,,,,,,,,,,,,,,,,,,,,,5.6,,APPROVED,Male,48.0,FALSE
744,2022-03-22 01:51:11,19,en,2069920131,2022-03-22 01:46:43,2022-03-22 01:51:11,Y,Y,A1,,,7,,,,,,,,,,,,,,,,,,,,,,,,,,,,,,,,,5,,,,,,,,,,,,,,,,,,,,,,,,,,,,,,,,,2,6.0,6.0,6.0,7.0,6.0,7.0,6.0,6.0,6.0,5.0,7.0,6.0,5.0,5.0,6.0,6.0,6.0,6.0,6.0,6.0,6.0,5.0,7.0,6.0,6.0,7.0,3.0,3.0,6.0,6.0,7.0,3.0,13,,,,,,,,,,,,,,,,,,,,,,,,,,,,,,,,,9,,,,,,,,,,,,,,,,,,,,,,,,,,,,,,,,,8,,,,,,,,,,,,,,,,,,,,,,,,,,,,,,,,,4,,,,,,,,,,,,,,,,,,,,,,,,,,,,,,,,,10,,,,,,,,,,,,,,,,,,,,,,,,,,,,,,,,,0,5.0,5.0,5.0,5.0,2.0,3.0,5.0,6.0,5.0,3.0,3.0,5.0,1.0,4.0,5.0,5.0,5.0,5.0,3.0,2.0,6.0,3.0,6.0,2.0,1.0,2.0,5.0,3.0,6.0,5.0,3.0,2.0,1,6.0,5.0,6.0,6.0,7.0,1.0,5.0,3.0,5.0,5.0,6.0,6.0,6.0,6.0,6.0,6.0,5.0,6.0,6.0,6.0,4.0,5.0,5.0,6.0,5.0,6.0,5.0,6.0,6.0,6.0,5.0,3.0,14,,,,,,,,,,,,,,,,,,,,,,,,,,,,,,,,,3,,,,,,,,,,,,,,,,,,,,,,,,,,,,,,,,,12,,,,,,,,,,,,,,,,,,,,,,,,,,,,,,,,,6,,,,,,,,,,,,,,,,,,,,,,,,,,,,,,,,,11,,,,,,,,,,,,,,,,,,,,,,,,,,,,,,,,,,272.44,11.77,,,,7.1,,33.94,,,,,,,,65.24,,,,,,,,,,,,,,,,,,91.41,,,58.75,,,,,,,,,,,,,,,,,,4.23,,APPROVED,Male,22.0,FALSE
746,2022-03-22 02:04:31,19,en,865467612,2022-03-22 01:46:46,2022-03-22 02:04:31,Y,Y,A1,,,10,,,,,,,,,,,,,,,,,,,,,,,,,,,,,,,,,6,,,,,,,,,,,,,,,,,,,,,,,,,,,,,,,,,11,,,,,,,,,,,,,,,,,,,,,,,,,,,,,,,,,8,,,,,,,,,,,,,,,,,,,,,,,,,,,,,,,,,14,,,,,,,,,,,,,,,,,,,,,,,,,,,,,,,,,12,,,,,,,,,,,,,,,,,,,,,,,,,,,,,,,,,2,1.0,1.0,1.0,2.0,2.0,2.0,1.0,5.0,1.0,1.0,1.0,1.0,1.0,2.0,1.0,1.0,1.0,1.0,1.0,1.0,1.0,2.0,6.0,1.0,1.0,1.0,1.0,1.0,1.0,1.0,1.0,7.0,3,,,,,,,,,,,,,,,,,,,,,,,,,,,,,,,,,9,,,,,,,,,,,,,,,,,,,,,,,,,,,,,,,,,1,6.0,6.0,5.0,7.0,4.0,7.0,2.0,7.0,6.0,3.0,7.0,6.0,7.0,5.0,6.0,6.0,6.0,7.0,6.0,5.0,5.0,5.0,7.0,6.0,5.0,7.0,7.0,7.0,7.0,7.0,7.0,3.0,4,,,,,,,,,,,,,,,,,,,,,,,,,,,,,,,,,5,,,,,,,,,,,,,,,,,,,,,,,,,,,,,,,,,7,,,,,,,,,,,,,,,,,,,,,,,,,,,,,,,,,13,,,,,,,,,,,,,,,,,,,,,,,,,,,,,,,,,0,5.0,3.0,6.0,3.0,5.0,5.0,2.0,7.0,6.0,2.0,2.0,6.0,5.0,2.0,5.0,2.0,6.0,6.0,6.0,3.0,2.0,5.0,2.0,4.0,2.0,7.0,6.0,3.0,6.0,3.0,2.0,1.0,,1070.01,131.96,,,,10.85,,197.26,,,,,,,,,,,,,,,,,,,,263.4,,,,,,,,,167.36,,,,,,,,,,,,,,,292.3,,,6.88,,APPROVED,Female,29.0,FALSE
747,2022-03-22 01:59:23,19,en,2034539105,2022-03-22 01:46:52,2022-03-22 01:59:23,Y,Y,A1,,,13,,,,,,,,,,,,,,,,,,,,,,,,,,,,,,,,,8,,,,,,,,,,,,,,,,,,,,,,,,,,,,,,,,,0,6.0,6.0,7.0,7.0,5.0,6.0,2.0,7.0,5.0,5.0,4.0,6.0,6.0,5.0,6.0,5.0,6.0,4.0,4.0,4.0,4.0,5.0,4.0,5.0,6.0,4.0,5.0,7.0,5.0,5.0,5.0,3.0,4,,,,,,,,,,,,,,,,,,,,,,,,,,,,,,,,,6,,,,,,,,,,,,,,,,,,,,,,,,,,,,,,,,,11,,,,,,,,,,,,,,,,,,,,,,,,,,,,,,,,,9,,,,,,,,,,,,,,,,,,,,,,,,,,,,,,,,,5,,,,,,,,,,,,,,,,,,,,,,,,,,,,,,,,,2,2.0,1.0,1.0,6.0,5.0,6.0,3.0,1.0,1.0,2.0,4.0,2.0,3.0,1.0,2.0,4.0,5.0,2.0,4.0,2.0,3.0,4.0,6.0,5.0,1.0,6.0,5.0,5.0,6.0,5.0,5.0,2.0,3,,,,,,,,,,,,,,,,,,,,,,,,,,,,,,,,,10,,,,,,,,,,,,,,,,,,,,,,,,,,,,,,,,,14,,,,,,,,,,,,,,,,,,,,,,,,,,,,,,,,,12,,,,,,,,,,,,,,,,,,,,,,,,,,,,,,,,,1,2.0,5.0,3.0,5.0,2.0,7.0,1.0,3.0,5.0,3.0,2.0,6.0,4.0,2.0,4.0,4.0,6.0,2.0,3.0,2.0,4.0,4.0,6.0,3.0,2.0,5.0,4.0,3.0,6.0,4.0,5.0,7.0,7,,,,,,,,,,,,,,,,,,,,,,,,,,,,,,,,,,755.14,23.94,,,,21.51,,47.94,,,,,,,,485.53,,,,,,,,,,,,,,,,,,83.03,,,,,,,,,,,,,,,89.63,,,,,,3.56,,APPROVED,Female,21.0,FALSE
748,2022-03-22 01:55:50,19,en,2130440057,2022-03-22 01:47:17,2022-03-22 01:55:50,Y,Y,A1,,,11,,,,,,,,,,,,,,,,,,,,,,,,,,,,,,,,,3,,,,,,,,,,,,,,,,,,,,,,,,,,,,,,,,,0,7.0,7.0,6.0,6.0,6.0,6.0,5.0,7.0,6.0,5.0,6.0,6.0,6.0,6.0,7.0,7.0,7.0,6.0,6.0,4.0,3.0,6.0,3.0,7.0,7.0,4.0,7.0,7.0,7.0,6.0,3.0,3.0,8,,,,,,,,,,,,,,,,,,,,,,,,,,,,,,,,,4,,,,,,,,,,,,,,,,,,,,,,,,,,,,,,,,,10,,,,,,,,,,,,,,,,,,,,,,,,,,,,,,,,,14,,,,,,,,,,,,,,,,,,,,,,,,,,,,,,,,,12,,,,,,,,,,,,,,,,,,,,,,,,,,,,,,,,,13,,,,,,,,,,,,,,,,,,,,,,,,,,,,,,,,,2,1.0,1.0,1.0,1.0,1.0,1.0,7.0,4.0,2.0,2.0,2.0,1.0,1.0,1.0,2.0,1.0,1.0,1.0,2.0,1.0,2.0,1.0,1.0,1.0,1.0,2.0,3.0,2.0,3.0,2.0,1.0,3.0,6,,,,,,,,,,,,,,,,,,,,,,,,,,,,,,,,,7,,,,,,,,,,,,,,,,,,,,,,,,,,,,,,,,,1,6.0,3.0,4.0,4.0,3.0,6.0,5.0,5.0,6.0,6.0,6.0,6.0,6.0,5.0,5.0,4.0,6.0,6.0,4.0,3.0,3.0,6.0,5.0,6.0,6.0,7.0,6.0,6.0,7.0,6.0,4.0,6.0,5,,,,,,,,,,,,,,,,,,,,,,,,,,,,,,,,,9,,,,,,,,,,,,,,,,,,,,,,,,,,,,,,,,,,515.37,19.07,,,,6.53,,40.14,,,,,,,,280.44,,,,,,,,,,,,,,,,,,,,,81.25,,,,,,,,,85.73,,,,,,,,,2.21,,APPROVED,Male,21.0,FALSE
749,2022-03-22 01:56:19,19,en,750839157,2022-03-22 01:48:04,2022-03-22 01:56:19,Y,Y,A2,,,11,,,,,,,,,,,,,,,,,,,,,,,,,,,,,,,,,0,5.0,2.0,5.0,5.0,3.0,5.0,2.0,6.0,3.0,3.0,4.0,5.0,5.0,3.0,4.0,6.0,5.0,5.0,5.0,4.0,4.0,6.0,5.0,6.0,4.0,6.0,4.0,5.0,5.0,5.0,5.0,2.0,6,,,,,,,,,,,,,,,,,,,,,,,,,,,,,,,,,14,,,,,,,,,,,,,,,,,,,,,,,,,,,,,,,,,3,,,,,,,,,,,,,,,,,,,,,,,,,,,,,,,,,8,,,,,,,,,,,,,,,,,,,,,,,,,,,,,,,,,13,,,,,,,,,,,,,,,,,,,,,,,,,,,,,,,,,10,,,,,,,,,,,,,,,,,,,,,,,,,,,,,,,,,2,1.0,3.0,1.0,3.0,1.0,2.0,7.0,2.0,4.0,1.0,2.0,2.0,2.0,2.0,3.0,3.0,4.0,2.0,2.0,1.0,2.0,2.0,4.0,2.0,1.0,2.0,4.0,2.0,2.0,3.0,3.0,2.0,4,,,,,,,,,,,,,,,,,,,,,,,,,,,,,,,,,5,,,,,,,,,,,,,,,,,,,,,,,,,,,,,,,,,1,3.0,5.0,3.0,4.0,3.0,4.0,4.0,3.0,5.0,3.0,4.0,3.0,3.0,4.0,5.0,4.0,5.0,3.0,3.0,3.0,4.0,3.0,4.0,3.0,3.0,4.0,5.0,3.0,4.0,3.0,4.0,5.0,9,,,,,,,,,,,,,,,,,,,,,,,,,,,,,,,,,7,,,,,,,,,,,,,,,,,,,,,,,,,,,,,,,,,12,,,,,,,,,,,,,,,,,,,,,,,,,,,,,,,,,,497.22,32.15,,,,6.13,,43.35,,,,,132.34,,,,,,,,,,,,,,,,,,,,,171.32,,,,,,,,,102.64,,,,,,,,,,,,9.29,,APPROVED,Female,36.0,FALSE
750,2022-03-22 01:56:40,19,en,1886954489,2022-03-22 01:48:41,2022-03-22 01:56:40,Y,Y,-oth-,,,6,,,,,,,,,,,,,,,,,,,,,,,,,,,,,,,,,9,,,,,,,,,,,,,,,,,,,,,,,,,,,,,,,,,10,,,,,,,,,,,,,,,,,,,,,,,,,,,,,,,,,8,,,,,,,,,,,,,,,,,,,,,,,,,,,,,,,,,13,,,,,,,,,,,,,,,,,,,,,,,,,,,,,,,,,12,,,,,,,,,,,,,,,,,,,,,,,,,,,,,,,,,11,,,,,,,,,,,,,,,,,,,,,,,,,,,,,,,,,5,,,,,,,,,,,,,,,,,,,,,,,,,,,,,,,,,3,,,,,,,,,,,,,,,,,,,,,,,,,,,,,,,,,2,3.0,5.0,3.0,4.0,3.0,3.0,6.0,6.0,4.0,2.0,3.0,3.0,2.0,3.0,5.0,3.0,5.0,2.0,2.0,3.0,3.0,3.0,3.0,2.0,4.0,3.0,4.0,3.0,6.0,3.0,3.0,3.0,14,,,,,,,,,,,,,,,,,,,,,,,,,,,,,,,,,7,,,,,,,,,,,,,,,,,,,,,,,,,,,,,,,,,0,3.0,5.0,2.0,3.0,2.0,2.0,5.0,6.0,5.0,3.0,3.0,3.0,3.0,5.0,5.0,4.0,5.0,3.0,3.0,2.0,3.0,3.0,3.0,3.0,2.0,3.0,4.0,3.0,5.0,4.0,2.0,6.0,4,,,,,,,,,,,,,,,,,,,,,,,,,,,,,,,,,1,3.0,6.0,3.0,2.0,5.0,3.0,5.0,5.0,6.0,4.0,3.0,5.0,5.0,5.0,5.0,3.0,5.0,3.0,4.0,3.0,4.0,5.0,3.0,3.0,6.0,3.0,5.0,4.0,5.0,5.0,4.0,1.0,,482.14,135.12,,,,8.65,,37.19,,,,,,,,,,,,,,,,,,,,,,,,,,,,,100.57,,,,,,,,,96.67,,,,,,100.16,,,3.78,,APPROVED,Male,39.0,FALSE
751,2022-03-22 01:55:54,19,en,1386481699,2022-03-22 01:49:16,2022-03-22 01:55:54,Y,Y,A1,,,11,,,,,,,,,,,,,,,,,,,,,,,,,,,,,,,,,9,,,,,,,,,,,,,,,,,,,,,,,,,,,,,,,,,13,,,,,,,,,,,,,,,,,,,,,,,,,,,,,,,,,0,3.0,7.0,4.0,3.0,4.0,2.0,6.0,5.0,7.0,4.0,4.0,6.0,5.0,4.0,5.0,5.0,6.0,7.0,6.0,3.0,4.0,4.0,3.0,5.0,4.0,3.0,7.0,3.0,3.0,5.0,5.0,4.0,7,,,,,,,,,,,,,,,,,,,,,,,,,,,,,,,,,2,4.0,6.0,5.0,5.0,5.0,4.0,5.0,6.0,6.0,6.0,3.0,5.0,5.0,3.0,5.0,4.0,5.0,6.0,6.0,5.0,6.0,5.0,3.0,5.0,6.0,4.0,6.0,5.0,4.0,5.0,5.0,6.0,8,,,,,,,,,,,,,,,,,,,,,,,,,,,,,,,,,4,,,,,,,,,,,,,,,,,,,,,,,,,,,,,,,,,10,,,,,,,,,,,,,,,,,,,,,,,,,,,,,,,,,5,,,,,,,,,,,,,,,,,,,,,,,,,,,,,,,,,14,,,,,,,,,,,,,,,,,,,,,,,,,,,,,,,,,12,,,,,,,,,,,,,,,,,,,,,,,,,,,,,,,,,3,,,,,,,,,,,,,,,,,,,,,,,,,,,,,,,,,6,,,,,,,,,,,,,,,,,,,,,,,,,,,,,,,,,1,4.0,6.0,2.0,4.0,4.0,2.0,4.0,4.0,6.0,4.0,2.0,3.0,2.0,4.0,4.0,4.0,4.0,4.0,3.0,4.0,4.0,4.0,2.0,4.0,2.0,4.0,7.0,4.0,4.0,4.0,6.0,1.0,great study thanks for letting me participate,401.41,27.9,,,,7.83,,43.83,,,,,,,,,,,117.08,,,,,,111.99,,,,,,,,,,,,,,,,,,,,,,,,,,,68.38,,,24.4,,APPROVED,Female,26.0,FALSE
752,2022-03-22 01:52:31,19,en,567062955,2022-03-22 01:49:17,2022-03-22 01:52:31,Y,Y,A1,,,9,,,,,,,,,,,,,,,,,,,,,,,,,,,,,,,,,3,,,,,,,,,,,,,,,,,,,,,,,,,,,,,,,,,12,,,,,,,,,,,,,,,,,,,,,,,,,,,,,,,,,13,,,,,,,,,,,,,,,,,,,,,,,,,,,,,,,,,4,,,,,,,,,,,,,,,,,,,,,,,,,,,,,,,,,10,,,,,,,,,,,,,,,,,,,,,,,,,,,,,,,,,7,,,,,,,,,,,,,,,,,,,,,,,,,,,,,,,,,1,4.0,4.0,3.0,3.0,5.0,5.0,4.0,5.0,5.0,5.0,5.0,5.0,4.0,3.0,5.0,4.0,4.0,5.0,5.0,6.0,5.0,5.0,3.0,3.0,5.0,5.0,4.0,4.0,4.0,3.0,5.0,1.0,6,,,,,,,,,,,,,,,,,,,,,,,,,,,,,,,,,0,3.0,4.0,2.0,2.0,2.0,2.0,6.0,2.0,3.0,1.0,2.0,3.0,3.0,2.0,4.0,2.0,5.0,3.0,3.0,1.0,3.0,3.0,4.0,4.0,3.0,4.0,1.0,5.0,2.0,2.0,3.0,3.0,8,,,,,,,,,,,,,,,,,,,,,,,,,,,,,,,,,2,5.0,4.0,5.0,4.0,6.0,6.0,3.0,4.0,6.0,5.0,6.0,5.0,3.0,4.0,5.0,4.0,6.0,5.0,5.0,3.0,5.0,4.0,4.0,5.0,6.0,5.0,3.0,5.0,6.0,5.0,4.0,5.0,14,,,,,,,,,,,,,,,,,,,,,,,,,,,,,,,,,11,,,,,,,,,,,,,,,,,,,,,,,,,,,,,,,,,5,,,,,,,,,,,,,,,,,,,,,,,,,,,,,,,,,,196.57,20.22,,,,7.02,,30.81,,,,,,,,,,,,,,,,,,,,,,,28.22,,,,,,75.06,,,,,,32.58,,,,,,,,,,,,2.66,,APPROVED,Male,23.0,FALSE
753,2022-03-22 01:55:04,19,en,1779812537,2022-03-22 01:49:17,2022-03-22 01:55:04,Y,Y,A1,,,10,,,,,,,,,,,,,,,,,,,,,,,,,,,,,,,,,13,,,,,,,,,,,,,,,,,,,,,,,,,,,,,,,,,7,,,,,,,,,,,,,,,,,,,,,,,,,,,,,,,,,9,,,,,,,,,,,,,,,,,,,,,,,,,,,,,,,,,14,,,,,,,,,,,,,,,,,,,,,,,,,,,,,,,,,2,5.0,5.0,5.0,5.0,4.0,5.0,3.0,5.0,5.0,5.0,5.0,6.0,5.0,5.0,5.0,5.0,5.0,5.0,5.0,5.0,5.0,5.0,6.0,5.0,5.0,5.0,4.0,5.0,5.0,5.0,6.0,6.0,1,5.0,4.0,3.0,5.0,4.0,5.0,4.0,3.0,5.0,4.0,4.0,4.0,4.0,4.0,4.0,4.0,4.0,4.0,4.0,3.0,4.0,4.0,4.0,4.0,3.0,4.0,4.0,3.0,4.0,3.0,4.0,7.0,8,,,,,,,,,,,,,,,,,,,,,,,,,,,,,,,,,11,,,,,,,,,,,,,,,,,,,,,,,,,,,,,,,,,3,,,,,,,,,,,,,,,,,,,,,,,,,,,,,,,,,6,,,,,,,,,,,,,,,,,,,,,,,,,,,,,,,,,12,,,,,,,,,,,,,,,,,,,,,,,,,,,,,,,,,4,,,,,,,,,,,,,,,,,,,,,,,,,,,,,,,,,0,3.0,3.0,3.0,5.0,4.0,4.0,3.0,5.0,5.0,3.0,4.0,4.0,3.0,3.0,6.0,4.0,4.0,4.0,4.0,3.0,4.0,4.0,5.0,3.0,4.0,4.0,4.0,3.0,4.0,4.0,3.0,7.0,5,,,,,,,,,,,,,,,,,,,,,,,,,,,,,,,,,:),350.56,109.34,,,,8.68,,41.68,,,,,,,,,,,,,,,,,58.53,,,52.25,,,,,,,,,,,,,,,,,,,,,71.81,,,,,,8.27,,APPROVED,Male,31.0,FALSE
754,2022-03-22 01:57:16,19,en,1484267258,2022-03-22 01:49:18,2022-03-22 01:57:16,Y,Y,-oth-,Currently stydying for a bachelor degree,,8,,,,,,,,,,,,,,,,,,,,,,,,,,,,,,,,,13,,,,,,,,,,,,,,,,,,,,,,,,,,,,,,,,,1,5.0,6.0,5.0,5.0,6.0,5.0,6.0,6.0,6.0,3.0,5.0,6.0,5.0,5.0,4.0,5.0,5.0,5.0,4.0,4.0,4.0,5.0,6.0,6.0,5.0,5.0,4.0,6.0,3.0,4.0,6.0,3.0,7,,,,,,,,,,,,,,,,,,,,,,,,,,,,,,,,,6,,,,,,,,,,,,,,,,,,,,,,,,,,,,,,,,,4,,,,,,,,,,,,,,,,,,,,,,,,,,,,,,,,,2,4.0,5.0,4.0,6.0,3.0,5.0,3.0,6.0,6.0,3.0,5.0,6.0,4.0,5.0,5.0,5.0,6.0,4.0,4.0,4.0,4.0,4.0,6.0,6.0,3.0,5.0,4.0,6.0,5.0,3.0,5.0,7.0,1,3.0,5.0,4.0,4.0,4.0,3.0,6.0,5.0,5.0,3.0,5.0,5.0,4.0,4.0,5.0,3.0,5.0,3.0,4.0,3.0,3.0,5.0,5.0,5.0,2.0,5.0,3.0,2.0,4.0,4.0,5.0,1.0,10,,,,,,,,,,,,,,,,,,,,,,,,,,,,,,,,,12,,,,,,,,,,,,,,,,,,,,,,,,,,,,,,,,,9,,,,,,,,,,,,,,,,,,,,,,,,,,,,,,,,,11,,,,,,,,,,,,,,,,,,,,,,,,,,,,,,,,,5,,,,,,,,,,,,,,,,,,,,,,,,,,,,,,,,,14,,,,,,,,,,,,,,,,,,,,,,,,,,,,,,,,,3,,,,,,,,,,,,,,,,,,,,,,,,,,,,,,,,,,482.63,36.36,,,,45.2,,31.9,,,,,,,,95.79,,,,,,,,,,,,99.79,,,169.82,,,,,,,,,,,,,,,,,,,,,,,,3.77,,APPROVED,Male,20.0,FALSE
755,2022-03-22 01:56:11,19,en,920399032,2022-03-22 01:49:21,2022-03-22 01:56:11,Y,Y,A1,,,4,,,,,,,,,,,,,,,,,,,,,,,,,,,,,,,,,11,,,,,,,,,,,,,,,,,,,,,,,,,,,,,,,,,8,,,,,,,,,,,,,,,,,,,,,,,,,,,,,,,,,10,,,,,,,,,,,,,,,,,,,,,,,,,,,,,,,,,9,,,,,,,,,,,,,,,,,,,,,,,,,,,,,,,,,12,,,,,,,,,,,,,,,,,,,,,,,,,,,,,,,,,0,5.0,7.0,7.0,3.0,5.0,2.0,5.0,5.0,7.0,4.0,4.0,6.0,5.0,6.0,7.0,6.0,7.0,5.0,4.0,4.0,4.0,4.0,3.0,5.0,5.0,4.0,1.0,7.0,7.0,4.0,7.0,7.0,5,,,,,,,,,,,,,,,,,,,,,,,,,,,,,,,,,6,,,,,,,,,,,,,,,,,,,,,,,,,,,,,,,,,3,,,,,,,,,,,,,,,,,,,,,,,,,,,,,,,,,1,5.0,5.0,5.0,3.0,5.0,2.0,2.0,6.0,4.0,5.0,5.0,5.0,5.0,5.0,5.0,2.0,5.0,7.0,5.0,5.0,4.0,4.0,3.0,5.0,6.0,2.0,1.0,4.0,2.0,2.0,1.0,4.0,2,7.0,2.0,7.0,4.0,7.0,6.0,1.0,2.0,2.0,5.0,7.0,6.0,7.0,2.0,7.0,4.0,7.0,7.0,7.0,6.0,4.0,7.0,7.0,4.0,7.0,7.0,1.0,7.0,7.0,4.0,7.0,5.0,7,,,,,,,,,,,,,,,,,,,,,,,,,,,,,,,,,13,,,,,,,,,,,,,,,,,,,,,,,,,,,,,,,,,14,,,,,,,,,,,,,,,,,,,,,,,,,,,,,,,,,,414.51,44.92,,,,5.78,,38.38,,,,,,,,,,,,,,,,,,,,107.72,,,,,,,,,,,,121.95,,,91.53,,,,,,,,,,,,4.23,,APPROVED,Male,22.0,FALSE
756,2022-03-22 01:54:32,19,en,1705556086,2022-03-22 01:49:23,2022-03-22 01:54:32,Y,Y,A1,,,14,,,,,,,,,,,,,,,,,,,,,,,,,,,,,,,,,12,,,,,,,,,,,,,,,,,,,,,,,,,,,,,,,,,2,7.0,7.0,6.0,7.0,6.0,7.0,5.0,7.0,5.0,7.0,7.0,6.0,7.0,7.0,6.0,7.0,6.0,6.0,7.0,5.0,5.0,6.0,6.0,7.0,5.0,7.0,6.0,7.0,5.0,7.0,6.0,3.0,3,,,,,,,,,,,,,,,,,,,,,,,,,,,,,,,,,10,,,,,,,,,,,,,,,,,,,,,,,,,,,,,,,,,9,,,,,,,,,,,,,,,,,,,,,,,,,,,,,,,,,4,,,,,,,,,,,,,,,,,,,,,,,,,,,,,,,,,8,,,,,,,,,,,,,,,,,,,,,,,,,,,,,,,,,1,1.0,1.0,1.0,1.0,1.0,2.0,2.0,1.0,2.0,1.0,3.0,1.0,1.0,1.0,1.0,2.0,1.0,1.0,1.0,1.0,1.0,1.0,4.0,2.0,1.0,3.0,2.0,2.0,1.0,1.0,2.0,2.0,7,,,,,,,,,,,,,,,,,,,,,,,,,,,,,,,,,5,,,,,,,,,,,,,,,,,,,,,,,,,,,,,,,,,11,,,,,,,,,,,,,,,,,,,,,,,,,,,,,,,,,6,,,,,,,,,,,,,,,,,,,,,,,,,,,,,,,,,13,,,,,,,,,,,,,,,,,,,,,,,,,,,,,,,,,0,5.0,5.0,7.0,5.0,3.0,6.0,5.0,1.0,4.0,6.0,6.0,6.0,3.0,4.0,3.0,6.0,5.0,3.0,5.0,6.0,4.0,4.0,4.0,6.0,3.0,4.0,2.0,6.0,2.0,6.0,6.0,1.0,,312.17,63.81,,,,6.0,,25.94,,,,,,,,94.2,,,,,,,,,,,,,,,,,,54.23,,,,,,,,,,,,,,,,,,64.43,,,3.56,,APPROVED,Male,21.0,FALSE
757,2022-03-22 01:54:29,19,en,593523602,2022-03-22 01:49:23,2022-03-22 01:54:29,Y,Y,-oth-,a levels,,12,,,,,,,,,,,,,,,,,,,,,,,,,,,,,,,,,8,,,,,,,,,,,,,,,,,,,,,,,,,,,,,,,,,7,,,,,,,,,,,,,,,,,,,,,,,,,,,,,,,,,2,5.0,6.0,5.0,4.0,5.0,5.0,4.0,6.0,6.0,5.0,5.0,5.0,5.0,6.0,6.0,5.0,6.0,5.0,5.0,5.0,4.0,5.0,4.0,5.0,7.0,5.0,6.0,6.0,5.0,4.0,3.0,4.0,5,,,,,,,,,,,,,,,,,,,,,,,,,,,,,,,,,9,,,,,,,,,,,,,,,,,,,,,,,,,,,,,,,,,4,,,,,,,,,,,,,,,,,,,,,,,,,,,,,,,,,11,,,,,,,,,,,,,,,,,,,,,,,,,,,,,,,,,13,,,,,,,,,,,,,,,,,,,,,,,,,,,,,,,,,0,1.0,3.0,1.0,4.0,2.0,1.0,7.0,1.0,1.0,1.0,1.0,1.0,1.0,1.0,2.0,1.0,1.0,1.0,1.0,1.0,1.0,1.0,1.0,1.0,1.0,2.0,5.0,1.0,3.0,4.0,1.0,3.0,10,,,,,,,,,,,,,,,,,,,,,,,,,,,,,,,,,1,1.0,2.0,3.0,2.0,2.0,1.0,3.0,1.0,2.0,1.0,1.0,2.0,1.0,2.0,2.0,1.0,3.0,1.0,1.0,1.0,1.0,3.0,2.0,2.0,3.0,4.0,3.0,1.0,1.0,4.0,1.0,5.0,6,,,,,,,,,,,,,,,,,,,,,,,,,,,,,,,,,14,,,,,,,,,,,,,,,,,,,,,,,,,,,,,,,,,3,,,,,,,,,,,,,,,,,,,,,,,,,,,,,,,,,,309.93,19.94,,,,15.53,,23.69,,,,,,,,,,,78.37,,,,,,,,,,,,,,,,,,85.63,,,,,,83.06,,,,,,,,,,,,3.71,,APPROVED,Female,61.0,FALSE
758,2022-03-22 02:00:52,19,en,762402702,2022-03-22 01:49:25,2022-03-22 02:00:52,Y,Y,A1,,,6,,,,,,,,,,,,,,,,,,,,,,,,,,,,,,,,,10,,,,,,,,,,,,,,,,,,,,,,,,,,,,,,,,,2,7.0,5.0,7.0,7.0,6.0,7.0,3.0,7.0,7.0,6.0,5.0,7.0,7.0,6.0,7.0,7.0,7.0,7.0,7.0,5.0,6.0,6.0,7.0,7.0,7.0,5.0,6.0,7.0,5.0,4.0,6.0,3.0,14,,,,,,,,,,,,,,,,,,,,,,,,,,,,,,,,,7,,,,,,,,,,,,,,,,,,,,,,,,,,,,,,,,,13,,,,,,,,,,,,,,,,,,,,,,,,,,,,,,,,,12,,,,,,,,,,,,,,,,,,,,,,,,,,,,,,,,,8,,,,,,,,,,,,,,,,,,,,,,,,,,,,,,,,,5,,,,,,,,,,,,,,,,,,,,,,,,,,,,,,,,,1,6.0,6.0,6.0,3.0,5.0,5.0,7.0,6.0,5.0,6.0,7.0,6.0,6.0,5.0,6.0,6.0,7.0,4.0,6.0,5.0,5.0,7.0,5.0,6.0,5.0,6.0,5.0,7.0,7.0,5.0,6.0,3.0,4,,,,,,,,,,,,,,,,,,,,,,,,,,,,,,,,,0,5.0,3.0,2.0,3.0,1.0,3.0,6.0,2.0,5.0,3.0,5.0,3.0,3.0,3.0,3.0,5.0,5.0,3.0,4.0,2.0,2.0,3.0,5.0,4.0,2.0,3.0,2.0,2.0,6.0,2.0,3.0,5.0,3,,,,,,,,,,,,,,,,,,,,,,,,,,,,,,,,,11,,,,,,,,,,,,,,,,,,,,,,,,,,,,,,,,,9,,,,,,,,,,,,,,,,,,,,,,,,,,,,,,,,,,688.88,236.1,,,,7.12,,31.06,,,,,,,,105.19,,,,,,,,,,,,,,,,,,,,,130.62,,,,,,172.87,,,,,,,,,,,,5.92,,APPROVED,Male,29.0,FALSE
759,2022-03-22 02:00:35,19,en,1066078999,2022-03-22 01:49:26,2022-03-22 02:00:35,Y,Y,-oth-,High School,,12,,,,,,,,,,,,,,,,,,,,,,,,,,,,,,,,,4,,,,,,,,,,,,,,,,,,,,,,,,,,,,,,,,,0,6.0,7.0,6.0,4.0,7.0,2.0,6.0,7.0,7.0,6.0,6.0,6.0,6.0,5.0,6.0,6.0,7.0,6.0,5.0,6.0,4.0,6.0,2.0,6.0,6.0,2.0,4.0,6.0,7.0,6.0,2.0,3.0,7,,,,,,,,,,,,,,,,,,,,,,,,,,,,,,,,,9,,,,,,,,,,,,,,,,,,,,,,,,,,,,,,,,,5,,,,,,,,,,,,,,,,,,,,,,,,,,,,,,,,,2,3.0,5.0,3.0,4.0,3.0,4.0,6.0,6.0,6.0,3.0,5.0,3.0,2.0,2.0,4.0,5.0,6.0,4.0,3.0,3.0,3.0,3.0,2.0,2.0,3.0,2.0,2.0,2.0,5.0,4.0,1.0,7.0,6,,,,,,,,,,,,,,,,,,,,,,,,,,,,,,,,,11,,,,,,,,,,,,,,,,,,,,,,,,,,,,,,,,,10,,,,,,,,,,,,,,,,,,,,,,,,,,,,,,,,,14,,,,,,,,,,,,,,,,,,,,,,,,,,,,,,,,,1,6.0,5.0,4.0,6.0,5.0,6.0,2.0,7.0,5.0,4.0,4.0,6.0,5.0,4.0,4.0,6.0,6.0,5.0,6.0,4.0,4.0,6.0,6.0,6.0,5.0,6.0,2.0,6.0,4.0,6.0,5.0,5.0,13,,,,,,,,,,,,,,,,,,,,,,,,,,,,,,,,,3,,,,,,,,,,,,,,,,,,,,,,,,,,,,,,,,,8,,,,,,,,,,,,,,,,,,,,,,,,,,,,,,,,,"I based myself on how useful and easy to understand I'd imagine data being represented by these. Yes, some did look appealing and original, but if I had to process a bunch of data visually through some of these visualizations, I'd probably find it difficult, especially one like the last one that looked like a honeycomb, hence why I rated some aspects positively (creativity, color harmony..) but some negatively (not professional, not organized..).",670.72,62.22,,,,129.17,,40.42,,,,,,,,93.29,,,,,,,,,,,,84.22,,,,,,,,,,,,,,,76.19,,,,,,,,,,,,185.21,,APPROVED,Male,26.0,FALSE
760,2022-03-22 01:52:54,19,en,828824318,2022-03-22 01:49:26,2022-03-22 01:52:54,Y,Y,A1,,,9,,,,,,,,,,,,,,,,,,,,,,,,,,,,,,,,,14,,,,,,,,,,,,,,,,,,,,,,,,,,,,,,,,,8,,,,,,,,,,,,,,,,,,,,,,,,,,,,,,,,,3,,,,,,,,,,,,,,,,,,,,,,,,,,,,,,,,,12,,,,,,,,,,,,,,,,,,,,,,,,,,,,,,,,,1,4.0,5.0,5.0,3.0,4.0,5.0,6.0,5.0,5.0,4.0,4.0,3.0,4.0,5.0,5.0,4.0,5.0,5.0,4.0,4.0,4.0,4.0,3.0,4.0,5.0,5.0,4.0,5.0,5.0,4.0,4.0,6.0,10,,,,,,,,,,,,,,,,,,,,,,,,,,,,,,,,,0,2.0,2.0,2.0,2.0,2.0,2.0,6.0,4.0,3.0,2.0,2.0,2.0,2.0,3.0,5.0,2.0,3.0,2.0,2.0,2.0,3.0,2.0,2.0,2.0,2.0,2.0,2.0,2.0,2.0,2.0,2.0,1.0,4,,,,,,,,,,,,,,,,,,,,,,,,,,,,,,,,,7,,,,,,,,,,,,,,,,,,,,,,,,,,,,,,,,,6,,,,,,,,,,,,,,,,,,,,,,,,,,,,,,,,,5,,,,,,,,,,,,,,,,,,,,,,,,,,,,,,,,,2,5.0,5.0,5.0,5.0,4.0,5.0,5.0,5.0,5.0,5.0,5.0,5.0,5.0,5.0,5.0,5.0,5.0,5.0,5.0,4.0,4.0,5.0,5.0,5.0,4.0,5.0,5.0,5.0,5.0,5.0,5.0,6.0,13,,,,,,,,,,,,,,,,,,,,,,,,,,,,,,,,,11,,,,,,,,,,,,,,,,,,,,,,,,,,,,,,,,,,212.86,27.64,,,,5.52,,34.88,,,,,,,,,,,,,,,,,57.89,,,,,,50.69,,,,,,,,,,,,,,,33.49,,,,,,,,,2.75,,APPROVED,Female,22.0,FALSE
761,2022-03-22 01:52:09,19,en,485115036,2022-03-22 01:49:27,2022-03-22 01:52:09,Y,Y,A1,,,5,,,,,,,,,,,,,,,,,,,,,,,,,,,,,,,,,3,,,,,,,,,,,,,,,,,,,,,,,,,,,,,,,,,13,,,,,,,,,,,,,,,,,,,,,,,,,,,,,,,,,12,,,,,,,,,,,,,,,,,,,,,,,,,,,,,,,,,8,,,,,,,,,,,,,,,,,,,,,,,,,,,,,,,,,10,,,,,,,,,,,,,,,,,,,,,,,,,,,,,,,,,0,5.0,5.0,6.0,5.0,4.0,5.0,4.0,5.0,3.0,5.0,4.0,5.0,4.0,5.0,5.0,5.0,5.0,4.0,4.0,4.0,4.0,4.0,5.0,5.0,3.0,4.0,5.0,4.0,4.0,4.0,4.0,7.0,1,2.0,2.0,2.0,2.0,2.0,2.0,2.0,2.0,2.0,2.0,2.0,2.0,2.0,2.0,2.0,2.0,2.0,2.0,2.0,2.0,2.0,2.0,2.0,2.0,2.0,2.0,2.0,2.0,2.0,2.0,2.0,1.0,11,,,,,,,,,,,,,,,,,,,,,,,,,,,,,,,,,9,,,,,,,,,,,,,,,,,,,,,,,,,,,,,,,,,14,,,,,,,,,,,,,,,,,,,,,,,,,,,,,,,,,4,,,,,,,,,,,,,,,,,,,,,,,,,,,,,,,,,6,,,,,,,,,,,,,,,,,,,,,,,,,,,,,,,,,7,,,,,,,,,,,,,,,,,,,,,,,,,,,,,,,,,2,4.0,5.0,3.0,4.0,3.0,4.0,4.0,3.0,3.0,3.0,3.0,4.0,3.0,2.0,4.0,3.0,5.0,3.0,3.0,3.0,3.0,5.0,2.0,3.0,3.0,4.0,5.0,5.0,3.0,3.0,3.0,1.0,,165.95,7.2,,,,5.7,,27.27,,,,,,,,,,,,,,,,,,,,52.68,,,26.1,,,,,,,,,,,,,,,,,,,,,44.39,,,2.61,,APPROVED,Male,24.0,FALSE
762,2022-03-22 01:55:50,19,en,1291958634,2022-03-22 01:49:27,2022-03-22 01:55:50,Y,Y,A1,,,7,,,,,,,,,,,,,,,,,,,,,,,,,,,,,,,,,9,,,,,,,,,,,,,,,,,,,,,,,,,,,,,,,,,8,,,,,,,,,,,,,,,,,,,,,,,,,,,,,,,,,14,,,,,,,,,,,,,,,,,,,,,,,,,,,,,,,,,10,,,,,,,,,,,,,,,,,,,,,,,,,,,,,,,,,4,,,,,,,,,,,,,,,,,,,,,,,,,,,,,,,,,2,5.0,6.0,4.0,3.0,5.0,4.0,3.0,5.0,6.0,4.0,4.0,3.0,4.0,5.0,5.0,6.0,5.0,5.0,5.0,2.0,5.0,5.0,3.0,5.0,4.0,2.0,4.0,4.0,4.0,4.0,3.0,7.0,3,,,,,,,,,,,,,,,,,,,,,,,,,,,,,,,,,1,2.0,2.0,2.0,2.0,1.0,2.0,3.0,3.0,1.0,1.0,2.0,1.0,2.0,1.0,2.0,1.0,4.0,2.0,1.0,1.0,2.0,2.0,2.0,2.0,1.0,2.0,3.0,1.0,2.0,2.0,3.0,2.0,0,4.0,6.0,4.0,4.0,2.0,5.0,3.0,3.0,4.0,2.0,5.0,3.0,5.0,2.0,5.0,4.0,5.0,1.0,2.0,1.0,1.0,4.0,1.0,2.0,3.0,2.0,4.0,5.0,5.0,3.0,2.0,3.0,11,,,,,,,,,,,,,,,,,,,,,,,,,,,,,,,,,12,,,,,,,,,,,,,,,,,,,,,,,,,,,,,,,,,5,,,,,,,,,,,,,,,,,,,,,,,,,,,,,,,,,13,,,,,,,,,,,,,,,,,,,,,,,,,,,,,,,,,6,,,,,,,,,,,,,,,,,,,,,,,,,,,,,,,,,,386.44,36.21,,,,5.7,,34.79,,,,,,,,,,,,,,,,,,,,94.49,,,,,,132.44,,,78.91,,,,,,,,,,,,,,,,,,3.9,,APPROVED,Male,18.0,FALSE
763,2022-03-22 01:53:12,19,en,288180213,2022-03-22 01:49:28,2022-03-22 01:53:12,Y,Y,A1,,,11,,,,,,,,,,,,,,,,,,,,,,,,,,,,,,,,,9,,,,,,,,,,,,,,,,,,,,,,,,,,,,,,,,,3,,,,,,,,,,,,,,,,,,,,,,,,,,,,,,,,,6,,,,,,,,,,,,,,,,,,,,,,,,,,,,,,,,,10,,,,,,,,,,,,,,,,,,,,,,,,,,,,,,,,,2,6.0,6.0,6.0,5.0,6.0,4.0,5.0,6.0,7.0,6.0,2.0,6.0,5.0,6.0,6.0,6.0,6.0,5.0,6.0,5.0,6.0,5.0,5.0,6.0,7.0,5.0,7.0,6.0,5.0,4.0,6.0,6.0,1,4.0,6.0,3.0,5.0,5.0,4.0,7.0,5.0,6.0,4.0,5.0,5.0,5.0,6.0,6.0,5.0,5.0,5.0,3.0,2.0,4.0,5.0,6.0,3.0,5.0,6.0,5.0,6.0,6.0,5.0,5.0,7.0,5,,,,,,,,,,,,,,,,,,,,,,,,,,,,,,,,,13,,,,,,,,,,,,,,,,,,,,,,,,,,,,,,,,,12,,,,,,,,,,,,,,,,,,,,,,,,,,,,,,,,,4,,,,,,,,,,,,,,,,,,,,,,,,,,,,,,,,,0,6.0,6.0,3.0,3.0,2.0,2.0,5.0,3.0,5.0,2.0,3.0,5.0,4.0,4.0,4.0,2.0,6.0,1.0,3.0,2.0,2.0,2.0,2.0,2.0,1.0,3.0,2.0,5.0,5.0,3.0,3.0,5.0,8,,,,,,,,,,,,,,,,,,,,,,,,,,,,,,,,,14,,,,,,,,,,,,,,,,,,,,,,,,,,,,,,,,,7,,,,,,,,,,,,,,,,,,,,,,,,,,,,,,,,,,236.05,12.19,,,,3.82,,18.52,,,,,,,,,,,,,,,,,54.18,,,59.68,,,,,,,,,,,,,,,85.58,,,,,,,,,,,,2.08,,APPROVED,Female,24.0,FALSE
764,2022-03-22 01:57:51,19,en,2062116054,2022-03-22 01:49:30,2022-03-22 01:57:51,Y,Y,A2,,,3,,,,,,,,,,,,,,,,,,,,,,,,,,,,,,,,,5,,,,,,,,,,,,,,,,,,,,,,,,,,,,,,,,,6,,,,,,,,,,,,,,,,,,,,,,,,,,,,,,,,,13,,,,,,,,,,,,,,,,,,,,,,,,,,,,,,,,,1,1.0,1.0,1.0,1.0,1.0,1.0,7.0,1.0,1.0,1.0,1.0,1.0,1.0,1.0,1.0,1.0,1.0,1.0,1.0,1.0,1.0,1.0,1.0,1.0,1.0,1.0,1.0,1.0,1.0,1.0,1.0,5.0,11,,,,,,,,,,,,,,,,,,,,,,,,,,,,,,,,,2,2.0,1.0,1.0,1.0,1.0,2.0,2.0,1.0,3.0,1.0,2.0,2.0,1.0,1.0,1.0,1.0,3.0,1.0,1.0,1.0,1.0,1.0,1.0,1.0,1.0,5.0,1.0,1.0,1.0,1.0,3.0,7.0,7,,,,,,,,,,,,,,,,,,,,,,,,,,,,,,,,,10,,,,,,,,,,,,,,,,,,,,,,,,,,,,,,,,,12,,,,,,,,,,,,,,,,,,,,,,,,,,,,,,,,,8,,,,,,,,,,,,,,,,,,,,,,,,,,,,,,,,,0,4.0,2.0,5.0,2.0,5.0,2.0,3.0,4.0,2.0,3.0,2.0,4.0,4.0,4.0,4.0,2.0,5.0,2.0,3.0,4.0,2.0,4.0,3.0,3.0,5.0,4.0,2.0,3.0,4.0,4.0,4.0,5.0,14,,,,,,,,,,,,,,,,,,,,,,,,,,,,,,,,,9,,,,,,,,,,,,,,,,,,,,,,,,,,,,,,,,,4,,,,,,,,,,,,,,,,,,,,,,,,,,,,,,,,,,505.23,116.7,,,,9.31,,109.94,,,,,,,,,,,,,,53.75,,,,,,115.31,,,,,,,,,,,,,,,92.74,,,,,,,,,,,,7.48,,APPROVED,Male,22.0,FALSE
765,2022-03-22 01:55:49,19,en,138685456,2022-03-22 01:49:30,2022-03-22 01:55:49,Y,Y,A1,,,6,,,,,,,,,,,,,,,,,,,,,,,,,,,,,,,,,9,,,,,,,,,,,,,,,,,,,,,,,,,,,,,,,,,2,3.0,4.0,5.0,5.0,3.0,5.0,3.0,4.0,5.0,3.0,3.0,4.0,4.0,3.0,4.0,4.0,4.0,4.0,5.0,3.0,4.0,5.0,4.0,4.0,3.0,4.0,3.0,4.0,4.0,4.0,5.0,3.0,1,3.0,4.0,4.0,4.0,3.0,6.0,3.0,5.0,3.0,3.0,3.0,4.0,3.0,3.0,4.0,4.0,5.0,4.0,4.0,2.0,3.0,4.0,4.0,3.0,3.0,5.0,4.0,3.0,4.0,3.0,5.0,4.0,10,,,,,,,,,,,,,,,,,,,,,,,,,,,,,,,,,3,,,,,,,,,,,,,,,,,,,,,,,,,,,,,,,,,8,,,,,,,,,,,,,,,,,,,,,,,,,,,,,,,,,11,,,,,,,,,,,,,,,,,,,,,,,,,,,,,,,,,14,,,,,,,,,,,,,,,,,,,,,,,,,,,,,,,,,0,4.0,4.0,3.0,3.0,3.0,4.0,2.0,3.0,5.0,3.0,3.0,4.0,3.0,4.0,4.0,3.0,4.0,4.0,4.0,3.0,4.0,4.0,3.0,3.0,3.0,6.0,3.0,3.0,2.0,4.0,4.0,3.0,5,,,,,,,,,,,,,,,,,,,,,,,,,,,,,,,,,4,,,,,,,,,,,,,,,,,,,,,,,,,,,,,,,,,12,,,,,,,,,,,,,,,,,,,,,,,,,,,,,,,,,13,,,,,,,,,,,,,,,,,,,,,,,,,,,,,,,,,7,,,,,,,,,,,,,,,,,,,,,,,,,,,,,,,,,,381.6,50.07,,,,7.56,,38.61,,,,,,,,82.98,,,82.8,,,,,,,,,,,,,,,,,,102.14,,,,,,,,,,,,,,,,,,17.44,,APPROVED,Male,31.0,FALSE
766,2022-03-22 01:55:05,19,en,214849245,2022-03-22 01:49:30,2022-03-22 01:55:05,Y,Y,A1,,,4,,,,,,,,,,,,,,,,,,,,,,,,,,,,,,,,,5,,,,,,,,,,,,,,,,,,,,,,,,,,,,,,,,,1,6.0,5.0,5.0,5.0,5.0,5.0,3.0,6.0,6.0,4.0,4.0,6.0,6.0,5.0,6.0,6.0,6.0,5.0,6.0,5.0,4.0,6.0,6.0,6.0,6.0,5.0,5.0,5.0,3.0,6.0,6.0,3.0,7,,,,,,,,,,,,,,,,,,,,,,,,,,,,,,,,,2,1.0,1.0,1.0,1.0,1.0,1.0,7.0,1.0,2.0,1.0,1.0,2.0,1.0,1.0,3.0,1.0,1.0,1.0,2.0,1.0,1.0,2.0,4.0,2.0,2.0,2.0,5.0,1.0,1.0,3.0,1.0,5.0,9,,,,,,,,,,,,,,,,,,,,,,,,,,,,,,,,,3,,,,,,,,,,,,,,,,,,,,,,,,,,,,,,,,,14,,,,,,,,,,,,,,,,,,,,,,,,,,,,,,,,,11,,,,,,,,,,,,,,,,,,,,,,,,,,,,,,,,,10,,,,,,,,,,,,,,,,,,,,,,,,,,,,,,,,,6,,,,,,,,,,,,,,,,,,,,,,,,,,,,,,,,,0,3.0,6.0,2.0,1.0,3.0,2.0,6.0,2.0,5.0,3.0,1.0,5.0,5.0,5.0,5.0,2.0,6.0,2.0,3.0,2.0,2.0,4.0,2.0,3.0,2.0,2.0,2.0,3.0,2.0,3.0,2.0,5.0,12,,,,,,,,,,,,,,,,,,,,,,,,,,,,,,,,,13,,,,,,,,,,,,,,,,,,,,,,,,,,,,,,,,,8,,,,,,,,,,,,,,,,,,,,,,,,,,,,,,,,,,337.18,34.68,,,,5.25,,29.1,,,,,,,,86.88,,,,,,83.19,,,,,,,,,,,,,,,,,,,,,93.6,,,,,,,,,,,,4.48,,APPROVED,Female,34.0,FALSE
767,2022-03-22 01:55:23,19,en,196810269,2022-03-22 01:49:32,2022-03-22 01:55:23,Y,Y,A2,,,9,,,,,,,,,,,,,,,,,,,,,,,,,,,,,,,,,11,,,,,,,,,,,,,,,,,,,,,,,,,,,,,,,,,8,,,,,,,,,,,,,,,,,,,,,,,,,,,,,,,,,5,,,,,,,,,,,,,,,,,,,,,,,,,,,,,,,,,10,,,,,,,,,,,,,,,,,,,,,,,,,,,,,,,,,6,,,,,,,,,,,,,,,,,,,,,,,,,,,,,,,,,13,,,,,,,,,,,,,,,,,,,,,,,,,,,,,,,,,3,,,,,,,,,,,,,,,,,,,,,,,,,,,,,,,,,12,,,,,,,,,,,,,,,,,,,,,,,,,,,,,,,,,7,,,,,,,,,,,,,,,,,,,,,,,,,,,,,,,,,0,6.0,7.0,4.0,4.0,3.0,3.0,6.0,6.0,7.0,4.0,4.0,4.0,3.0,6.0,6.0,5.0,5.0,6.0,6.0,6.0,4.0,6.0,3.0,6.0,6.0,2.0,1.0,5.0,5.0,2.0,7.0,4.0,1,4.0,7.0,3.0,1.0,5.0,2.0,5.0,4.0,7.0,4.0,3.0,5.0,6.0,3.0,5.0,4.0,6.0,3.0,4.0,5.0,4.0,2.0,5.0,5.0,5.0,4.0,5.0,5.0,5.0,4.0,5.0,5.0,4,,,,,,,,,,,,,,,,,,,,,,,,,,,,,,,,,2,5.0,5.0,1.0,4.0,4.0,4.0,7.0,6.0,4.0,1.0,3.0,5.0,1.0,6.0,4.0,6.0,5.0,1.0,5.0,1.0,4.0,2.0,6.0,3.0,2.0,7.0,6.0,1.0,4.0,2.0,5.0,7.0,14,,,,,,,,,,,,,,,,,,,,,,,,,,,,,,,,,none,353.43,35.37,,,,26.8,,36.07,,,,,,,,,,,,,,,,,,,,,,,,,,,,,,,,90.61,,,88.29,,,,,,67.42,,,,,,8.87,,APPROVED,Male,19.0,FALSE
768,2022-03-22 01:58:06,19,en,893288781,2022-03-22 01:49:36,2022-03-22 01:58:06,Y,Y,-oth-,GED,,8,,,,,,,,,,,,,,,,,,,,,,,,,,,,,,,,,6,,,,,,,,,,,,,,,,,,,,,,,,,,,,,,,,,7,,,,,,,,,,,,,,,,,,,,,,,,,,,,,,,,,1,3.0,4.0,3.0,4.0,3.0,3.0,5.0,3.0,5.0,3.0,3.0,4.0,3.0,4.0,3.0,3.0,5.0,4.0,4.0,3.0,4.0,3.0,3.0,4.0,3.0,4.0,3.0,3.0,4.0,3.0,4.0,4.0,13,,,,,,,,,,,,,,,,,,,,,,,,,,,,,,,,,3,,,,,,,,,,,,,,,,,,,,,,,,,,,,,,,,,10,,,,,,,,,,,,,,,,,,,,,,,,,,,,,,,,,9,,,,,,,,,,,,,,,,,,,,,,,,,,,,,,,,,14,,,,,,,,,,,,,,,,,,,,,,,,,,,,,,,,,11,,,,,,,,,,,,,,,,,,,,,,,,,,,,,,,,,4,,,,,,,,,,,,,,,,,,,,,,,,,,,,,,,,,5,,,,,,,,,,,,,,,,,,,,,,,,,,,,,,,,,12,,,,,,,,,,,,,,,,,,,,,,,,,,,,,,,,,2,4.0,3.0,3.0,4.0,3.0,5.0,4.0,5.0,3.0,3.0,4.0,4.0,4.0,3.0,6.0,4.0,6.0,3.0,4.0,2.0,4.0,4.0,5.0,3.0,3.0,5.0,5.0,4.0,4.0,3.0,6.0,7.0,0,2.0,5.0,2.0,4.0,2.0,2.0,6.0,2.0,5.0,2.0,2.0,2.0,2.0,2.0,4.0,2.0,4.0,2.0,2.0,1.0,2.0,2.0,1.0,3.0,2.0,2.0,4.0,2.0,2.0,2.0,2.0,1.0,,512.67,12.13,,,,9.16,,79.76,,,,,,,,,,,174.91,,,,,,,,,,,,,,,,,,,,,,,,,,,,,,85.43,,,147.87,,,3.41,,APPROVED,Male,27.0,FALSE
769,2022-03-22 01:57:53,19,en,1751090553,2022-03-22 01:49:39,2022-03-22 01:57:53,Y,Y,-oth-,One year of University studying Architecture,,3,,,,,,,,,,,,,,,,,,,,,,,,,,,,,,,,,0,5.0,4.0,3.0,5.0,5.0,6.0,2.0,7.0,2.0,2.0,6.0,5.0,5.0,2.0,6.0,6.0,5.0,5.0,4.0,5.0,3.0,5.0,7.0,6.0,6.0,6.0,1.0,5.0,5.0,6.0,6.0,2.0,9,,,,,,,,,,,,,,,,,,,,,,,,,,,,,,,,,12,,,,,,,,,,,,,,,,,,,,,,,,,,,,,,,,,8,,,,,,,,,,,,,,,,,,,,,,,,,,,,,,,,,1,5.0,5.0,3.0,2.0,5.0,5.0,7.0,3.0,5.0,3.0,3.0,6.0,5.0,5.0,6.0,3.0,6.0,3.0,5.0,3.0,2.0,3.0,3.0,3.0,5.0,6.0,1.0,5.0,6.0,3.0,5.0,6.0,6,,,,,,,,,,,,,,,,,,,,,,,,,,,,,,,,,11,,,,,,,,,,,,,,,,,,,,,,,,,,,,,,,,,10,,,,,,,,,,,,,,,,,,,,,,,,,,,,,,,,,2,6.0,7.0,6.0,3.0,7.0,2.0,7.0,7.0,3.0,5.0,6.0,6.0,5.0,5.0,7.0,5.0,7.0,5.0,5.0,5.0,6.0,5.0,4.0,6.0,7.0,5.0,5.0,7.0,6.0,6.0,4.0,3.0,7,,,,,,,,,,,,,,,,,,,,,,,,,,,,,,,,,13,,,,,,,,,,,,,,,,,,,,,,,,,,,,,,,,,5,,,,,,,,,,,,,,,,,,,,,,,,,,,,,,,,,14,,,,,,,,,,,,,,,,,,,,,,,,,,,,,,,,,4,,,,,,,,,,,,,,,,,,,,,,,,,,,,,,,,,,491.48,41.84,,,,40.91,,114.34,,,,,105.95,,,,,,,,,,,,94.78,,,,,,,,,,,,81.92,,,,,,,,,,,,,,,,,,11.74,,APPROVED,Male,29.0,FALSE
770,2022-03-22 01:55:00,19,en,1099487282,2022-03-22 01:49:48,2022-03-22 01:55:00,Y,Y,A1,,,2,5.0,6.0,6.0,5.0,5.0,5.0,3.0,6.0,6.0,6.0,7.0,5.0,6.0,5.0,6.0,6.0,6.0,6.0,5.0,5.0,4.0,5.0,5.0,5.0,5.0,4.0,6.0,6.0,6.0,6.0,7.0,1.0,6,,,,,,,,,,,,,,,,,,,,,,,,,,,,,,,,,13,,,,,,,,,,,,,,,,,,,,,,,,,,,,,,,,,5,,,,,,,,,,,,,,,,,,,,,,,,,,,,,,,,,4,,,,,,,,,,,,,,,,,,,,,,,,,,,,,,,,,1,4.0,5.0,5.0,6.0,5.0,3.0,5.0,7.0,7.0,5.0,4.0,5.0,4.0,5.0,4.0,3.0,5.0,4.0,5.0,5.0,4.0,5.0,5.0,5.0,4.0,3.0,5.0,5.0,4.0,4.0,6.0,6.0,7,,,,,,,,,,,,,,,,,,,,,,,,,,,,,,,,,9,,,,,,,,,,,,,,,,,,,,,,,,,,,,,,,,,10,,,,,,,,,,,,,,,,,,,,,,,,,,,,,,,,,3,,,,,,,,,,,,,,,,,,,,,,,,,,,,,,,,,8,,,,,,,,,,,,,,,,,,,,,,,,,,,,,,,,,11,,,,,,,,,,,,,,,,,,,,,,,,,,,,,,,,,14,,,,,,,,,,,,,,,,,,,,,,,,,,,,,,,,,12,,,,,,,,,,,,,,,,,,,,,,,,,,,,,,,,,0,4.0,6.0,5.0,4.0,5.0,3.0,6.0,5.0,5.0,4.0,5.0,5.0,5.0,5.0,5.0,4.0,6.0,3.0,4.0,4.0,4.0,4.0,2.0,5.0,5.0,3.0,6.0,3.0,6.0,4.0,4.0,1.0,,315.02,31.76,,,,6.98,,21.88,,64.63,,,,,,,,,,,,,,,85.69,,,,,,,,,,,,,,,,,,,,,,,,,,,100.79,,,3.29,,APPROVED,Male,24.0,FALSE
771,2022-03-22 02:04:38,19,en,77973669,2022-03-22 01:50:05,2022-03-22 02:04:38,Y,Y,A1,,,2,6.0,7.0,6.0,6.0,6.0,7.0,3.0,6.0,7.0,6.0,6.0,6.0,6.0,6.0,6.0,6.0,6.0,7.0,6.0,7.0,5.0,6.0,7.0,6.0,6.0,6.0,2.0,6.0,6.0,6.0,7.0,1.0,12,,,,,,,,,,,,,,,,,,,,,,,,,,,,,,,,,4,,,,,,,,,,,,,,,,,,,,,,,,,,,,,,,,,14,,,,,,,,,,,,,,,,,,,,,,,,,,,,,,,,,10,,,,,,,,,,,,,,,,,,,,,,,,,,,,,,,,,1,6.0,4.0,5.0,6.0,6.0,7.0,3.0,6.0,5.0,5.0,6.0,5.0,6.0,6.0,5.0,5.0,5.0,5.0,6.0,6.0,6.0,6.0,7.0,5.0,5.0,6.0,2.0,5.0,6.0,6.0,6.0,6.0,6,,,,,,,,,,,,,,,,,,,,,,,,,,,,,,,,,11,,,,,,,,,,,,,,,,,,,,,,,,,,,,,,,,,5,,,,,,,,,,,,,,,,,,,,,,,,,,,,,,,,,13,,,,,,,,,,,,,,,,,,,,,,,,,,,,,,,,,9,,,,,,,,,,,,,,,,,,,,,,,,,,,,,,,,,8,,,,,,,,,,,,,,,,,,,,,,,,,,,,,,,,,7,,,,,,,,,,,,,,,,,,,,,,,,,,,,,,,,,0,5.0,6.0,6.0,6.0,5.0,7.0,2.0,6.0,6.0,4.0,5.0,3.0,5.0,5.0,5.0,5.0,6.0,3.0,5.0,5.0,4.0,5.0,6.0,5.0,5.0,6.0,3.0,5.0,5.0,5.0,6.0,7.0,3,,,,,,,,,,,,,,,,,,,,,,,,,,,,,,,,,No I do not have any comments,875.75,215.38,,,,11.62,,97.65,,119.79,,,,,,,,,,,,,,,162.82,,,,,,,,,,,,,,,,,,,,,,,,246.97,,,,,,21.52,,APPROVED,Female,22.0,FALSE
772,2022-03-22 01:59:52,19,en,1556658467,2022-03-22 01:50:25,2022-03-22 01:59:52,Y,Y,-oth-,A levels,,6,,,,,,,,,,,,,,,,,,,,,,,,,,,,,,,,,4,,,,,,,,,,,,,,,,,,,,,,,,,,,,,,,,,3,,,,,,,,,,,,,,,,,,,,,,,,,,,,,,,,,5,,,,,,,,,,,,,,,,,,,,,,,,,,,,,,,,,0,3.0,5.0,3.0,2.0,1.0,2.0,6.0,4.0,6.0,3.0,2.0,2.0,3.0,2.0,2.0,5.0,5.0,4.0,3.0,2.0,2.0,3.0,5.0,4.0,2.0,5.0,5.0,3.0,6.0,4.0,2.0,5.0,7,,,,,,,,,,,,,,,,,,,,,,,,,,,,,,,,,1,2.0,6.0,2.0,4.0,2.0,2.0,7.0,6.0,5.0,2.0,2.0,3.0,1.0,2.0,3.0,4.0,5.0,2.0,2.0,2.0,2.0,2.0,2.0,3.0,1.0,5.0,6.0,2.0,5.0,4.0,2.0,7.0,11,,,,,,,,,,,,,,,,,,,,,,,,,,,,,,,,,8,,,,,,,,,,,,,,,,,,,,,,,,,,,,,,,,,9,,,,,,,,,,,,,,,,,,,,,,,,,,,,,,,,,13,,,,,,,,,,,,,,,,,,,,,,,,,,,,,,,,,12,,,,,,,,,,,,,,,,,,,,,,,,,,,,,,,,,14,,,,,,,,,,,,,,,,,,,,,,,,,,,,,,,,,2,3.0,5.0,2.0,5.0,1.0,6.0,2.0,3.0,6.0,1.0,1.0,6.0,2.0,5.0,4.0,5.0,5.0,3.0,2.0,2.0,5.0,2.0,6.0,1.0,2.0,6.0,6.0,4.0,5.0,3.0,6.0,7.0,10,,,,,,,,,,,,,,,,,,,,,,,,,,,,,,,,,,569.19,31.9,,,,18.04,,47.26,,,,,,,,,,,,,,234.15,,,,,,143.41,,,,,,,,,,,,,,,,,,,,,89.17,,,,,,5.26,,APPROVED,Female,31.0,FALSE
773,2022-03-22 01:57:01,19,en,2122670370,2022-03-22 01:51:55,2022-03-22 01:57:01,Y,Y,A1,,,13,,,,,,,,,,,,,,,,,,,,,,,,,,,,,,,,,10,,,,,,,,,,,,,,,,,,,,,,,,,,,,,,,,,0,6.0,7.0,6.0,6.0,6.0,6.0,2.0,7.0,7.0,6.0,6.0,5.0,6.0,6.0,6.0,5.0,6.0,5.0,7.0,6.0,4.0,5.0,6.0,6.0,6.0,7.0,4.0,7.0,5.0,5.0,7.0,3.0,9,,,,,,,,,,,,,,,,,,,,,,,,,,,,,,,,,12,,,,,,,,,,,,,,,,,,,,,,,,,,,,,,,,,1,5.0,6.0,4.0,3.0,4.0,3.0,4.0,6.0,5.0,3.0,2.0,3.0,3.0,5.0,4.0,4.0,5.0,5.0,6.0,3.0,4.0,5.0,3.0,5.0,5.0,4.0,3.0,5.0,2.0,4.0,5.0,6.0,2,3.0,6.0,4.0,5.0,3.0,5.0,4.0,6.0,3.0,4.0,3.0,2.0,5.0,5.0,5.0,3.0,6.0,4.0,4.0,4.0,3.0,5.0,6.0,5.0,4.0,7.0,3.0,5.0,6.0,3.0,6.0,7.0,11,,,,,,,,,,,,,,,,,,,,,,,,,,,,,,,,,6,,,,,,,,,,,,,,,,,,,,,,,,,,,,,,,,,8,,,,,,,,,,,,,,,,,,,,,,,,,,,,,,,,,7,,,,,,,,,,,,,,,,,,,,,,,,,,,,,,,,,5,,,,,,,,,,,,,,,,,,,,,,,,,,,,,,,,,3,,,,,,,,,,,,,,,,,,,,,,,,,,,,,,,,,4,,,,,,,,,,,,,,,,,,,,,,,,,,,,,,,,,14,,,,,,,,,,,,,,,,,,,,,,,,,,,,,,,,,very interesting,308.57,20.07,,,,7.96,,37.64,,,,,,,,84.85,,,,,,,,,75.35,,,70.37,,,,,,,,,,,,,,,,,,,,,,,,,,,12.33,,APPROVED,Female,22.0,FALSE
774,2022-03-22 02:01:09,19,en,1853167420,2022-03-22 01:53:25,2022-03-22 02:01:09,Y,Y,A1,,,13,,,,,,,,,,,,,,,,,,,,,,,,,,,,,,,,,2,5.0,5.0,5.0,6.0,5.0,6.0,3.0,5.0,4.0,5.0,4.0,6.0,5.0,4.0,5.0,5.0,4.0,5.0,5.0,4.0,4.0,5.0,6.0,5.0,5.0,5.0,2.0,6.0,4.0,5.0,5.0,2.0,10,,,,,,,,,,,,,,,,,,,,,,,,,,,,,,,,,1,5.0,6.0,5.0,4.0,6.0,4.0,6.0,6.0,7.0,5.0,5.0,5.0,5.0,6.0,6.0,5.0,6.0,5.0,5.0,5.0,5.0,5.0,5.0,5.0,5.0,6.0,4.0,5.0,6.0,6.0,6.0,4.0,0,5.0,6.0,6.0,5.0,7.0,5.0,4.0,6.0,7.0,6.0,6.0,5.0,5.0,6.0,7.0,6.0,7.0,5.0,6.0,6.0,6.0,6.0,6.0,7.0,6.0,7.0,2.0,6.0,7.0,6.0,6.0,5.0,7,,,,,,,,,,,,,,,,,,,,,,,,,,,,,,,,,8,,,,,,,,,,,,,,,,,,,,,,,,,,,,,,,,,12,,,,,,,,,,,,,,,,,,,,,,,,,,,,,,,,,5,,,,,,,,,,,,,,,,,,,,,,,,,,,,,,,,,9,,,,,,,,,,,,,,,,,,,,,,,,,,,,,,,,,4,,,,,,,,,,,,,,,,,,,,,,,,,,,,,,,,,11,,,,,,,,,,,,,,,,,,,,,,,,,,,,,,,,,3,,,,,,,,,,,,,,,,,,,,,,,,,,,,,,,,,6,,,,,,,,,,,,,,,,,,,,,,,,,,,,,,,,,14,,,,,,,,,,,,,,,,,,,,,,,,,,,,,,,,,,467.06,31.67,,,,10.78,,42.67,,,,,124.55,,,,,,89.68,,,123.6,,,,,,,,,,,,,,,,,,,,,,,,,,,,,,,,,44.11,,APPROVED,Female,27.0,FALSE
776,2022-03-22 01:58:10,19,en,200409273,2022-03-22 01:53:32,2022-03-22 01:58:10,Y,Y,A2,,,8,,,,,,,,,,,,,,,,,,,,,,,,,,,,,,,,,7,,,,,,,,,,,,,,,,,,,,,,,,,,,,,,,,,9,,,,,,,,,,,,,,,,,,,,,,,,,,,,,,,,,10,,,,,,,,,,,,,,,,,,,,,,,,,,,,,,,,,2,6.0,3.0,5.0,6.0,5.0,7.0,2.0,7.0,5.0,6.0,5.0,7.0,7.0,6.0,6.0,7.0,7.0,7.0,6.0,3.0,6.0,6.0,7.0,6.0,5.0,7.0,4.0,6.0,6.0,6.0,7.0,5.0,1,7.0,7.0,7.0,6.0,6.0,3.0,5.0,6.0,7.0,6.0,3.0,7.0,7.0,5.0,7.0,6.0,7.0,7.0,7.0,5.0,3.0,7.0,5.0,6.0,7.0,5.0,7.0,6.0,6.0,6.0,6.0,6.0,14,,,,,,,,,,,,,,,,,,,,,,,,,,,,,,,,,6,,,,,,,,,,,,,,,,,,,,,,,,,,,,,,,,,12,,,,,,,,,,,,,,,,,,,,,,,,,,,,,,,,,0,1.0,5.0,1.0,1.0,1.0,1.0,7.0,5.0,5.0,1.0,1.0,1.0,1.0,1.0,1.0,1.0,1.0,1.0,1.0,1.0,1.0,1.0,1.0,1.0,1.0,2.0,4.0,1.0,1.0,1.0,1.0,3.0,5,,,,,,,,,,,,,,,,,,,,,,,,,,,,,,,,,4,,,,,,,,,,,,,,,,,,,,,,,,,,,,,,,,,3,,,,,,,,,,,,,,,,,,,,,,,,,,,,,,,,,11,,,,,,,,,,,,,,,,,,,,,,,,,,,,,,,,,13,,,,,,,,,,,,,,,,,,,,,,,,,,,,,,,,,,279.77,16.17,,,,5.07,,31.51,,,,,,,,,,,,,,75.61,,,83.08,,,,,,,,,,,,64.21,,,,,,,,,,,,,,,,,,4.12,,APPROVED,Female,28.0,FALSE
777,2022-03-22 02:02:16,19,en,50627710,2022-03-22 01:53:32,2022-03-22 02:02:16,Y,Y,-oth-,high school diploma,,3,,,,,,,,,,,,,,,,,,,,,,,,,,,,,,,,,10,,,,,,,,,,,,,,,,,,,,,,,,,,,,,,,,,2,6.0,6.0,6.0,5.0,6.0,6.0,2.0,6.0,7.0,6.0,6.0,6.0,6.0,6.0,6.0,5.0,6.0,6.0,6.0,6.0,6.0,6.0,5.0,6.0,6.0,6.0,4.0,6.0,6.0,6.0,7.0,3.0,13,,,,,,,,,,,,,,,,,,,,,,,,,,,,,,,,,6,,,,,,,,,,,,,,,,,,,,,,,,,,,,,,,,,9,,,,,,,,,,,,,,,,,,,,,,,,,,,,,,,,,8,,,,,,,,,,,,,,,,,,,,,,,,,,,,,,,,,12,,,,,,,,,,,,,,,,,,,,,,,,,,,,,,,,,5,,,,,,,,,,,,,,,,,,,,,,,,,,,,,,,,,14,,,,,,,,,,,,,,,,,,,,,,,,,,,,,,,,,11,,,,,,,,,,,,,,,,,,,,,,,,,,,,,,,,,4,,,,,,,,,,,,,,,,,,,,,,,,,,,,,,,,,1,4.0,5.0,5.0,6.0,5.0,6.0,4.0,3.0,6.0,5.0,5.0,5.0,5.0,5.0,4.0,6.0,5.0,5.0,5.0,5.0,5.0,5.0,6.0,5.0,4.0,6.0,4.0,4.0,5.0,6.0,6.0,6.0,0,3.0,6.0,3.0,5.0,4.0,3.0,4.0,6.0,6.0,3.0,3.0,6.0,3.0,3.0,3.0,3.0,6.0,5.0,3.0,3.0,4.0,4.0,5.0,3.0,3.0,5.0,3.0,3.0,3.0,4.0,6.0,7.0,7,,,,,,,,,,,,,,,,,,,,,,,,,,,,,,,,,,526.04,232.98,,,,19.56,,51.03,,,,,,,,65.56,,,,,,,,,,,,,,,,,,,,,,,,,,,,,,71.14,,,81.61,,,,,,4.16,,APPROVED,Female,20.0,FALSE
779,2022-03-22 02:02:47,19,en,2002067104,2022-03-22 01:53:35,2022-03-22 02:02:47,Y,Y,A1,,,14,,,,,,,,,,,,,,,,,,,,,,,,,,,,,,,,,7,,,,,,,,,,,,,,,,,,,,,,,,,,,,,,,,,8,,,,,,,,,,,,,,,,,,,,,,,,,,,,,,,,,3,,,,,,,,,,,,,,,,,,,,,,,,,,,,,,,,,5,,,,,,,,,,,,,,,,,,,,,,,,,,,,,,,,,13,,,,,,,,,,,,,,,,,,,,,,,,,,,,,,,,,11,,,,,,,,,,,,,,,,,,,,,,,,,,,,,,,,,6,,,,,,,,,,,,,,,,,,,,,,,,,,,,,,,,,2,5.0,3.0,3.0,6.0,2.0,3.0,5.0,5.0,2.0,3.0,3.0,2.0,3.0,3.0,5.0,3.0,5.0,3.0,2.0,2.0,5.0,5.0,5.0,3.0,2.0,3.0,4.0,3.0,6.0,2.0,5.0,2.0,9,,,,,,,,,,,,,,,,,,,,,,,,,,,,,,,,,0,5.0,5.0,3.0,6.0,4.0,4.0,2.0,3.0,6.0,5.0,4.0,6.0,4.0,6.0,5.0,4.0,5.0,5.0,5.0,3.0,5.0,5.0,5.0,5.0,3.0,3.0,2.0,6.0,5.0,5.0,6.0,4.0,10,,,,,,,,,,,,,,,,,,,,,,,,,,,,,,,,,1,5.0,5.0,5.0,6.0,3.0,6.0,3.0,2.0,5.0,6.0,5.0,3.0,5.0,6.0,6.0,5.0,5.0,6.0,6.0,5.0,5.0,5.0,5.0,6.0,3.0,3.0,1.0,5.0,6.0,5.0,5.0,6.0,4,,,,,,,,,,,,,,,,,,,,,,,,,,,,,,,,,12,,,,,,,,,,,,,,,,,,,,,,,,,,,,,,,,,"The survey on looking at 3 different visualizations was interesting to look at the concept and taste my judgement on my opinions whether it is nice, good aesthetics or different.",376.55,10.25,,,,26.79,,49.7,,,,,,,,,,,,,,,,,,,,,,,,,,80.03,,,,,,102.23,,,,,,65.47,,,,,,,,,42.08,,APPROVED,Male,24.0,FALSE
782,2022-03-22 01:59:19,19,en,1680483114,2022-03-22 01:53:41,2022-03-22 01:59:18,Y,Y,A1,,,8,,,,,,,,,,,,,,,,,,,,,,,,,,,,,,,,,6,,,,,,,,,,,,,,,,,,,,,,,,,,,,,,,,,2,6.0,5.0,5.0,5.0,6.0,7.0,2.0,3.0,6.0,5.0,5.0,6.0,7.0,5.0,6.0,5.0,6.0,5.0,6.0,7.0,6.0,6.0,5.0,5.0,7.0,4.0,2.0,6.0,6.0,5.0,6.0,3.0,3,,,,,,,,,,,,,,,,,,,,,,,,,,,,,,,,,5,,,,,,,,,,,,,,,,,,,,,,,,,,,,,,,,,12,,,,,,,,,,,,,,,,,,,,,,,,,,,,,,,,,10,,,,,,,,,,,,,,,,,,,,,,,,,,,,,,,,,11,,,,,,,,,,,,,,,,,,,,,,,,,,,,,,,,,7,,,,,,,,,,,,,,,,,,,,,,,,,,,,,,,,,9,,,,,,,,,,,,,,,,,,,,,,,,,,,,,,,,,0,4.0,7.0,3.0,5.0,3.0,3.0,6.0,6.0,6.0,5.0,5.0,6.0,7.0,6.0,5.0,5.0,6.0,4.0,6.0,3.0,2.0,5.0,2.0,3.0,4.0,4.0,6.0,5.0,5.0,4.0,5.0,4.0,14,,,,,,,,,,,,,,,,,,,,,,,,,,,,,,,,,13,,,,,,,,,,,,,,,,,,,,,,,,,,,,,,,,,1,1.0,3.0,1.0,2.0,2.0,1.0,7.0,6.0,6.0,2.0,1.0,3.0,2.0,2.0,1.0,1.0,5.0,1.0,1.0,1.0,2.0,1.0,1.0,1.0,1.0,2.0,6.0,1.0,1.0,2.0,3.0,7.0,4,,,,,,,,,,,,,,,,,,,,,,,,,,,,,,,,,,339.81,13.67,,,,7.43,,24.72,,,,,,,,71.97,,,,,,,,,,,,,,,,,,,,,,,,132.49,,,,,,,,,83.54,,,,,,5.99,,APPROVED,Male,23.0,FALSE
783,2022-03-22 02:05:39,19,en,513415694,2022-03-22 01:53:43,2022-03-22 02:05:39,Y,Y,-oth-,12th grade,,5,,,,,,,,,,,,,,,,,,,,,,,,,,,,,,,,,14,,,,,,,,,,,,,,,,,,,,,,,,,,,,,,,,,11,,,,,,,,,,,,,,,,,,,,,,,,,,,,,,,,,7,,,,,,,,,,,,,,,,,,,,,,,,,,,,,,,,,13,,,,,,,,,,,,,,,,,,,,,,,,,,,,,,,,,0,2.0,5.0,3.0,2.0,4.0,1.0,6.0,2.0,3.0,2.0,3.0,4.0,2.0,4.0,4.0,2.0,3.0,2.0,4.0,3.0,3.0,3.0,2.0,4.0,5.0,2.0,4.0,3.0,3.0,3.0,3.0,6.0,10,,,,,,,,,,,,,,,,,,,,,,,,,,,,,,,,,3,,,,,,,,,,,,,,,,,,,,,,,,,,,,,,,,,12,,,,,,,,,,,,,,,,,,,,,,,,,,,,,,,,,1,5.0,4.0,5.0,5.0,4.0,5.0,3.0,1.0,6.0,5.0,5.0,5.0,5.0,4.0,5.0,4.0,5.0,4.0,5.0,5.0,5.0,4.0,4.0,5.0,5.0,4.0,4.0,4.0,5.0,4.0,6.0,3.0,9,,,,,,,,,,,,,,,,,,,,,,,,,,,,,,,,,6,,,,,,,,,,,,,,,,,,,,,,,,,,,,,,,,,4,,,,,,,,,,,,,,,,,,,,,,,,,,,,,,,,,8,,,,,,,,,,,,,,,,,,,,,,,,,,,,,,,,,2,7.0,6.0,5.0,5.0,6.0,6.0,5.0,5.0,5.0,6.0,6.0,5.0,6.0,5.0,6.0,5.0,5.0,6.0,6.0,5.0,6.0,6.0,6.0,5.0,5.0,5.0,5.0,6.0,6.0,5.0,5.0,7.0,,717.26,185.87,,,,36.43,,138.51,,,,,,,,,,,,,,,,,147.45,,,,,,,,,,,,117.7,,,,,,,,,,,,,,,80.03,,,11.27,,APPROVED,Male,32.0,FALSE
784,2022-03-22 01:58:19,19,en,62990517,2022-03-22 01:53:44,2022-03-22 01:58:19,Y,Y,A2,,,9,,,,,,,,,,,,,,,,,,,,,,,,,,,,,,,,,4,,,,,,,,,,,,,,,,,,,,,,,,,,,,,,,,,6,,,,,,,,,,,,,,,,,,,,,,,,,,,,,,,,,0,3.0,3.0,3.0,4.0,6.0,5.0,6.0,5.0,5.0,4.0,5.0,6.0,5.0,5.0,7.0,4.0,5.0,3.0,4.0,4.0,5.0,5.0,5.0,4.0,3.0,6.0,6.0,4.0,5.0,5.0,6.0,4.0,1,3.0,2.0,2.0,2.0,2.0,2.0,7.0,5.0,3.0,2.0,2.0,2.0,3.0,3.0,2.0,2.0,2.0,2.0,4.0,4.0,2.0,3.0,2.0,3.0,2.0,3.0,2.0,3.0,2.0,3.0,2.0,5.0,11,,,,,,,,,,,,,,,,,,,,,,,,,,,,,,,,,13,,,,,,,,,,,,,,,,,,,,,,,,,,,,,,,,,3,,,,,,,,,,,,,,,,,,,,,,,,,,,,,,,,,5,,,,,,,,,,,,,,,,,,,,,,,,,,,,,,,,,10,,,,,,,,,,,,,,,,,,,,,,,,,,,,,,,,,2,5.0,6.0,3.0,5.0,4.0,5.0,6.0,5.0,6.0,4.0,5.0,6.0,5.0,4.0,5.0,3.0,6.0,3.0,4.0,3.0,3.0,3.0,3.0,4.0,3.0,4.0,5.0,5.0,5.0,3.0,5.0,4.0,14,,,,,,,,,,,,,,,,,,,,,,,,,,,,,,,,,7,,,,,,,,,,,,,,,,,,,,,,,,,,,,,,,,,8,,,,,,,,,,,,,,,,,,,,,,,,,,,,,,,,,12,,,,,,,,,,,,,,,,,,,,,,,,,,,,,,,,,,279.01,25.07,,,,5.67,,24.94,,,,,,,,,,,72.82,,,69.83,,,,,,,,,,,,,,,,,,75.81,,,,,,,,,,,,,,,4.87,,APPROVED,Male,47.0,FALSE
785,2022-03-22 02:00:54,19,en,1202335468,2022-03-22 01:53:44,2022-03-22 02:00:54,Y,Y,A2,,,14,,,,,,,,,,,,,,,,,,,,,,,,,,,,,,,,,5,,,,,,,,,,,,,,,,,,,,,,,,,,,,,,,,,9,,,,,,,,,,,,,,,,,,,,,,,,,,,,,,,,,1,5.0,5.0,6.0,5.0,5.0,3.0,5.0,5.0,6.0,5.0,5.0,5.0,5.0,6.0,6.0,5.0,6.0,5.0,5.0,4.0,4.0,6.0,5.0,6.0,6.0,5.0,6.0,6.0,6.0,6.0,6.0,4.0,12,,,,,,,,,,,,,,,,,,,,,,,,,,,,,,,,,13,,,,,,,,,,,,,,,,,,,,,,,,,,,,,,,,,7,,,,,,,,,,,,,,,,,,,,,,,,,,,,,,,,,6,,,,,,,,,,,,,,,,,,,,,,,,,,,,,,,,,4,,,,,,,,,,,,,,,,,,,,,,,,,,,,,,,,,0,5.0,2.0,5.0,3.0,3.0,2.0,5.0,4.0,4.0,2.0,4.0,5.0,3.0,4.0,5.0,3.0,5.0,3.0,3.0,2.0,3.0,2.0,4.0,3.0,4.0,5.0,5.0,4.0,5.0,4.0,3.0,3.0,2,2.0,4.0,2.0,2.0,2.0,2.0,2.0,3.0,4.0,2.0,2.0,3.0,2.0,2.0,4.0,3.0,3.0,2.0,2.0,2.0,2.0,2.0,2.0,2.0,2.0,4.0,4.0,2.0,2.0,2.0,3.0,4.0,8,,,,,,,,,,,,,,,,,,,,,,,,,,,,,,,,,10,,,,,,,,,,,,,,,,,,,,,,,,,,,,,,,,,11,,,,,,,,,,,,,,,,,,,,,,,,,,,,,,,,,3,,,,,,,,,,,,,,,,,,,,,,,,,,,,,,,,,,432.45,97.67,,,,7.52,,24.29,,,,,,,,,,,137.05,,,,,,,,,,,,,,,,,,101.2,,,60.6,,,,,,,,,,,,,,,4.12,,APPROVED,Male,32.0,FALSE
787,2022-03-22 01:59:19,19,en,985588506,2022-03-22 01:53:46,2022-03-22 01:59:19,Y,Y,A1,,,5,,,,,,,,,,,,,,,,,,,,,,,,,,,,,,,,,13,,,,,,,,,,,,,,,,,,,,,,,,,,,,,,,,,6,,,,,,,,,,,,,,,,,,,,,,,,,,,,,,,,,4,,,,,,,,,,,,,,,,,,,,,,,,,,,,,,,,,8,,,,,,,,,,,,,,,,,,,,,,,,,,,,,,,,,11,,,,,,,,,,,,,,,,,,,,,,,,,,,,,,,,,3,,,,,,,,,,,,,,,,,,,,,,,,,,,,,,,,,2,5.0,5.0,4.0,4.0,4.0,4.0,4.0,4.0,6.0,4.0,4.0,5.0,6.0,5.0,5.0,4.0,6.0,6.0,5.0,4.0,4.0,5.0,4.0,5.0,4.0,3.0,3.0,4.0,4.0,4.0,3.0,1.0,10,,,,,,,,,,,,,,,,,,,,,,,,,,,,,,,,,9,,,,,,,,,,,,,,,,,,,,,,,,,,,,,,,,,12,,,,,,,,,,,,,,,,,,,,,,,,,,,,,,,,,14,,,,,,,,,,,,,,,,,,,,,,,,,,,,,,,,,7,,,,,,,,,,,,,,,,,,,,,,,,,,,,,,,,,1,2.0,2.0,2.0,3.0,2.0,2.0,5.0,3.0,3.0,2.0,2.0,4.0,3.0,4.0,3.0,3.0,4.0,2.0,2.0,2.0,3.0,2.0,3.0,3.0,2.0,3.0,5.0,3.0,4.0,3.0,3.0,7.0,0,3.0,5.0,4.0,2.0,3.0,2.0,6.0,4.0,5.0,2.0,3.0,5.0,4.0,4.0,4.0,3.0,5.0,3.0,3.0,2.0,4.0,3.0,2.0,4.0,4.0,3.0,6.0,2.0,5.0,3.0,3.0,1.0,,334.79,44.33,,,,13.66,,21.78,,,,,,,,,,,,,,,,,,,,,,,81.77,,,,,,,,,,,,,,,,,,70.99,,,98.95,,,3.31,,APPROVED,Female,40.0,FALSE
788,2022-03-22 01:59:24,19,en,572558973,2022-03-22 01:53:48,2022-03-22 01:59:24,Y,Y,A2,,,2,3.0,5.0,3.0,5.0,3.0,3.0,5.0,6.0,5.0,3.0,3.0,5.0,4.0,4.0,3.0,6.0,5.0,3.0,4.0,3.0,4.0,4.0,5.0,3.0,4.0,4.0,4.0,5.0,5.0,4.0,4.0,1.0,5,,,,,,,,,,,,,,,,,,,,,,,,,,,,,,,,,6,,,,,,,,,,,,,,,,,,,,,,,,,,,,,,,,,1,5.0,5.0,6.0,5.0,6.0,5.0,3.0,6.0,6.0,5.0,6.0,4.0,6.0,5.0,5.0,5.0,5.0,5.0,6.0,5.0,5.0,6.0,5.0,6.0,6.0,5.0,3.0,6.0,5.0,6.0,5.0,4.0,4,,,,,,,,,,,,,,,,,,,,,,,,,,,,,,,,,10,,,,,,,,,,,,,,,,,,,,,,,,,,,,,,,,,12,,,,,,,,,,,,,,,,,,,,,,,,,,,,,,,,,11,,,,,,,,,,,,,,,,,,,,,,,,,,,,,,,,,8,,,,,,,,,,,,,,,,,,,,,,,,,,,,,,,,,0,2.0,3.0,2.0,2.0,2.0,1.0,7.0,1.0,5.0,1.0,2.0,2.0,2.0,2.0,3.0,1.0,5.0,2.0,2.0,1.0,2.0,2.0,3.0,2.0,1.0,2.0,3.0,2.0,3.0,2.0,2.0,3.0,14,,,,,,,,,,,,,,,,,,,,,,,,,,,,,,,,,9,,,,,,,,,,,,,,,,,,,,,,,,,,,,,,,,,7,,,,,,,,,,,,,,,,,,,,,,,,,,,,,,,,,3,,,,,,,,,,,,,,,,,,,,,,,,,,,,,,,,,13,,,,,,,,,,,,,,,,,,,,,,,,,,,,,,,,,,339.33,19.44,,,,5.92,,26.62,,81.38,,,,,,,,,74.88,,,,,,,,,,,,,,,,,,127.64,,,,,,,,,,,,,,,,,,3.45,,APPROVED,Male,39.0,FALSE
789,2022-03-22 02:00:18,19,en,470425993,2022-03-22 01:53:48,2022-03-22 02:00:18,Y,Y,-oth-,high school diploma,,5,,,,,,,,,,,,,,,,,,,,,,,,,,,,,,,,,3,,,,,,,,,,,,,,,,,,,,,,,,,,,,,,,,,1,7.0,7.0,7.0,6.0,7.0,7.0,4.0,7.0,7.0,7.0,7.0,7.0,7.0,7.0,7.0,7.0,7.0,7.0,7.0,7.0,5.0,7.0,4.0,7.0,7.0,6.0,1.0,7.0,5.0,7.0,7.0,3.0,11,,,,,,,,,,,,,,,,,,,,,,,,,,,,,,,,,0,7.0,7.0,6.0,3.0,6.0,2.0,7.0,7.0,7.0,5.0,4.0,6.0,6.0,7.0,7.0,6.0,7.0,3.0,5.0,4.0,4.0,6.0,3.0,3.0,5.0,3.0,1.0,7.0,4.0,5.0,5.0,5.0,6,,,,,,,,,,,,,,,,,,,,,,,,,,,,,,,,,13,,,,,,,,,,,,,,,,,,,,,,,,,,,,,,,,,2,1.0,2.0,3.0,1.0,1.0,1.0,7.0,1.0,3.0,1.0,1.0,3.0,3.0,2.0,5.0,1.0,4.0,1.0,2.0,2.0,1.0,2.0,1.0,1.0,1.0,1.0,6.0,1.0,1.0,1.0,1.0,1.0,9,,,,,,,,,,,,,,,,,,,,,,,,,,,,,,,,,7,,,,,,,,,,,,,,,,,,,,,,,,,,,,,,,,,10,,,,,,,,,,,,,,,,,,,,,,,,,,,,,,,,,4,,,,,,,,,,,,,,,,,,,,,,,,,,,,,,,,,14,,,,,,,,,,,,,,,,,,,,,,,,,,,,,,,,,8,,,,,,,,,,,,,,,,,,,,,,,,,,,,,,,,,12,,,,,,,,,,,,,,,,,,,,,,,,,,,,,,,,,,392.73,74.85,,,,14.21,,38.63,,,,,,,,60.53,,,,,,87.07,,,,,,,,,114.4,,,,,,,,,,,,,,,,,,,,,,,,3.04,,APPROVED,Male,20.0,FALSE
790,2022-03-22 02:02:26,19,en,390671953,2022-03-22 01:53:49,2022-03-22 02:02:26,Y,Y,A1,,,4,,,,,,,,,,,,,,,,,,,,,,,,,,,,,,,,,14,,,,,,,,,,,,,,,,,,,,,,,,,,,,,,,,,2,6.0,5.0,6.0,7.0,5.0,6.0,1.0,7.0,7.0,5.0,6.0,5.0,6.0,5.0,5.0,7.0,6.0,6.0,6.0,6.0,5.0,6.0,6.0,6.0,6.0,7.0,2.0,6.0,6.0,6.0,7.0,3.0,0,6.0,6.0,5.0,4.0,6.0,3.0,5.0,6.0,6.0,5.0,6.0,5.0,5.0,5.0,6.0,2.0,6.0,4.0,4.0,4.0,6.0,6.0,4.0,6.0,6.0,6.0,5.0,4.0,7.0,6.0,7.0,4.0,5,,,,,,,,,,,,,,,,,,,,,,,,,,,,,,,,,13,,,,,,,,,,,,,,,,,,,,,,,,,,,,,,,,,12,,,,,,,,,,,,,,,,,,,,,,,,,,,,,,,,,1,3.0,2.0,5.0,3.0,2.0,1.0,6.0,5.0,2.0,3.0,2.0,3.0,2.0,3.0,4.0,1.0,2.0,2.0,2.0,3.0,3.0,6.0,2.0,4.0,3.0,3.0,1.0,2.0,2.0,4.0,2.0,1.0,11,,,,,,,,,,,,,,,,,,,,,,,,,,,,,,,,,8,,,,,,,,,,,,,,,,,,,,,,,,,,,,,,,,,9,,,,,,,,,,,,,,,,,,,,,,,,,,,,,,,,,7,,,,,,,,,,,,,,,,,,,,,,,,,,,,,,,,,3,,,,,,,,,,,,,,,,,,,,,,,,,,,,,,,,,10,,,,,,,,,,,,,,,,,,,,,,,,,,,,,,,,,6,,,,,,,,,,,,,,,,,,,,,,,,,,,,,,,,,,520.37,18.67,,,,11.44,,72.39,,,,,,,,119.82,,,149.97,,,,,,,,,,,,144.25,,,,,,,,,,,,,,,,,,,,,,,,3.83,,APPROVED,Female,39.0,FALSE
791,2022-03-22 02:02:30,19,en,1589308259,2022-03-22 01:53:50,2022-03-22 02:02:30,Y,Y,A1,,,7,,,,,,,,,,,,,,,,,,,,,,,,,,,,,,,,,14,,,,,,,,,,,,,,,,,,,,,,,,,,,,,,,,,5,,,,,,,,,,,,,,,,,,,,,,,,,,,,,,,,,9,,,,,,,,,,,,,,,,,,,,,,,,,,,,,,,,,0,3.0,6.0,4.0,4.0,4.0,3.0,5.0,4.0,5.0,4.0,4.0,5.0,4.0,5.0,5.0,3.0,4.0,3.0,3.0,4.0,4.0,4.0,4.0,4.0,6.0,2.0,4.0,4.0,6.0,4.0,4.0,5.0,12,,,,,,,,,,,,,,,,,,,,,,,,,,,,,,,,,11,,,,,,,,,,,,,,,,,,,,,,,,,,,,,,,,,10,,,,,,,,,,,,,,,,,,,,,,,,,,,,,,,,,1,3.0,2.0,3.0,4.0,2.0,4.0,3.0,3.0,2.0,3.0,4.0,4.0,4.0,4.0,4.0,5.0,3.0,2.0,3.0,3.0,3.0,3.0,6.0,2.0,3.0,6.0,4.0,3.0,4.0,3.0,4.0,2.0,2,4.0,7.0,3.0,4.0,4.0,2.0,5.0,4.0,7.0,3.0,3.0,5.0,3.0,5.0,5.0,4.0,5.0,3.0,4.0,4.0,3.0,3.0,2.0,3.0,4.0,4.0,5.0,4.0,4.0,3.0,4.0,3.0,8,,,,,,,,,,,,,,,,,,,,,,,,,,,,,,,,,6,,,,,,,,,,,,,,,,,,,,,,,,,,,,,,,,,13,,,,,,,,,,,,,,,,,,,,,,,,,,,,,,,,,4,,,,,,,,,,,,,,,,,,,,,,,,,,,,,,,,,3,,,,,,,,,,,,,,,,,,,,,,,,,,,,,,,,,,522.19,174.91,,,,10.17,,54.78,,,,,,,,,,,,,,98.06,,,,,,,,,,,,98.14,,,80.47,,,,,,,,,,,,,,,,,,5.66,,APPROVED,Male,31.0,FALSE
792,2022-03-22 02:22:30,19,en,264762223,2022-03-22 01:53:50,2022-03-22 02:22:30,Y,Y,A1,,,12,,,,,,,,,,,,,,,,,,,,,,,,,,,,,,,,,7,,,,,,,,,,,,,,,,,,,,,,,,,,,,,,,,,3,,,,,,,,,,,,,,,,,,,,,,,,,,,,,,,,,6,,,,,,,,,,,,,,,,,,,,,,,,,,,,,,,,,2,6.0,6.0,6.0,6.0,5.0,7.0,5.0,5.0,6.0,5.0,6.0,6.0,7.0,5.0,6.0,7.0,6.0,6.0,6.0,6.0,6.0,6.0,7.0,6.0,6.0,6.0,6.0,7.0,5.0,6.0,7.0,5.0,13,,,,,,,,,,,,,,,,,,,,,,,,,,,,,,,,,4,,,,,,,,,,,,,,,,,,,,,,,,,,,,,,,,,8,,,,,,,,,,,,,,,,,,,,,,,,,,,,,,,,,1,6.0,6.0,6.0,7.0,4.0,7.0,1.0,5.0,6.0,6.0,6.0,6.0,7.0,4.0,5.0,7.0,7.0,6.0,6.0,6.0,6.0,6.0,5.0,6.0,5.0,7.0,6.0,6.0,6.0,6.0,7.0,2.0,14,,,,,,,,,,,,,,,,,,,,,,,,,,,,,,,,,11,,,,,,,,,,,,,,,,,,,,,,,,,,,,,,,,,10,,,,,,,,,,,,,,,,,,,,,,,,,,,,,,,,,5,,,,,,,,,,,,,,,,,,,,,,,,,,,,,,,,,0,7.0,6.0,7.0,6.0,4.0,6.0,1.0,6.0,6.0,4.0,4.0,6.0,6.0,6.0,6.0,6.0,6.0,6.0,6.0,5.0,6.0,6.0,6.0,5.0,4.0,6.0,6.0,7.0,5.0,5.0,6.0,7.0,9,,,,,,,,,,,,,,,,,,,,,,,,,,,,,,,,,,1723.75,66.0,,,,37.94,,190.2,,,,,,,,,,,,,,76.36,,,,,,,,,,,,973.71,,,,,,,,,,,,,,,374.85,,,,,,4.69,,APPROVED,Female,34.0,FALSE
793,2022-03-22 02:01:55,19,en,985553774,2022-03-22 01:53:53,2022-03-22 02:01:55,Y,Y,-oth-,TAFE college Cert IV (Australia),,7,,,,,,,,,,,,,,,,,,,,,,,,,,,,,,,,,4,,,,,,,,,,,,,,,,,,,,,,,,,,,,,,,,,1,6.0,6.0,6.0,3.0,7.0,5.0,4.0,7.0,7.0,7.0,6.0,7.0,5.0,5.0,6.0,4.0,7.0,5.0,6.0,7.0,5.0,6.0,3.0,6.0,6.0,4.0,3.0,5.0,5.0,6.0,6.0,3.0,10,,,,,,,,,,,,,,,,,,,,,,,,,,,,,,,,,11,,,,,,,,,,,,,,,,,,,,,,,,,,,,,,,,,6,,,,,,,,,,,,,,,,,,,,,,,,,,,,,,,,,5,,,,,,,,,,,,,,,,,,,,,,,,,,,,,,,,,2,6.0,5.0,5.0,4.0,5.0,3.0,5.0,6.0,5.0,6.0,4.0,7.0,5.0,5.0,5.0,3.0,6.0,6.0,6.0,5.0,4.0,6.0,5.0,3.0,5.0,3.0,5.0,6.0,4.0,5.0,5.0,1.0,14,,,,,,,,,,,,,,,,,,,,,,,,,,,,,,,,,0,1.0,5.0,1.0,2.0,2.0,1.0,7.0,1.0,2.0,2.0,2.0,1.0,2.0,2.0,5.0,1.0,6.0,1.0,1.0,1.0,1.0,1.0,1.0,1.0,5.0,1.0,2.0,1.0,1.0,1.0,1.0,3.0,3,,,,,,,,,,,,,,,,,,,,,,,,,,,,,,,,,12,,,,,,,,,,,,,,,,,,,,,,,,,,,,,,,,,13,,,,,,,,,,,,,,,,,,,,,,,,,,,,,,,,,9,,,,,,,,,,,,,,,,,,,,,,,,,,,,,,,,,8,,,,,,,,,,,,,,,,,,,,,,,,,,,,,,,,,"All very interesting, the first very confusing.",485.71,33.47,,,,22.75,,39.33,,,,,,,,126.27,,,,,,,,,,,,,,,110.52,,,,,,128.93,,,,,,,,,,,,,,,,,,24.44,,APPROVED,Female,54.0,FALSE
794,2022-03-22 02:00:45,19,en,1561028000,2022-03-22 01:53:56,2022-03-22 02:00:45,Y,Y,-oth-,diploma,,5,,,,,,,,,,,,,,,,,,,,,,,,,,,,,,,,,0,6.0,6.0,6.0,5.0,6.0,6.0,5.0,5.0,6.0,6.0,6.0,6.0,5.0,6.0,6.0,6.0,6.0,6.0,6.0,6.0,5.0,6.0,7.0,5.0,6.0,6.0,6.0,6.0,5.0,6.0,5.0,2.0,13,,,,,,,,,,,,,,,,,,,,,,,,,,,,,,,,,7,,,,,,,,,,,,,,,,,,,,,,,,,,,,,,,,,12,,,,,,,,,,,,,,,,,,,,,,,,,,,,,,,,,8,,,,,,,,,,,,,,,,,,,,,,,,,,,,,,,,,11,,,,,,,,,,,,,,,,,,,,,,,,,,,,,,,,,1,3.0,6.0,1.0,3.0,3.0,2.0,6.0,4.0,6.0,5.0,4.0,6.0,2.0,3.0,6.0,2.0,2.0,3.0,2.0,1.0,4.0,2.0,3.0,2.0,2.0,6.0,4.0,5.0,6.0,2.0,2.0,1.0,4,,,,,,,,,,,,,,,,,,,,,,,,,,,,,,,,,6,,,,,,,,,,,,,,,,,,,,,,,,,,,,,,,,,10,,,,,,,,,,,,,,,,,,,,,,,,,,,,,,,,,9,,,,,,,,,,,,,,,,,,,,,,,,,,,,,,,,,2,6.0,6.0,6.0,6.0,6.0,6.0,5.0,6.0,6.0,5.0,5.0,6.0,5.0,6.0,6.0,6.0,5.0,6.0,6.0,5.0,6.0,6.0,6.0,4.0,6.0,6.0,6.0,6.0,6.0,6.0,5.0,6.0,14,,,,,,,,,,,,,,,,,,,,,,,,,,,,,,,,,3,,,,,,,,,,,,,,,,,,,,,,,,,,,,,,,,,,412.72,40.79,,,,14.51,,45.42,,,,,117.99,,,,,,,,,,,,,,,,,,105.72,,,,,,,,,,,,,,,82.77,,,,,,,,,5.52,,APPROVED,Male,41.0,FALSE
795,2022-03-22 02:01:04,19,en,18032381,2022-03-22 01:54:01,2022-03-22 02:01:04,Y,Y,A1,,,13,,,,,,,,,,,,,,,,,,,,,,,,,,,,,,,,,7,,,,,,,,,,,,,,,,,,,,,,,,,,,,,,,,,12,,,,,,,,,,,,,,,,,,,,,,,,,,,,,,,,,10,,,,,,,,,,,,,,,,,,,,,,,,,,,,,,,,,9,,,,,,,,,,,,,,,,,,,,,,,,,,,,,,,,,11,,,,,,,,,,,,,,,,,,,,,,,,,,,,,,,,,2,4.0,6.0,5.0,5.0,5.0,2.0,6.0,7.0,7.0,4.0,3.0,5.0,6.0,5.0,6.0,5.0,7.0,6.0,5.0,3.0,2.0,5.0,2.0,3.0,5.0,1.0,6.0,4.0,4.0,3.0,2.0,7.0,8,,,,,,,,,,,,,,,,,,,,,,,,,,,,,,,,,3,,,,,,,,,,,,,,,,,,,,,,,,,,,,,,,,,1,1.0,3.0,1.0,1.0,1.0,1.0,7.0,1.0,6.0,3.0,1.0,1.0,1.0,1.0,2.0,2.0,1.0,1.0,1.0,1.0,1.0,1.0,1.0,1.0,1.0,1.0,7.0,3.0,4.0,2.0,1.0,3.0,5,,,,,,,,,,,,,,,,,,,,,,,,,,,,,,,,,6,,,,,,,,,,,,,,,,,,,,,,,,,,,,,,,,,0,3.0,6.0,3.0,2.0,3.0,2.0,7.0,6.0,7.0,2.0,3.0,6.0,2.0,2.0,6.0,2.0,5.0,1.0,3.0,4.0,2.0,2.0,5.0,2.0,4.0,7.0,5.0,3.0,4.0,2.0,4.0,6.0,14,,,,,,,,,,,,,,,,,,,,,,,,,,,,,,,,,4,,,,,,,,,,,,,,,,,,,,,,,,,,,,,,,,,,427.28,14.87,,,,9.51,,41.32,,,,,,,,,,,,,,,,,,,,131.61,,,,,,,,,103.46,,,,,,,,,122.73,,,,,,,,,3.78,,APPROVED,Female,23.0,FALSE
796,2022-03-22 02:05:07,19,en,201561692,2022-03-22 01:54:25,2022-03-22 02:05:07,Y,Y,-oth-,GED,,3,,,,,,,,,,,,,,,,,,,,,,,,,,,,,,,,,0,5.0,1.0,5.0,2.0,3.0,2.0,5.0,1.0,2.0,3.0,2.0,5.0,1.0,1.0,1.0,3.0,3.0,1.0,3.0,2.0,2.0,1.0,4.0,1.0,4.0,3.0,1.0,1.0,5.0,2.0,4.0,2.0,7,,,,,,,,,,,,,,,,,,,,,,,,,,,,,,,,,5,,,,,,,,,,,,,,,,,,,,,,,,,,,,,,,,,10,,,,,,,,,,,,,,,,,,,,,,,,,,,,,,,,,4,,,,,,,,,,,,,,,,,,,,,,,,,,,,,,,,,14,,,,,,,,,,,,,,,,,,,,,,,,,,,,,,,,,1,1.0,1.0,1.0,1.0,1.0,1.0,7.0,1.0,1.0,1.0,1.0,1.0,1.0,1.0,1.0,1.0,1.0,1.0,1.0,1.0,1.0,1.0,1.0,1.0,2.0,2.0,7.0,1.0,1.0,1.0,1.0,1.0,6,,,,,,,,,,,,,,,,,,,,,,,,,,,,,,,,,2,1.0,1.0,1.0,1.0,1.0,1.0,7.0,1.0,1.0,1.0,2.0,1.0,1.0,1.0,1.0,1.0,1.0,1.0,1.0,1.0,1.0,1.0,1.0,1.0,1.0,1.0,7.0,1.0,2.0,1.0,1.0,3.0,11,,,,,,,,,,,,,,,,,,,,,,,,,,,,,,,,,8,,,,,,,,,,,,,,,,,,,,,,,,,,,,,,,,,13,,,,,,,,,,,,,,,,,,,,,,,,,,,,,,,,,12,,,,,,,,,,,,,,,,,,,,,,,,,,,,,,,,,9,,,,,,,,,,,,,,,,,,,,,,,,,,,,,,,,,Terrible survey. Difficult to navigate. Awkward. Poorly done.,646.36,47.0,,,,73.37,,40.7,,,,,233.97,,,,,,,,,,,,,,,,,,112.08,,,,,,96.36,,,,,,,,,,,,,,,,,,42.88,,APPROVED,Male,52.0,FALSE
797,2022-03-22 02:20:01,19,en,1020350771,2022-03-22 01:54:43,2022-03-22 02:20:01,Y,Y,A1,,,6,,,,,,,,,,,,,,,,,,,,,,,,,,,,,,,,,13,,,,,,,,,,,,,,,,,,,,,,,,,,,,,,,,,7,,,,,,,,,,,,,,,,,,,,,,,,,,,,,,,,,0,5.0,6.0,6.0,5.0,5.0,6.0,3.0,5.0,6.0,5.0,6.0,5.0,5.0,5.0,6.0,5.0,5.0,6.0,5.0,5.0,5.0,5.0,6.0,5.0,5.0,5.0,4.0,5.0,6.0,4.0,6.0,4.0,3,,,,,,,,,,,,,,,,,,,,,,,,,,,,,,,,,5,,,,,,,,,,,,,,,,,,,,,,,,,,,,,,,,,10,,,,,,,,,,,,,,,,,,,,,,,,,,,,,,,,,12,,,,,,,,,,,,,,,,,,,,,,,,,,,,,,,,,4,,,,,,,,,,,,,,,,,,,,,,,,,,,,,,,,,11,,,,,,,,,,,,,,,,,,,,,,,,,,,,,,,,,8,,,,,,,,,,,,,,,,,,,,,,,,,,,,,,,,,9,,,,,,,,,,,,,,,,,,,,,,,,,,,,,,,,,14,,,,,,,,,,,,,,,,,,,,,,,,,,,,,,,,,1,4.0,4.0,2.0,3.0,2.0,2.0,2.0,3.0,4.0,2.0,2.0,2.0,2.0,3.0,2.0,3.0,2.0,2.0,2.0,2.0,2.0,2.0,2.0,2.0,2.0,3.0,4.0,2.0,2.0,2.0,4.0,7.0,2,4.0,5.0,4.0,5.0,4.0,5.0,4.0,5.0,5.0,4.0,4.0,4.0,4.0,4.0,4.0,5.0,5.0,4.0,4.0,4.0,4.0,4.0,5.0,4.0,4.0,5.0,4.0,4.0,5.0,4.0,5.0,1.0,It has been a pleasure to participate in this survey. Thank you.,1521.51,376.2,,,,25.43,,138.49,,,,,,,,,,,551.64,,,,,,,,,,,,,,,,,,,,,,,,,,,,,,185.57,,,158.62,,,85.56,,APPROVED,Male,32.0,FALSE
798,2022-03-22 02:03:03,19,en,2127641060,2022-03-22 01:54:55,2022-03-22 02:03:03,Y,Y,A1,,,14,,,,,,,,,,,,,,,,,,,,,,,,,,,,,,,,,4,,,,,,,,,,,,,,,,,,,,,,,,,,,,,,,,,2,7.0,7.0,7.0,7.0,7.0,7.0,4.0,7.0,7.0,7.0,7.0,7.0,7.0,7.0,7.0,7.0,7.0,7.0,7.0,7.0,7.0,7.0,7.0,7.0,7.0,7.0,1.0,7.0,6.0,7.0,7.0,5.0,10,,,,,,,,,,,,,,,,,,,,,,,,,,,,,,,,,6,,,,,,,,,,,,,,,,,,,,,,,,,,,,,,,,,3,,,,,,,,,,,,,,,,,,,,,,,,,,,,,,,,,12,,,,,,,,,,,,,,,,,,,,,,,,,,,,,,,,,7,,,,,,,,,,,,,,,,,,,,,,,,,,,,,,,,,8,,,,,,,,,,,,,,,,,,,,,,,,,,,,,,,,,0,7.0,7.0,7.0,7.0,7.0,7.0,4.0,7.0,7.0,7.0,7.0,7.0,7.0,7.0,7.0,7.0,7.0,7.0,7.0,7.0,7.0,7.0,7.0,7.0,7.0,1.0,1.0,7.0,7.0,4.0,7.0,3.0,9,,,,,,,,,,,,,,,,,,,,,,,,,,,,,,,,,13,,,,,,,,,,,,,,,,,,,,,,,,,,,,,,,,,11,,,,,,,,,,,,,,,,,,,,,,,,,,,,,,,,,1,7.0,7.0,7.0,7.0,7.0,7.0,1.0,7.0,7.0,4.0,7.0,7.0,7.0,4.0,7.0,7.0,7.0,7.0,7.0,7.0,4.0,7.0,7.0,4.0,7.0,7.0,4.0,7.0,7.0,4.0,7.0,7.0,5,,,,,,,,,,,,,,,,,,,,,,,,,,,,,,,,,,492.24,91.43,,,,11.48,,31.52,,,,,,,,92.86,,,,,,,,,,,,,,,,,,,,,109.68,,,,,,,,,,,,149.73,,,,,,5.54,,APPROVED,Female,22.0,FALSE
801,2022-03-22 02:04:39,19,en,1248940103,2022-03-22 01:55:56,2022-03-22 02:04:39,Y,Y,-oth-,high school ,,9,,,,,,,,,,,,,,,,,,,,,,,,,,,,,,,,,4,,,,,,,,,,,,,,,,,,,,,,,,,,,,,,,,,5,,,,,,,,,,,,,,,,,,,,,,,,,,,,,,,,,3,,,,,,,,,,,,,,,,,,,,,,,,,,,,,,,,,13,,,,,,,,,,,,,,,,,,,,,,,,,,,,,,,,,1,4.0,7.0,4.0,3.0,4.0,3.0,4.0,3.0,6.0,5.0,2.0,5.0,5.0,4.0,6.0,3.0,6.0,4.0,5.0,7.0,5.0,4.0,2.0,5.0,5.0,2.0,3.0,5.0,2.0,5.0,4.0,6.0,10,,,,,,,,,,,,,,,,,,,,,,,,,,,,,,,,,11,,,,,,,,,,,,,,,,,,,,,,,,,,,,,,,,,14,,,,,,,,,,,,,,,,,,,,,,,,,,,,,,,,,0,3.0,7.0,3.0,4.0,4.0,3.0,4.0,3.0,7.0,4.0,4.0,5.0,2.0,4.0,7.0,2.0,7.0,3.0,2.0,2.0,3.0,2.0,2.0,2.0,4.0,3.0,6.0,5.0,4.0,4.0,5.0,3.0,12,,,,,,,,,,,,,,,,,,,,,,,,,,,,,,,,,8,,,,,,,,,,,,,,,,,,,,,,,,,,,,,,,,,6,,,,,,,,,,,,,,,,,,,,,,,,,,,,,,,,,2,3.0,3.0,6.0,6.0,4.0,7.0,4.0,7.0,6.0,4.0,7.0,7.0,4.0,6.0,6.0,6.0,5.0,5.0,4.0,4.0,4.0,4.0,7.0,7.0,4.0,7.0,5.0,4.0,5.0,4.0,7.0,7.0,7,,,,,,,,,,,,,,,,,,,,,,,,,,,,,,,,,,527.48,19.85,,,,25.91,,88.06,,,,,,,,,,,,,,,,,105.72,,,,,,,,,,,,176.47,,,,,,,,,,,,105.56,,,,,,5.91,,APPROVED,Male,19.0,FALSE
802,2022-03-22 02:05:28,19,en,931326098,2022-03-22 01:55:58,2022-03-22 02:05:28,Y,Y,A1,,,12,,,,,,,,,,,,,,,,,,,,,,,,,,,,,,,,,0,6.0,5.0,6.0,6.0,6.0,7.0,1.0,6.0,5.0,6.0,6.0,6.0,6.0,6.0,6.0,7.0,6.0,6.0,6.0,6.0,7.0,6.0,7.0,7.0,6.0,7.0,4.0,6.0,7.0,6.0,7.0,2.0,6,,,,,,,,,,,,,,,,,,,,,,,,,,,,,,,,,8,,,,,,,,,,,,,,,,,,,,,,,,,,,,,,,,,10,,,,,,,,,,,,,,,,,,,,,,,,,,,,,,,,,3,,,,,,,,,,,,,,,,,,,,,,,,,,,,,,,,,1,2.0,7.0,2.0,3.0,2.0,1.0,7.0,2.0,5.0,2.0,1.0,2.0,5.0,3.0,3.0,3.0,3.0,3.0,2.0,2.0,3.0,3.0,3.0,2.0,2.0,3.0,5.0,2.0,2.0,3.0,3.0,7.0,11,,,,,,,,,,,,,,,,,,,,,,,,,,,,,,,,,14,,,,,,,,,,,,,,,,,,,,,,,,,,,,,,,,,9,,,,,,,,,,,,,,,,,,,,,,,,,,,,,,,,,2,5.0,7.0,4.0,5.0,5.0,3.0,7.0,3.0,5.0,4.0,3.0,4.0,6.0,5.0,3.0,4.0,5.0,3.0,4.0,5.0,5.0,4.0,3.0,6.0,4.0,3.0,1.0,6.0,5.0,4.0,4.0,4.0,4,,,,,,,,,,,,,,,,,,,,,,,,,,,,,,,,,13,,,,,,,,,,,,,,,,,,,,,,,,,,,,,,,,,7,,,,,,,,,,,,,,,,,,,,,,,,,,,,,,,,,5,,,,,,,,,,,,,,,,,,,,,,,,,,,,,,,,,,573.01,120.03,,,,9.67,,33.66,,,,,71.27,,,,,,,,,,,,,,,181.11,,,,,,,,,,,,148.84,,,,,,,,,,,,,,,8.43,,APPROVED,Male,18.0,FALSE
803,2022-03-22 02:01:58,19,en,1766410069,2022-03-22 01:55:58,2022-03-22 02:01:58,Y,Y,-oth-,College Certificate,,5,,,,,,,,,,,,,,,,,,,,,,,,,,,,,,,,,13,,,,,,,,,,,,,,,,,,,,,,,,,,,,,,,,,4,,,,,,,,,,,,,,,,,,,,,,,,,,,,,,,,,1,5.0,6.0,5.0,6.0,5.0,5.0,3.0,6.0,6.0,5.0,4.0,5.0,5.0,5.0,6.0,4.0,5.0,4.0,4.0,5.0,5.0,6.0,5.0,5.0,5.0,5.0,2.0,5.0,5.0,5.0,5.0,4.0,0,4.0,6.0,4.0,4.0,3.0,5.0,5.0,4.0,6.0,3.0,4.0,4.0,4.0,3.0,5.0,4.0,5.0,3.0,4.0,4.0,5.0,4.0,5.0,4.0,4.0,5.0,4.0,4.0,4.0,4.0,4.0,5.0,10,,,,,,,,,,,,,,,,,,,,,,,,,,,,,,,,,8,,,,,,,,,,,,,,,,,,,,,,,,,,,,,,,,,14,,,,,,,,,,,,,,,,,,,,,,,,,,,,,,,,,9,,,,,,,,,,,,,,,,,,,,,,,,,,,,,,,,,3,,,,,,,,,,,,,,,,,,,,,,,,,,,,,,,,,7,,,,,,,,,,,,,,,,,,,,,,,,,,,,,,,,,2,2.0,3.0,2.0,4.0,2.0,6.0,2.0,3.0,2.0,2.0,2.0,2.0,2.0,2.0,3.0,2.0,2.0,3.0,2.0,2.0,2.0,4.0,2.0,2.0,3.0,6.0,2.0,2.0,3.0,5.0,3.0,5.0,6,,,,,,,,,,,,,,,,,,,,,,,,,,,,,,,,,12,,,,,,,,,,,,,,,,,,,,,,,,,,,,,,,,,11,,,,,,,,,,,,,,,,,,,,,,,,,,,,,,,,,,362.57,10.47,,,,12.42,,102.2,,,,,,,,,,,52.39,,,96.51,,,,,,,,,,,,,,,,,,,,,80.25,,,,,,,,,,,,8.33,,APPROVED,Female,24.0,FALSE
804,2022-03-22 02:00:10,19,en,379119189,2022-03-22 01:56:01,2022-03-22 02:00:10,Y,Y,A1,,,3,,,,,,,,,,,,,,,,,,,,,,,,,,,,,,,,,0,4.0,4.0,4.0,6.0,4.0,5.0,5.0,5.0,3.0,2.0,4.0,4.0,4.0,3.0,2.0,4.0,3.0,4.0,5.0,3.0,4.0,5.0,6.0,4.0,4.0,5.0,4.0,4.0,3.0,4.0,4.0,2.0,5,,,,,,,,,,,,,,,,,,,,,,,,,,,,,,,,,1,2.0,3.0,2.0,2.0,2.0,2.0,2.0,2.0,2.0,2.0,2.0,6.0,2.0,2.0,2.0,2.0,2.0,2.0,2.0,2.0,2.0,2.0,2.0,2.0,2.0,2.0,2.0,2.0,2.0,2.0,2.0,4.0,10,,,,,,,,,,,,,,,,,,,,,,,,,,,,,,,,,9,,,,,,,,,,,,,,,,,,,,,,,,,,,,,,,,,7,,,,,,,,,,,,,,,,,,,,,,,,,,,,,,,,,4,,,,,,,,,,,,,,,,,,,,,,,,,,,,,,,,,14,,,,,,,,,,,,,,,,,,,,,,,,,,,,,,,,,11,,,,,,,,,,,,,,,,,,,,,,,,,,,,,,,,,13,,,,,,,,,,,,,,,,,,,,,,,,,,,,,,,,,8,,,,,,,,,,,,,,,,,,,,,,,,,,,,,,,,,12,,,,,,,,,,,,,,,,,,,,,,,,,,,,,,,,,2,4.0,5.0,5.0,4.0,4.0,4.0,5.0,4.0,5.0,5.0,4.0,3.0,6.0,5.0,4.0,5.0,5.0,4.0,5.0,4.0,6.0,5.0,5.0,4.0,5.0,5.0,4.0,5.0,6.0,5.0,4.0,7.0,6,,,,,,,,,,,,,,,,,,,,,,,,,,,,,,,,,,252.44,26.58,,,,8.46,,32.03,,,,,68.3,,,,,,66.47,,,,,,,,,,,,,,,,,,,,,,,,,,,,,,45.63,,,,,,4.97,,APPROVED,Male,24.0,FALSE
805,2022-03-22 02:05:27,19,en,1898048269,2022-03-22 01:56:03,2022-03-22 02:05:27,Y,Y,A1,,,1,4.0,4.0,4.0,5.0,4.0,5.0,3.0,5.0,4.0,4.0,3.0,4.0,4.0,2.0,4.0,4.0,4.0,3.0,4.0,3.0,3.0,4.0,5.0,4.0,4.0,5.0,4.0,4.0,4.0,4.0,5.0,1.0,2,6.0,4.0,6.0,6.0,6.0,6.0,1.0,7.0,6.0,6.0,5.0,6.0,6.0,5.0,4.0,6.0,6.0,4.0,6.0,4.0,6.0,6.0,6.0,5.0,6.0,7.0,4.0,7.0,4.0,5.0,7.0,2.0,3,,,,,,,,,,,,,,,,,,,,,,,,,,,,,,,,,7,,,,,,,,,,,,,,,,,,,,,,,,,,,,,,,,,13,,,,,,,,,,,,,,,,,,,,,,,,,,,,,,,,,4,,,,,,,,,,,,,,,,,,,,,,,,,,,,,,,,,14,,,,,,,,,,,,,,,,,,,,,,,,,,,,,,,,,11,,,,,,,,,,,,,,,,,,,,,,,,,,,,,,,,,10,,,,,,,,,,,,,,,,,,,,,,,,,,,,,,,,,0,3.0,6.0,2.0,5.0,4.0,5.0,2.0,1.0,4.0,2.0,6.0,4.0,2.0,3.0,3.0,3.0,7.0,4.0,2.0,4.0,1.0,4.0,5.0,4.0,4.0,6.0,4.0,5.0,5.0,2.0,6.0,3.0,5,,,,,,,,,,,,,,,,,,,,,,,,,,,,,,,,,12,,,,,,,,,,,,,,,,,,,,,,,,,,,,,,,,,8,,,,,,,,,,,,,,,,,,,,,,,,,,,,,,,,,6,,,,,,,,,,,,,,,,,,,,,,,,,,,,,,,,,9,,,,,,,,,,,,,,,,,,,,,,,,,,,,,,,,,,568.14,32.56,,,,45.39,,35.61,,137.07,,,123.33,,,,,,,,,,,,,,,,,,,,,,,,190.79,,,,,,,,,,,,,,,,,,3.39,,APPROVED,Female,21.0,FALSE
806,2022-03-22 02:00:30,19,en,1336254565,2022-03-22 01:56:03,2022-03-22 02:00:29,Y,Y,A3,,,7,,,,,,,,,,,,,,,,,,,,,,,,,,,,,,,,,13,,,,,,,,,,,,,,,,,,,,,,,,,,,,,,,,,4,,,,,,,,,,,,,,,,,,,,,,,,,,,,,,,,,12,,,,,,,,,,,,,,,,,,,,,,,,,,,,,,,,,1,5.0,5.0,4.0,5.0,5.0,5.0,5.0,5.0,5.0,5.0,4.0,4.0,4.0,4.0,4.0,6.0,5.0,6.0,5.0,3.0,5.0,4.0,5.0,6.0,5.0,5.0,5.0,6.0,4.0,6.0,6.0,5.0,0,6.0,5.0,6.0,5.0,6.0,5.0,6.0,5.0,5.0,6.0,6.0,5.0,6.0,6.0,5.0,5.0,5.0,6.0,5.0,6.0,3.0,5.0,5.0,5.0,5.0,6.0,5.0,5.0,6.0,5.0,5.0,6.0,5,,,,,,,,,,,,,,,,,,,,,,,,,,,,,,,,,10,,,,,,,,,,,,,,,,,,,,,,,,,,,,,,,,,14,,,,,,,,,,,,,,,,,,,,,,,,,,,,,,,,,2,5.0,5.0,4.0,5.0,5.0,5.0,5.0,6.0,5.0,6.0,6.0,6.0,5.0,5.0,5.0,4.0,5.0,5.0,4.0,5.0,6.0,6.0,6.0,5.0,5.0,6.0,5.0,6.0,6.0,6.0,5.0,3.0,6,,,,,,,,,,,,,,,,,,,,,,,,,,,,,,,,,9,,,,,,,,,,,,,,,,,,,,,,,,,,,,,,,,,11,,,,,,,,,,,,,,,,,,,,,,,,,,,,,,,,,3,,,,,,,,,,,,,,,,,,,,,,,,,,,,,,,,,8,,,,,,,,,,,,,,,,,,,,,,,,,,,,,,,,,,269.96,12.3,,,,4.29,,29.78,,,,,,,,,,,,,,38.74,,,39.11,,,,,,,,,,,,141.73,,,,,,,,,,,,,,,,,,4.01,,APPROVED,Male,23.0,FALSE
807,2022-03-22 02:01:26,19,en,188113856,2022-03-22 01:56:04,2022-03-22 02:01:26,Y,Y,A2,,,6,,,,,,,,,,,,,,,,,,,,,,,,,,,,,,,,,9,,,,,,,,,,,,,,,,,,,,,,,,,,,,,,,,,10,,,,,,,,,,,,,,,,,,,,,,,,,,,,,,,,,12,,,,,,,,,,,,,,,,,,,,,,,,,,,,,,,,,1,4.0,5.0,3.0,4.0,4.0,5.0,4.0,3.0,5.0,5.0,3.0,6.0,4.0,4.0,3.0,2.0,3.0,2.0,4.0,3.0,5.0,5.0,5.0,3.0,4.0,3.0,4.0,4.0,3.0,3.0,5.0,3.0,4,,,,,,,,,,,,,,,,,,,,,,,,,,,,,,,,,3,,,,,,,,,,,,,,,,,,,,,,,,,,,,,,,,,2,3.0,2.0,4.0,1.0,3.0,2.0,5.0,4.0,2.0,3.0,2.0,2.0,5.0,3.0,4.0,4.0,3.0,4.0,1.0,2.0,3.0,4.0,5.0,2.0,4.0,2.0,2.0,3.0,3.0,2.0,3.0,1.0,7,,,,,,,,,,,,,,,,,,,,,,,,,,,,,,,,,0,2.0,4.0,2.0,2.0,5.0,2.0,3.0,4.0,3.0,1.0,2.0,2.0,4.0,2.0,3.0,2.0,2.0,2.0,2.0,2.0,3.0,2.0,2.0,2.0,2.0,2.0,2.0,5.0,2.0,5.0,4.0,3.0,5,,,,,,,,,,,,,,,,,,,,,,,,,,,,,,,,,11,,,,,,,,,,,,,,,,,,,,,,,,,,,,,,,,,13,,,,,,,,,,,,,,,,,,,,,,,,,,,,,,,,,14,,,,,,,,,,,,,,,,,,,,,,,,,,,,,,,,,8,,,,,,,,,,,,,,,,,,,,,,,,,,,,,,,,,it was something really different ,325.78,25.34,,,,6.46,,58.18,,,,,,,,,,,,,,37.27,,,,,,,,,56.93,,,,,,122.57,,,,,,,,,,,,,,,,,,19.03,,APPROVED,Male,34.0,FALSE
808,2022-03-22 02:00:28,19,en,1065660532,2022-03-22 01:56:05,2022-03-22 02:00:28,Y,Y,-oth-,Tafe certificate,,1,5.0,6.0,6.0,5.0,6.0,6.0,2.0,6.0,6.0,5.0,5.0,6.0,6.0,5.0,6.0,5.0,6.0,6.0,5.0,5.0,6.0,5.0,4.0,4.0,5.0,5.0,6.0,4.0,6.0,5.0,6.0,1.0,14,,,,,,,,,,,,,,,,,,,,,,,,,,,,,,,,,7,,,,,,,,,,,,,,,,,,,,,,,,,,,,,,,,,11,,,,,,,,,,,,,,,,,,,,,,,,,,,,,,,,,10,,,,,,,,,,,,,,,,,,,,,,,,,,,,,,,,,2,6.0,5.0,6.0,6.0,6.0,5.0,2.0,6.0,6.0,5.0,5.0,5.0,6.0,5.0,5.0,5.0,6.0,6.0,6.0,5.0,5.0,6.0,5.0,6.0,6.0,5.0,6.0,5.0,5.0,5.0,6.0,6.0,0,2.0,3.0,1.0,1.0,2.0,5.0,6.0,6.0,3.0,1.0,2.0,1.0,1.0,1.0,2.0,2.0,1.0,1.0,2.0,2.0,2.0,3.0,3.0,2.0,2.0,5.0,2.0,1.0,2.0,2.0,5.0,7.0,13,,,,,,,,,,,,,,,,,,,,,,,,,,,,,,,,,4,,,,,,,,,,,,,,,,,,,,,,,,,,,,,,,,,6,,,,,,,,,,,,,,,,,,,,,,,,,,,,,,,,,12,,,,,,,,,,,,,,,,,,,,,,,,,,,,,,,,,3,,,,,,,,,,,,,,,,,,,,,,,,,,,,,,,,,5,,,,,,,,,,,,,,,,,,,,,,,,,,,,,,,,,9,,,,,,,,,,,,,,,,,,,,,,,,,,,,,,,,,8,,,,,,,,,,,,,,,,,,,,,,,,,,,,,,,,,,266.18,25.61,,,,17.9,,41.95,,52.89,,,,,,,,,,,,,,,52.13,,,71.93,,,,,,,,,,,,,,,,,,,,,,,,,,,3.77,,APPROVED,Female,35.0,FALSE
809,2022-03-22 02:05:58,19,en,390829905,2022-03-22 01:56:06,2022-03-22 02:05:58,Y,Y,A2,,,3,,,,,,,,,,,,,,,,,,,,,,,,,,,,,,,,,13,,,,,,,,,,,,,,,,,,,,,,,,,,,,,,,,,9,,,,,,,,,,,,,,,,,,,,,,,,,,,,,,,,,11,,,,,,,,,,,,,,,,,,,,,,,,,,,,,,,,,1,5.0,5.0,7.0,6.0,6.0,6.0,3.0,7.0,7.0,7.0,6.0,6.0,6.0,6.0,7.0,5.0,7.0,5.0,7.0,6.0,6.0,6.0,6.0,6.0,6.0,6.0,2.0,5.0,2.0,7.0,6.0,5.0,5,,,,,,,,,,,,,,,,,,,,,,,,,,,,,,,,,14,,,,,,,,,,,,,,,,,,,,,,,,,,,,,,,,,8,,,,,,,,,,,,,,,,,,,,,,,,,,,,,,,,,10,,,,,,,,,,,,,,,,,,,,,,,,,,,,,,,,,0,1.0,3.0,2.0,3.0,1.0,1.0,5.0,4.0,3.0,2.0,3.0,2.0,2.0,2.0,4.0,2.0,1.0,3.0,2.0,2.0,2.0,2.0,2.0,1.0,2.0,3.0,7.0,2.0,6.0,2.0,2.0,3.0,4,,,,,,,,,,,,,,,,,,,,,,,,,,,,,,,,,7,,,,,,,,,,,,,,,,,,,,,,,,,,,,,,,,,6,,,,,,,,,,,,,,,,,,,,,,,,,,,,,,,,,2,6.0,6.0,3.0,5.0,3.0,5.0,4.0,5.0,6.0,4.0,5.0,5.0,5.0,5.0,5.0,4.0,4.0,4.0,3.0,5.0,4.0,3.0,5.0,3.0,3.0,5.0,3.0,3.0,4.0,3.0,5.0,7.0,12,,,,,,,,,,,,,,,,,,,,,,,,,,,,,,,,,No comments,595.46,128.73,,,,18.91,,35.21,,,,,,,,,,,,,,73.86,,,,,,,,,,,,,,,146.12,,,,,,,,,,,,184.36,,,,,,8.27,,APPROVED,Male,25.0,FALSE
810,2022-03-22 02:09:19,19,en,1154564748,2022-03-22 01:56:07,2022-03-22 02:09:19,Y,Y,A1,,,10,,,,,,,,,,,,,,,,,,,,,,,,,,,,,,,,,12,,,,,,,,,,,,,,,,,,,,,,,,,,,,,,,,,6,,,,,,,,,,,,,,,,,,,,,,,,,,,,,,,,,2,5.0,7.0,7.0,7.0,7.0,5.0,1.0,7.0,7.0,7.0,7.0,7.0,7.0,7.0,7.0,7.0,7.0,7.0,7.0,7.0,7.0,7.0,7.0,7.0,7.0,7.0,2.0,6.0,7.0,7.0,7.0,4.0,7,,,,,,,,,,,,,,,,,,,,,,,,,,,,,,,,,5,,,,,,,,,,,,,,,,,,,,,,,,,,,,,,,,,14,,,,,,,,,,,,,,,,,,,,,,,,,,,,,,,,,9,,,,,,,,,,,,,,,,,,,,,,,,,,,,,,,,,0,1.0,1.0,3.0,1.0,1.0,1.0,7.0,1.0,1.0,1.0,1.0,1.0,1.0,1.0,1.0,1.0,1.0,1.0,1.0,1.0,1.0,1.0,1.0,1.0,1.0,2.0,6.0,1.0,1.0,1.0,4.0,2.0,1,4.0,7.0,6.0,4.0,6.0,4.0,5.0,1.0,5.0,3.0,5.0,5.0,7.0,5.0,7.0,4.0,5.0,3.0,4.0,1.0,6.0,3.0,6.0,3.0,5.0,6.0,5.0,7.0,5.0,3.0,5.0,3.0,13,,,,,,,,,,,,,,,,,,,,,,,,,,,,,,,,,3,,,,,,,,,,,,,,,,,,,,,,,,,,,,,,,,,8,,,,,,,,,,,,,,,,,,,,,,,,,,,,,,,,,4,,,,,,,,,,,,,,,,,,,,,,,,,,,,,,,,,11,,,,,,,,,,,,,,,,,,,,,,,,,,,,,,,,,none,794.35,19.0,,,,4.17,,19.92,,,,,,,,,,,44.82,,,,,,,,,,,,,,,50.9,,,650.8,,,,,,,,,,,,,,,,,,4.74,,APPROVED,Female,24.0,FALSE
811,2022-03-22 02:02:13,19,en,1780030968,2022-03-22 01:56:08,2022-03-22 02:02:13,Y,Y,A1,,,12,,,,,,,,,,,,,,,,,,,,,,,,,,,,,,,,,4,,,,,,,,,,,,,,,,,,,,,,,,,,,,,,,,,14,,,,,,,,,,,,,,,,,,,,,,,,,,,,,,,,,7,,,,,,,,,,,,,,,,,,,,,,,,,,,,,,,,,11,,,,,,,,,,,,,,,,,,,,,,,,,,,,,,,,,0,5.0,6.0,4.0,5.0,4.0,3.0,6.0,5.0,6.0,5.0,4.0,4.0,5.0,4.0,4.0,5.0,6.0,5.0,4.0,5.0,4.0,5.0,5.0,5.0,5.0,4.0,3.0,4.0,5.0,5.0,4.0,6.0,1,3.0,5.0,3.0,4.0,3.0,4.0,6.0,6.0,4.0,3.0,3.0,2.0,3.0,3.0,3.0,5.0,3.0,3.0,3.0,3.0,3.0,2.0,4.0,3.0,3.0,3.0,2.0,3.0,5.0,3.0,4.0,7.0,5,,,,,,,,,,,,,,,,,,,,,,,,,,,,,,,,,13,,,,,,,,,,,,,,,,,,,,,,,,,,,,,,,,,8,,,,,,,,,,,,,,,,,,,,,,,,,,,,,,,,,10,,,,,,,,,,,,,,,,,,,,,,,,,,,,,,,,,9,,,,,,,,,,,,,,,,,,,,,,,,,,,,,,,,,2,6.0,4.0,6.0,6.0,6.0,6.0,2.0,5.0,7.0,4.0,5.0,5.0,6.0,4.0,5.0,6.0,6.0,5.0,5.0,4.0,6.0,6.0,6.0,5.0,6.0,6.0,2.0,6.0,7.0,4.0,6.0,6.0,3,,,,,,,,,,,,,,,,,,,,,,,,,,,,,,,,,6,,,,,,,,,,,,,,,,,,,,,,,,,,,,,,,,,,368.45,17.37,,,,5.63,,45.51,,,,,,,,,,,,,,,,,121.0,,,94.16,,,,,,,,,,,,,,,,,,79.83,,,,,,,,,4.95,,APPROVED,Male,47.0,FALSE
812,2022-03-22 02:02:08,19,en,1096523967,2022-03-22 01:56:09,2022-03-22 02:02:08,Y,Y,A1,,,4,,,,,,,,,,,,,,,,,,,,,,,,,,,,,,,,,11,,,,,,,,,,,,,,,,,,,,,,,,,,,,,,,,,6,,,,,,,,,,,,,,,,,,,,,,,,,,,,,,,,,1,5.0,4.0,5.0,4.0,5.0,5.0,7.0,4.0,4.0,6.0,6.0,5.0,5.0,5.0,5.0,5.0,5.0,5.0,5.0,5.0,4.0,6.0,5.0,6.0,5.0,5.0,4.0,6.0,5.0,5.0,6.0,4.0,3,,,,,,,,,,,,,,,,,,,,,,,,,,,,,,,,,2,2.0,2.0,2.0,2.0,3.0,2.0,7.0,3.0,4.0,2.0,2.0,3.0,2.0,2.0,4.0,4.0,2.0,3.0,1.0,2.0,2.0,2.0,2.0,2.0,2.0,2.0,3.0,2.0,2.0,2.0,3.0,6.0,0,6.0,6.0,7.0,4.0,6.0,6.0,3.0,6.0,7.0,6.0,5.0,6.0,6.0,6.0,6.0,6.0,5.0,5.0,6.0,6.0,5.0,6.0,5.0,6.0,6.0,5.0,4.0,6.0,4.0,6.0,4.0,7.0,5,,,,,,,,,,,,,,,,,,,,,,,,,,,,,,,,,7,,,,,,,,,,,,,,,,,,,,,,,,,,,,,,,,,12,,,,,,,,,,,,,,,,,,,,,,,,,,,,,,,,,10,,,,,,,,,,,,,,,,,,,,,,,,,,,,,,,,,14,,,,,,,,,,,,,,,,,,,,,,,,,,,,,,,,,13,,,,,,,,,,,,,,,,,,,,,,,,,,,,,,,,,8,,,,,,,,,,,,,,,,,,,,,,,,,,,,,,,,,9,,,,,,,,,,,,,,,,,,,,,,,,,,,,,,,,,,363.01,28.47,,,,6.9,,36.3,,,,,,,,,,,81.89,,,,,,86.25,,,116.42,,,,,,,,,,,,,,,,,,,,,,,,,,,6.78,,APPROVED,Male,31.0,FALSE
813,2022-03-22 02:04:48,19,en,1887598180,2022-03-22 01:56:09,2022-03-22 02:04:48,Y,Y,A1,,,6,,,,,,,,,,,,,,,,,,,,,,,,,,,,,,,,,5,,,,,,,,,,,,,,,,,,,,,,,,,,,,,,,,,8,,,,,,,,,,,,,,,,,,,,,,,,,,,,,,,,,11,,,,,,,,,,,,,,,,,,,,,,,,,,,,,,,,,3,,,,,,,,,,,,,,,,,,,,,,,,,,,,,,,,,14,,,,,,,,,,,,,,,,,,,,,,,,,,,,,,,,,10,,,,,,,,,,,,,,,,,,,,,,,,,,,,,,,,,13,,,,,,,,,,,,,,,,,,,,,,,,,,,,,,,,,12,,,,,,,,,,,,,,,,,,,,,,,,,,,,,,,,,2,6.0,5.0,1.0,1.0,1.0,1.0,7.0,5.0,5.0,1.0,1.0,6.0,1.0,6.0,5.0,1.0,5.0,6.0,1.0,1.0,5.0,1.0,1.0,1.0,1.0,5.0,7.0,1.0,1.0,4.0,4.0,3.0,1,5.0,5.0,4.0,6.0,4.0,6.0,1.0,7.0,6.0,4.0,2.0,6.0,5.0,3.0,2.0,5.0,4.0,5.0,6.0,4.0,2.0,5.0,5.0,5.0,6.0,1.0,3.0,6.0,3.0,3.0,5.0,4.0,7,,,,,,,,,,,,,,,,,,,,,,,,,,,,,,,,,9,,,,,,,,,,,,,,,,,,,,,,,,,,,,,,,,,4,,,,,,,,,,,,,,,,,,,,,,,,,,,,,,,,,0,1.0,4.0,2.0,1.0,1.0,1.0,7.0,2.0,4.0,2.0,3.0,3.0,1.0,5.0,2.0,1.0,3.0,1.0,2.0,1.0,2.0,1.0,1.0,3.0,2.0,5.0,3.0,2.0,3.0,3.0,4.0,1.0,,522.25,26.49,,,,115.55,,46.98,,,,,,,,,,,,,,,,,,,,,,,,,,,,,87.77,,,136.79,,,,,,,,,,,,104.31,,,4.36,,APPROVED,Female,26.0,FALSE
814,2022-03-22 02:04:09,19,en,550146013,2022-03-22 01:56:11,2022-03-22 02:04:09,Y,Y,A2,,,0,3.0,6.0,5.0,2.0,4.0,3.0,6.0,5.0,5.0,3.0,3.0,3.0,3.0,4.0,3.0,3.0,5.0,4.0,3.0,3.0,3.0,3.0,2.0,4.0,3.0,2.0,5.0,4.0,4.0,3.0,4.0,1.0,13,,,,,,,,,,,,,,,,,,,,,,,,,,,,,,,,,6,,,,,,,,,,,,,,,,,,,,,,,,,,,,,,,,,4,,,,,,,,,,,,,,,,,,,,,,,,,,,,,,,,,5,,,,,,,,,,,,,,,,,,,,,,,,,,,,,,,,,1,5.0,5.0,5.0,4.0,5.0,2.0,5.0,3.0,4.0,5.0,3.0,5.0,6.0,5.0,5.0,4.0,6.0,5.0,5.0,5.0,4.0,6.0,3.0,5.0,5.0,6.0,5.0,6.0,4.0,5.0,4.0,6.0,14,,,,,,,,,,,,,,,,,,,,,,,,,,,,,,,,,2,2.0,2.0,1.0,2.0,2.0,1.0,6.0,1.0,3.0,2.0,2.0,2.0,2.0,1.0,3.0,1.0,4.0,2.0,2.0,2.0,1.0,2.0,1.0,2.0,2.0,2.0,2.0,2.0,2.0,2.0,3.0,1.0,10,,,,,,,,,,,,,,,,,,,,,,,,,,,,,,,,,8,,,,,,,,,,,,,,,,,,,,,,,,,,,,,,,,,3,,,,,,,,,,,,,,,,,,,,,,,,,,,,,,,,,7,,,,,,,,,,,,,,,,,,,,,,,,,,,,,,,,,12,,,,,,,,,,,,,,,,,,,,,,,,,,,,,,,,,9,,,,,,,,,,,,,,,,,,,,,,,,,,,,,,,,,11,,,,,,,,,,,,,,,,,,,,,,,,,,,,,,,,,,479.34,85.73,,,,41.3,,33.03,,116.41,,,,,,,,,,,,,,,107.14,,,,,,91.28,,,,,,,,,,,,,,,,,,,,,,,,4.45,,APPROVED,Male,32.0,FALSE
815,2022-03-22 01:59:46,19,en,192376701,2022-03-22 01:56:13,2022-03-22 01:59:46,Y,Y,A2,,,4,,,,,,,,,,,,,,,,,,,,,,,,,,,,,,,,,5,,,,,,,,,,,,,,,,,,,,,,,,,,,,,,,,,3,,,,,,,,,,,,,,,,,,,,,,,,,,,,,,,,,9,,,,,,,,,,,,,,,,,,,,,,,,,,,,,,,,,12,,,,,,,,,,,,,,,,,,,,,,,,,,,,,,,,,13,,,,,,,,,,,,,,,,,,,,,,,,,,,,,,,,,14,,,,,,,,,,,,,,,,,,,,,,,,,,,,,,,,,8,,,,,,,,,,,,,,,,,,,,,,,,,,,,,,,,,6,,,,,,,,,,,,,,,,,,,,,,,,,,,,,,,,,1,2.0,4.0,2.0,2.0,2.0,2.0,3.0,2.0,3.0,3.0,2.0,2.0,2.0,2.0,2.0,2.0,2.0,2.0,2.0,2.0,2.0,2.0,3.0,2.0,2.0,3.0,2.0,2.0,2.0,3.0,3.0,3.0,2,5.0,5.0,6.0,6.0,5.0,6.0,4.0,5.0,6.0,4.0,5.0,5.0,5.0,4.0,5.0,5.0,5.0,5.0,4.0,5.0,5.0,5.0,5.0,5.0,5.0,5.0,4.0,5.0,5.0,5.0,6.0,4.0,11,,,,,,,,,,,,,,,,,,,,,,,,,,,,,,,,,10,,,,,,,,,,,,,,,,,,,,,,,,,,,,,,,,,7,,,,,,,,,,,,,,,,,,,,,,,,,,,,,,,,,0,3.0,5.0,3.0,5.0,2.0,5.0,4.0,4.0,4.0,4.0,4.0,5.0,4.0,3.0,5.0,6.0,6.0,3.0,4.0,3.0,3.0,6.0,3.0,3.0,6.0,5.0,4.0,4.0,6.0,4.0,5.0,1.0,"Nice survey, 10/10 !",217.47,15.91,,,,7.47,,52.95,,,,,,,,,,,,,,,,,,,,,,,,,,,,,39.31,,,35.69,,,,,,,,,,,,50.6,,,15.54,,APPROVED,Male,20.0,FALSE
816,2022-03-22 02:02:01,19,en,2067441969,2022-03-22 01:56:14,2022-03-22 02:02:01,Y,Y,A3,,,10,,,,,,,,,,,,,,,,,,,,,,,,,,,,,,,,,7,,,,,,,,,,,,,,,,,,,,,,,,,,,,,,,,,9,,,,,,,,,,,,,,,,,,,,,,,,,,,,,,,,,6,,,,,,,,,,,,,,,,,,,,,,,,,,,,,,,,,13,,,,,,,,,,,,,,,,,,,,,,,,,,,,,,,,,3,,,,,,,,,,,,,,,,,,,,,,,,,,,,,,,,,4,,,,,,,,,,,,,,,,,,,,,,,,,,,,,,,,,0,4.0,5.0,6.0,3.0,5.0,3.0,7.0,6.0,6.0,4.0,3.0,6.0,6.0,6.0,5.0,2.0,6.0,4.0,5.0,5.0,5.0,5.0,2.0,5.0,4.0,3.0,5.0,4.0,5.0,5.0,5.0,1.0,8,,,,,,,,,,,,,,,,,,,,,,,,,,,,,,,,,11,,,,,,,,,,,,,,,,,,,,,,,,,,,,,,,,,1,5.0,5.0,5.0,5.0,5.0,3.0,6.0,6.0,5.0,4.0,5.0,5.0,4.0,5.0,4.0,5.0,5.0,4.0,5.0,4.0,4.0,5.0,3.0,4.0,5.0,6.0,3.0,5.0,5.0,4.0,5.0,4.0,5,,,,,,,,,,,,,,,,,,,,,,,,,,,,,,,,,14,,,,,,,,,,,,,,,,,,,,,,,,,,,,,,,,,2,4.0,3.0,3.0,5.0,4.0,5.0,3.0,5.0,4.0,3.0,5.0,5.0,4.0,3.0,5.0,4.0,6.0,3.0,4.0,4.0,4.0,4.0,6.0,4.0,4.0,6.0,3.0,4.0,5.0,4.0,5.0,7.0,12,,,,,,,,,,,,,,,,,,,,,,,,,,,,,,,,,What you learn from visualization is also important in evaluating it.,349.94,21.47,,,,5.53,,29.21,,,,,,,,,,,,,,,,,,,,,,,95.46,,,,,,,,,64.58,,,,,,,,,94.43,,,,,,39.26,,APPROVED,Male,45.0,FALSE
817,2022-03-22 02:03:46,19,en,795772413,2022-03-22 01:56:16,2022-03-22 02:03:46,Y,Y,-oth-,high school degree,,1,1.0,7.0,2.0,1.0,1.0,1.0,6.0,1.0,7.0,1.0,1.0,1.0,1.0,1.0,1.0,1.0,1.0,1.0,1.0,1.0,1.0,1.0,1.0,1.0,1.0,1.0,1.0,1.0,1.0,1.0,1.0,1.0,6,,,,,,,,,,,,,,,,,,,,,,,,,,,,,,,,,10,,,,,,,,,,,,,,,,,,,,,,,,,,,,,,,,,8,,,,,,,,,,,,,,,,,,,,,,,,,,,,,,,,,12,,,,,,,,,,,,,,,,,,,,,,,,,,,,,,,,,13,,,,,,,,,,,,,,,,,,,,,,,,,,,,,,,,,7,,,,,,,,,,,,,,,,,,,,,,,,,,,,,,,,,11,,,,,,,,,,,,,,,,,,,,,,,,,,,,,,,,,5,,,,,,,,,,,,,,,,,,,,,,,,,,,,,,,,,9,,,,,,,,,,,,,,,,,,,,,,,,,,,,,,,,,3,,,,,,,,,,,,,,,,,,,,,,,,,,,,,,,,,2,2.0,5.0,2.0,4.0,5.0,3.0,3.0,2.0,6.0,5.0,2.0,4.0,5.0,4.0,4.0,1.0,5.0,2.0,5.0,5.0,2.0,5.0,4.0,5.0,5.0,1.0,3.0,5.0,3.0,1.0,2.0,1.0,0,6.0,6.0,6.0,4.0,3.0,3.0,6.0,1.0,7.0,4.0,3.0,2.0,4.0,6.0,4.0,2.0,6.0,5.0,5.0,2.0,5.0,6.0,1.0,3.0,4.0,4.0,4.0,3.0,6.0,4.0,2.0,6.0,4,,,,,,,,,,,,,,,,,,,,,,,,,,,,,,,,,14,,,,,,,,,,,,,,,,,,,,,,,,,,,,,,,,,,453.42,52.36,,,,25.74,,72.1,,86.32,,,,,,,,,,,,,,,,,,,,,,,,,,,,,,,,,106.24,,,105.09,,,,,,,,,5.57,,APPROVED,Female,24.0,FALSE
818,2022-03-22 02:02:25,19,en,1896949213,2022-03-22 01:56:22,2022-03-22 02:02:25,Y,Y,A1,,,10,,,,,,,,,,,,,,,,,,,,,,,,,,,,,,,,,4,,,,,,,,,,,,,,,,,,,,,,,,,,,,,,,,,3,,,,,,,,,,,,,,,,,,,,,,,,,,,,,,,,,11,,,,,,,,,,,,,,,,,,,,,,,,,,,,,,,,,1,2.0,2.0,1.0,1.0,2.0,1.0,7.0,4.0,1.0,1.0,1.0,1.0,1.0,1.0,1.0,1.0,3.0,1.0,2.0,2.0,2.0,2.0,2.0,2.0,2.0,4.0,4.0,2.0,1.0,2.0,1.0,7.0,9,,,,,,,,,,,,,,,,,,,,,,,,,,,,,,,,,13,,,,,,,,,,,,,,,,,,,,,,,,,,,,,,,,,8,,,,,,,,,,,,,,,,,,,,,,,,,,,,,,,,,5,,,,,,,,,,,,,,,,,,,,,,,,,,,,,,,,,0,5.0,6.0,5.0,1.0,5.0,5.0,2.0,4.0,2.0,3.0,5.0,6.0,5.0,5.0,5.0,6.0,5.0,4.0,4.0,1.0,4.0,4.0,2.0,2.0,5.0,5.0,5.0,6.0,6.0,1.0,3.0,3.0,14,,,,,,,,,,,,,,,,,,,,,,,,,,,,,,,,,12,,,,,,,,,,,,,,,,,,,,,,,,,,,,,,,,,2,5.0,5.0,5.0,3.0,5.0,5.0,4.0,5.0,5.0,5.0,4.0,6.0,4.0,3.0,5.0,6.0,6.0,5.0,4.0,2.0,6.0,5.0,4.0,4.0,5.0,5.0,4.0,5.0,5.0,2.0,5.0,6.0,7,,,,,,,,,,,,,,,,,,,,,,,,,,,,,,,,,6,,,,,,,,,,,,,,,,,,,,,,,,,,,,,,,,,,365.15,35.99,,,,7.29,,48.67,,,,,,,,,,,,,,90.04,,,,,,,,,,,,,,,99.2,,,,,,,,,79.83,,,,,,,,,4.13,,APPROVED,Male,24.0,FALSE
819,2022-03-22 02:01:33,19,en,1841202004,2022-03-22 01:56:24,2022-03-22 02:01:33,Y,Y,-oth-,,,5,,,,,,,,,,,,,,,,,,,,,,,,,,,,,,,,,10,,,,,,,,,,,,,,,,,,,,,,,,,,,,,,,,,2,6.0,6.0,7.0,7.0,6.0,7.0,2.0,7.0,6.0,6.0,6.0,7.0,7.0,5.0,6.0,6.0,6.0,5.0,6.0,6.0,4.0,6.0,6.0,6.0,6.0,6.0,5.0,6.0,5.0,6.0,6.0,3.0,9,,,,,,,,,,,,,,,,,,,,,,,,,,,,,,,,,14,,,,,,,,,,,,,,,,,,,,,,,,,,,,,,,,,7,,,,,,,,,,,,,,,,,,,,,,,,,,,,,,,,,1,6.0,7.0,5.0,6.0,5.0,6.0,3.0,7.0,6.0,5.0,5.0,3.0,4.0,4.0,6.0,6.0,5.0,5.0,5.0,2.0,3.0,5.0,5.0,5.0,5.0,5.0,5.0,5.0,3.0,5.0,5.0,7.0,0,3.0,5.0,2.0,4.0,3.0,2.0,7.0,5.0,5.0,2.0,2.0,5.0,3.0,5.0,5.0,3.0,6.0,2.0,3.0,3.0,2.0,3.0,3.0,2.0,3.0,2.0,5.0,4.0,5.0,5.0,2.0,1.0,12,,,,,,,,,,,,,,,,,,,,,,,,,,,,,,,,,6,,,,,,,,,,,,,,,,,,,,,,,,,,,,,,,,,8,,,,,,,,,,,,,,,,,,,,,,,,,,,,,,,,,11,,,,,,,,,,,,,,,,,,,,,,,,,,,,,,,,,4,,,,,,,,,,,,,,,,,,,,,,,,,,,,,,,,,13,,,,,,,,,,,,,,,,,,,,,,,,,,,,,,,,,3,,,,,,,,,,,,,,,,,,,,,,,,,,,,,,,,,None.,314.12,62.34,,,,23.58,,25.19,,,,,,,,53.86,,,,,,,,,,,,64.91,,,78.83,,,,,,,,,,,,,,,,,,,,,,,,5.41,,APPROVED,Male,35.0,FALSE
820,2022-03-22 02:04:34,19,en,1673505862,2022-03-22 01:56:31,2022-03-22 02:04:34,Y,Y,A1,,,14,,,,,,,,,,,,,,,,,,,,,,,,,,,,,,,,,1,7.0,7.0,6.0,6.0,7.0,6.0,3.0,7.0,6.0,6.0,7.0,6.0,6.0,6.0,5.0,6.0,7.0,6.0,6.0,7.0,6.0,6.0,6.0,6.0,7.0,7.0,1.0,6.0,6.0,7.0,6.0,2.0,10,,,,,,,,,,,,,,,,,,,,,,,,,,,,,,,,,12,,,,,,,,,,,,,,,,,,,,,,,,,,,,,,,,,5,,,,,,,,,,,,,,,,,,,,,,,,,,,,,,,,,8,,,,,,,,,,,,,,,,,,,,,,,,,,,,,,,,,6,,,,,,,,,,,,,,,,,,,,,,,,,,,,,,,,,3,,,,,,,,,,,,,,,,,,,,,,,,,,,,,,,,,4,,,,,,,,,,,,,,,,,,,,,,,,,,,,,,,,,0,4.0,6.0,3.0,5.0,2.0,5.0,7.0,2.0,5.0,5.0,4.0,4.0,5.0,4.0,5.0,5.0,5.0,6.0,5.0,4.0,5.0,4.0,5.0,4.0,3.0,5.0,4.0,5.0,5.0,5.0,5.0,3.0,11,,,,,,,,,,,,,,,,,,,,,,,,,,,,,,,,,13,,,,,,,,,,,,,,,,,,,,,,,,,,,,,,,,,7,,,,,,,,,,,,,,,,,,,,,,,,,,,,,,,,,9,,,,,,,,,,,,,,,,,,,,,,,,,,,,,,,,,2,6.0,7.0,6.0,6.0,6.0,6.0,5.0,6.0,7.0,6.0,5.0,6.0,7.0,6.0,7.0,6.0,6.0,7.0,6.0,6.0,7.0,7.0,7.0,7.0,5.0,6.0,2.0,6.0,7.0,7.0,6.0,1.0,NO,487.39,62.15,,,,7.64,,29.25,,,,,192.01,,,,,,,,,,,,,,,,,,,,,,,,109.13,,,,,,,,,,,,,,,74.51,,,12.7,,APPROVED,Female,51.0,FALSE
821,2022-03-22 02:06:43,19,en,1274365750,2022-03-22 01:56:32,2022-03-22 02:06:43,Y,Y,A1,,,2,4.0,7.0,5.0,5.0,4.0,5.0,5.0,6.0,7.0,4.0,4.0,6.0,4.0,4.0,3.0,5.0,4.0,4.0,4.0,2.0,3.0,5.0,6.0,3.0,4.0,4.0,2.0,3.0,5.0,4.0,6.0,1.0,14,,,,,,,,,,,,,,,,,,,,,,,,,,,,,,,,,6,,,,,,,,,,,,,,,,,,,,,,,,,,,,,,,,,13,,,,,,,,,,,,,,,,,,,,,,,,,,,,,,,,,5,,,,,,,,,,,,,,,,,,,,,,,,,,,,,,,,,12,,,,,,,,,,,,,,,,,,,,,,,,,,,,,,,,,10,,,,,,,,,,,,,,,,,,,,,,,,,,,,,,,,,0,3.0,5.0,2.0,1.0,4.0,1.0,7.0,2.0,5.0,3.0,2.0,3.0,3.0,2.0,2.0,2.0,5.0,4.0,2.0,2.0,2.0,4.0,1.0,2.0,4.0,3.0,3.0,3.0,3.0,2.0,2.0,3.0,9,,,,,,,,,,,,,,,,,,,,,,,,,,,,,,,,,4,,,,,,,,,,,,,,,,,,,,,,,,,,,,,,,,,7,,,,,,,,,,,,,,,,,,,,,,,,,,,,,,,,,3,,,,,,,,,,,,,,,,,,,,,,,,,,,,,,,,,8,,,,,,,,,,,,,,,,,,,,,,,,,,,,,,,,,11,,,,,,,,,,,,,,,,,,,,,,,,,,,,,,,,,1,3.0,7.0,6.0,4.0,4.0,3.0,3.0,7.0,7.0,5.0,3.0,4.0,4.0,3.0,4.0,5.0,6.0,5.0,4.0,3.0,4.0,4.0,4.0,4.0,4.0,5.0,3.0,4.0,3.0,4.0,7.0,1.0,,613.57,53.88,,,,9.49,,89.21,,126.03,,,,,,,,,,,,,,,,,,,,,163.7,,,,,,,,,,,,,,,,,,,,,160.38,,,10.88,,APPROVED,Female,21.0,FALSE
822,2022-03-22 02:13:44,19,en,1257294992,2022-03-22 01:56:38,2022-03-22 02:13:44,Y,Y,A1,,,11,,,,,,,,,,,,,,,,,,,,,,,,,,,,,,,,,13,,,,,,,,,,,,,,,,,,,,,,,,,,,,,,,,,6,,,,,,,,,,,,,,,,,,,,,,,,,,,,,,,,,4,,,,,,,,,,,,,,,,,,,,,,,,,,,,,,,,,9,,,,,,,,,,,,,,,,,,,,,,,,,,,,,,,,,10,,,,,,,,,,,,,,,,,,,,,,,,,,,,,,,,,14,,,,,,,,,,,,,,,,,,,,,,,,,,,,,,,,,7,,,,,,,,,,,,,,,,,,,,,,,,,,,,,,,,,8,,,,,,,,,,,,,,,,,,,,,,,,,,,,,,,,,1,3.0,4.0,2.0,3.0,2.0,1.0,6.0,1.0,4.0,2.0,2.0,3.0,2.0,3.0,4.0,1.0,3.0,2.0,2.0,2.0,2.0,2.0,2.0,2.0,2.0,5.0,4.0,2.0,5.0,2.0,4.0,3.0,5,,,,,,,,,,,,,,,,,,,,,,,,,,,,,,,,,2,6.0,6.0,6.0,3.0,6.0,4.0,4.0,6.0,6.0,6.0,7.0,6.0,6.0,6.0,7.0,5.0,7.0,6.0,6.0,6.0,6.0,6.0,3.0,6.0,6.0,7.0,6.0,6.0,7.0,6.0,5.0,5.0,3,,,,,,,,,,,,,,,,,,,,,,,,,,,,,,,,,12,,,,,,,,,,,,,,,,,,,,,,,,,,,,,,,,,0,5.0,6.0,5.0,2.0,5.0,3.0,5.0,4.0,6.0,2.0,5.0,5.0,5.0,5.0,6.0,4.0,6.0,5.0,3.0,2.0,5.0,5.0,3.0,5.0,5.0,6.0,4.0,5.0,7.0,3.0,5.0,1.0,"Very New Visualizations. But more difficult to interpret.
",1029.11,126.23,,,,10.97,,353.75,,,,,,,,,,,,,,,,,,,,,,,,,,,,,168.01,,,,,,108.3,,,,,,,,,198.52,,,63.33,,APPROVED,Male,47.0,FALSE
823,2022-03-22 02:03:48,19,en,431656131,2022-03-22 01:56:51,2022-03-22 02:03:48,Y,Y,A1,,,3,,,,,,,,,,,,,,,,,,,,,,,,,,,,,,,,,0,5.0,4.0,5.0,3.0,6.0,6.0,2.0,7.0,5.0,4.0,5.0,5.0,5.0,3.0,2.0,4.0,6.0,5.0,6.0,6.0,4.0,5.0,3.0,6.0,5.0,6.0,2.0,5.0,3.0,4.0,6.0,2.0,5,,,,,,,,,,,,,,,,,,,,,,,,,,,,,,,,,12,,,,,,,,,,,,,,,,,,,,,,,,,,,,,,,,,14,,,,,,,,,,,,,,,,,,,,,,,,,,,,,,,,,7,,,,,,,,,,,,,,,,,,,,,,,,,,,,,,,,,6,,,,,,,,,,,,,,,,,,,,,,,,,,,,,,,,,1,1.0,3.0,1.0,3.0,1.0,3.0,4.0,3.0,3.0,3.0,3.0,2.0,3.0,2.0,2.0,2.0,4.0,2.0,4.0,2.0,2.0,2.0,2.0,3.0,2.0,2.0,2.0,2.0,2.0,2.0,2.0,1.0,11,,,,,,,,,,,,,,,,,,,,,,,,,,,,,,,,,10,,,,,,,,,,,,,,,,,,,,,,,,,,,,,,,,,4,,,,,,,,,,,,,,,,,,,,,,,,,,,,,,,,,13,,,,,,,,,,,,,,,,,,,,,,,,,,,,,,,,,9,,,,,,,,,,,,,,,,,,,,,,,,,,,,,,,,,2,3.0,6.0,4.0,4.0,5.0,4.0,1.0,6.0,7.0,5.0,5.0,6.0,5.0,4.0,3.0,4.0,5.0,4.0,4.0,3.0,4.0,5.0,3.0,5.0,4.0,6.0,2.0,4.0,6.0,3.0,6.0,7.0,8,,,,,,,,,,,,,,,,,,,,,,,,,,,,,,,,,I really enjoyed this experiment. thank you!,419.25,80.18,,,,7.26,,52.12,,,,,93.36,,,,,,,,,,,,,,,,,,82.3,,,,,,,,,,,,,,,,,,67.6,,,,,,36.43,,APPROVED,Male,47.0,FALSE
824,2022-03-22 02:04:18,19,en,29018435,2022-03-22 01:56:54,2022-03-22 02:04:18,Y,Y,A2,,,10,,,,,,,,,,,,,,,,,,,,,,,,,,,,,,,,,1,7.0,5.0,7.0,7.0,7.0,7.0,1.0,7.0,5.0,7.0,7.0,7.0,7.0,6.0,6.0,7.0,7.0,7.0,7.0,7.0,5.0,7.0,7.0,7.0,7.0,6.0,2.0,7.0,5.0,6.0,7.0,2.0,11,,,,,,,,,,,,,,,,,,,,,,,,,,,,,,,,,13,,,,,,,,,,,,,,,,,,,,,,,,,,,,,,,,,8,,,,,,,,,,,,,,,,,,,,,,,,,,,,,,,,,6,,,,,,,,,,,,,,,,,,,,,,,,,,,,,,,,,12,,,,,,,,,,,,,,,,,,,,,,,,,,,,,,,,,5,,,,,,,,,,,,,,,,,,,,,,,,,,,,,,,,,14,,,,,,,,,,,,,,,,,,,,,,,,,,,,,,,,,0,3.0,5.0,2.0,3.0,1.0,1.0,7.0,1.0,5.0,2.0,2.0,3.0,2.0,3.0,5.0,3.0,3.0,2.0,2.0,1.0,1.0,2.0,2.0,2.0,2.0,1.0,7.0,3.0,1.0,2.0,2.0,3.0,7,,,,,,,,,,,,,,,,,,,,,,,,,,,,,,,,,3,,,,,,,,,,,,,,,,,,,,,,,,,,,,,,,,,9,,,,,,,,,,,,,,,,,,,,,,,,,,,,,,,,,4,,,,,,,,,,,,,,,,,,,,,,,,,,,,,,,,,2,1.0,5.0,2.0,3.0,2.0,2.0,6.0,3.0,5.0,1.0,1.0,2.0,2.0,1.0,5.0,1.0,3.0,4.0,2.0,1.0,1.0,2.0,1.0,1.0,1.0,1.0,7.0,3.0,3.0,2.0,2.0,1.0,,447.34,38.55,,,,8.67,,52.12,,,,,79.56,,,,,,,,,,,,,,,,,,,,,,,,136.0,,,,,,,,,,,,,,,124.95,,,7.49,,APPROVED,Female,26.0,FALSE
825,2022-03-22 02:04:47,19,en,25910840,2022-03-22 01:57:14,2022-03-22 02:04:47,Y,Y,A1,,,13,,,,,,,,,,,,,,,,,,,,,,,,,,,,,,,,,6,,,,,,,,,,,,,,,,,,,,,,,,,,,,,,,,,8,,,,,,,,,,,,,,,,,,,,,,,,,,,,,,,,,14,,,,,,,,,,,,,,,,,,,,,,,,,,,,,,,,,3,,,,,,,,,,,,,,,,,,,,,,,,,,,,,,,,,12,,,,,,,,,,,,,,,,,,,,,,,,,,,,,,,,,11,,,,,,,,,,,,,,,,,,,,,,,,,,,,,,,,,9,,,,,,,,,,,,,,,,,,,,,,,,,,,,,,,,,2,1.0,1.0,1.0,1.0,1.0,1.0,3.0,1.0,2.0,2.0,3.0,1.0,1.0,2.0,2.0,1.0,2.0,1.0,1.0,1.0,1.0,2.0,3.0,1.0,1.0,1.0,1.0,1.0,1.0,1.0,1.0,2.0,10,,,,,,,,,,,,,,,,,,,,,,,,,,,,,,,,,7,,,,,,,,,,,,,,,,,,,,,,,,,,,,,,,,,4,,,,,,,,,,,,,,,,,,,,,,,,,,,,,,,,,5,,,,,,,,,,,,,,,,,,,,,,,,,,,,,,,,,1,4.0,5.0,5.0,5.0,4.0,2.0,2.0,5.0,3.0,3.0,4.0,4.0,5.0,4.0,5.0,4.0,5.0,5.0,4.0,4.0,4.0,5.0,5.0,4.0,3.0,3.0,3.0,2.0,4.0,1.0,5.0,7.0,1,3.0,4.0,2.0,2.0,3.0,3.0,5.0,3.0,4.0,2.0,2.0,3.0,2.0,1.0,4.0,3.0,2.0,4.0,2.0,4.0,1.0,3.0,5.0,2.0,4.0,4.0,2.0,1.0,2.0,1.0,4.0,1.0,,457.46,39.37,,,,9.76,,49.0,,,,,,,,,,,,,,,,,,,,,,,,,,79.71,,,,,,,,,,,,,,,132.38,,,142.4,,,4.84,,APPROVED,Female,20.0,FALSE
826,2022-03-22 02:02:08,19,en,400877891,2022-03-22 01:57:18,2022-03-22 02:02:08,Y,Y,-oth-,High school degree,,6,,,,,,,,,,,,,,,,,,,,,,,,,,,,,,,,,2,7.0,7.0,7.0,7.0,7.0,7.0,7.0,7.0,7.0,7.0,7.0,7.0,7.0,7.0,7.0,7.0,7.0,7.0,7.0,7.0,7.0,7.0,7.0,7.0,7.0,7.0,7.0,7.0,7.0,6.0,7.0,2.0,13,,,,,,,,,,,,,,,,,,,,,,,,,,,,,,,,,12,,,,,,,,,,,,,,,,,,,,,,,,,,,,,,,,,1,1.0,1.0,2.0,3.0,2.0,1.0,3.0,4.0,4.0,1.0,1.0,1.0,1.0,2.0,1.0,1.0,4.0,1.0,2.0,1.0,3.0,2.0,1.0,1.0,2.0,1.0,1.0,1.0,5.0,1.0,2.0,5.0,5,,,,,,,,,,,,,,,,,,,,,,,,,,,,,,,,,7,,,,,,,,,,,,,,,,,,,,,,,,,,,,,,,,,3,,,,,,,,,,,,,,,,,,,,,,,,,,,,,,,,,11,,,,,,,,,,,,,,,,,,,,,,,,,,,,,,,,,14,,,,,,,,,,,,,,,,,,,,,,,,,,,,,,,,,0,4.0,5.0,3.0,4.0,2.0,2.0,2.0,6.0,7.0,2.0,2.0,4.0,2.0,1.0,4.0,5.0,5.0,1.0,3.0,1.0,1.0,4.0,5.0,5.0,3.0,5.0,2.0,5.0,2.0,2.0,4.0,4.0,4,,,,,,,,,,,,,,,,,,,,,,,,,,,,,,,,,9,,,,,,,,,,,,,,,,,,,,,,,,,,,,,,,,,10,,,,,,,,,,,,,,,,,,,,,,,,,,,,,,,,,8,,,,,,,,,,,,,,,,,,,,,,,,,,,,,,,,,,293.05,28.09,,,,30.16,,35.52,,,,,35.55,,,,,,,,,63.4,,,,,,,,,,,,,,,,,,95.61,,,,,,,,,,,,,,,4.72,,APPROVED,Female,21.0,FALSE
827,2022-03-22 02:01:16,19,en,41536470,2022-03-22 01:57:29,2022-03-22 02:01:16,Y,Y,-oth-,Associates Degree,,5,,,,,,,,,,,,,,,,,,,,,,,,,,,,,,,,,1,5.0,6.0,4.0,5.0,5.0,5.0,3.0,6.0,6.0,5.0,5.0,6.0,5.0,4.0,5.0,4.0,6.0,5.0,5.0,5.0,3.0,6.0,6.0,5.0,5.0,6.0,4.0,6.0,5.0,5.0,6.0,2.0,6,,,,,,,,,,,,,,,,,,,,,,,,,,,,,,,,,13,,,,,,,,,,,,,,,,,,,,,,,,,,,,,,,,,2,5.0,5.0,3.0,5.0,4.0,5.0,3.0,5.0,6.0,3.0,3.0,5.0,5.0,5.0,5.0,4.0,5.0,4.0,5.0,3.0,3.0,4.0,5.0,5.0,5.0,5.0,2.0,5.0,4.0,3.0,6.0,5.0,14,,,,,,,,,,,,,,,,,,,,,,,,,,,,,,,,,11,,,,,,,,,,,,,,,,,,,,,,,,,,,,,,,,,0,3.0,5.0,2.0,3.0,1.0,3.0,6.0,5.0,5.0,3.0,3.0,5.0,3.0,3.0,3.0,3.0,5.0,3.0,2.0,3.0,2.0,2.0,3.0,3.0,2.0,2.0,4.0,2.0,3.0,3.0,3.0,1.0,4,,,,,,,,,,,,,,,,,,,,,,,,,,,,,,,,,8,,,,,,,,,,,,,,,,,,,,,,,,,,,,,,,,,7,,,,,,,,,,,,,,,,,,,,,,,,,,,,,,,,,9,,,,,,,,,,,,,,,,,,,,,,,,,,,,,,,,,3,,,,,,,,,,,,,,,,,,,,,,,,,,,,,,,,,10,,,,,,,,,,,,,,,,,,,,,,,,,,,,,,,,,12,,,,,,,,,,,,,,,,,,,,,,,,,,,,,,,,,,228.96,8.3,,,,17.88,,32.04,,,,,51.94,,,,,,,,,57.49,,,,,,,,,58.84,,,,,,,,,,,,,,,,,,,,,,,,2.47,,APPROVED,Male,32.0,FALSE
828,2022-03-22 02:12:09,19,en,1548346012,2022-03-22 01:57:36,2022-03-22 02:12:08,Y,Y,A1,,,14,,,,,,,,,,,,,,,,,,,,,,,,,,,,,,,,,10,,,,,,,,,,,,,,,,,,,,,,,,,,,,,,,,,5,,,,,,,,,,,,,,,,,,,,,,,,,,,,,,,,,1,4.0,6.0,4.0,5.0,5.0,7.0,5.0,4.0,7.0,4.0,3.0,6.0,6.0,6.0,7.0,4.0,7.0,6.0,6.0,4.0,4.0,5.0,6.0,6.0,4.0,7.0,1.0,6.0,7.0,5.0,7.0,4.0,9,,,,,,,,,,,,,,,,,,,,,,,,,,,,,,,,,0,1.0,6.0,1.0,2.0,4.0,1.0,7.0,7.0,7.0,1.0,4.0,5.0,1.0,1.0,6.0,2.0,6.0,5.0,1.0,2.0,1.0,2.0,2.0,2.0,1.0,3.0,1.0,3.0,6.0,1.0,3.0,6.0,3,,,,,,,,,,,,,,,,,,,,,,,,,,,,,,,,,13,,,,,,,,,,,,,,,,,,,,,,,,,,,,,,,,,11,,,,,,,,,,,,,,,,,,,,,,,,,,,,,,,,,4,,,,,,,,,,,,,,,,,,,,,,,,,,,,,,,,,8,,,,,,,,,,,,,,,,,,,,,,,,,,,,,,,,,2,2.0,6.0,1.0,1.0,1.0,1.0,7.0,2.0,6.0,1.0,3.0,2.0,1.0,2.0,1.0,4.0,4.0,5.0,1.0,1.0,1.0,2.0,1.0,1.0,1.0,1.0,1.0,1.0,5.0,1.0,1.0,3.0,12,,,,,,,,,,,,,,,,,,,,,,,,,,,,,,,,,6,,,,,,,,,,,,,,,,,,,,,,,,,,,,,,,,,7,,,,,,,,,,,,,,,,,,,,,,,,,,,,,,,,,"It was very strange, but interesting. I wish I got more",875.67,41.42,,,,34.6,,156.19,,,,,,,,,,,178.57,,,,,,268.41,,,,,,,,,,,,,,,,,,141.48,,,,,,,,,,,,55.0,,APPROVED,Male,19.0,FALSE
829,2022-03-22 02:08:00,19,en,830285421,2022-03-22 01:57:39,2022-03-22 02:08:00,Y,Y,A1,,,14,,,,,,,,,,,,,,,,,,,,,,,,,,,,,,,,,9,,,,,,,,,,,,,,,,,,,,,,,,,,,,,,,,,4,,,,,,,,,,,,,,,,,,,,,,,,,,,,,,,,,10,,,,,,,,,,,,,,,,,,,,,,,,,,,,,,,,,2,4.0,3.0,5.0,3.0,4.0,5.0,7.0,5.0,4.0,4.0,3.0,3.0,4.0,4.0,5.0,5.0,6.0,4.0,5.0,5.0,5.0,4.0,1.0,5.0,4.0,4.0,2.0,5.0,3.0,3.0,5.0,5.0,8,,,,,,,,,,,,,,,,,,,,,,,,,,,,,,,,,1,6.0,5.0,6.0,5.0,5.0,6.0,6.0,3.0,6.0,6.0,4.0,7.0,5.0,4.0,7.0,4.0,7.0,4.0,6.0,5.0,4.0,6.0,6.0,7.0,4.0,7.0,1.0,7.0,4.0,4.0,6.0,7.0,0,2.0,7.0,2.0,1.0,4.0,1.0,7.0,1.0,4.0,1.0,1.0,1.0,2.0,5.0,1.0,1.0,3.0,3.0,2.0,2.0,4.0,4.0,1.0,3.0,3.0,1.0,1.0,2.0,3.0,1.0,1.0,1.0,5,,,,,,,,,,,,,,,,,,,,,,,,,,,,,,,,,7,,,,,,,,,,,,,,,,,,,,,,,,,,,,,,,,,6,,,,,,,,,,,,,,,,,,,,,,,,,,,,,,,,,3,,,,,,,,,,,,,,,,,,,,,,,,,,,,,,,,,12,,,,,,,,,,,,,,,,,,,,,,,,,,,,,,,,,13,,,,,,,,,,,,,,,,,,,,,,,,,,,,,,,,,11,,,,,,,,,,,,,,,,,,,,,,,,,,,,,,,,,,624.28,28.9,,,,11.82,,46.83,,,,,,,,,,,,,,131.1,,,,,,140.28,,,259.28,,,,,,,,,,,,,,,,,,,,,,,,6.07,,APPROVED,Female,21.0,FALSE
832,2022-03-22 02:08:57,19,en,1870241204,2022-03-22 02:00:12,2022-03-22 02:08:57,Y,Y,A2,,,9,,,,,,,,,,,,,,,,,,,,,,,,,,,,,,,,,11,,,,,,,,,,,,,,,,,,,,,,,,,,,,,,,,,12,,,,,,,,,,,,,,,,,,,,,,,,,,,,,,,,,3,,,,,,,,,,,,,,,,,,,,,,,,,,,,,,,,,13,,,,,,,,,,,,,,,,,,,,,,,,,,,,,,,,,2,7.0,7.0,6.0,5.0,7.0,6.0,6.0,7.0,6.0,4.0,6.0,6.0,6.0,6.0,6.0,6.0,7.0,6.0,7.0,6.0,6.0,6.0,6.0,7.0,7.0,6.0,6.0,5.0,7.0,6.0,7.0,6.0,6,,,,,,,,,,,,,,,,,,,,,,,,,,,,,,,,,4,,,,,,,,,,,,,,,,,,,,,,,,,,,,,,,,,14,,,,,,,,,,,,,,,,,,,,,,,,,,,,,,,,,10,,,,,,,,,,,,,,,,,,,,,,,,,,,,,,,,,8,,,,,,,,,,,,,,,,,,,,,,,,,,,,,,,,,5,,,,,,,,,,,,,,,,,,,,,,,,,,,,,,,,,0,3.0,6.0,4.0,4.0,2.0,4.0,6.0,3.0,5.0,3.0,4.0,4.0,3.0,3.0,5.0,4.0,5.0,3.0,3.0,3.0,3.0,2.0,4.0,3.0,4.0,5.0,3.0,4.0,6.0,4.0,4.0,6.0,7,,,,,,,,,,,,,,,,,,,,,,,,,,,,,,,,,1,3.0,6.0,5.0,2.0,2.0,3.0,3.0,6.0,5.0,2.0,2.0,2.0,2.0,3.0,5.0,2.0,2.0,2.0,2.0,2.0,2.0,2.0,2.0,2.0,2.0,2.0,5.0,2.0,6.0,2.0,2.0,1.0,No,527.89,31.22,,,,9.29,,66.76,,,,,,,,,,,,,,,,,106.39,,,,,,,,,,,,,,,,,,,,,173.95,,,,,,133.85,,,6.43,,APPROVED,Female,40.0,FALSE
834,2022-03-22 02:12:46,19,en,248826551,2022-03-22 02:03:14,2022-03-22 02:12:46,Y,Y,A1,,,6,,,,,,,,,,,,,,,,,,,,,,,,,,,,,,,,,2,2.0,1.0,3.0,3.0,3.0,2.0,3.0,5.0,1.0,2.0,3.0,2.0,3.0,2.0,2.0,2.0,3.0,2.0,3.0,1.0,2.0,3.0,2.0,3.0,2.0,3.0,3.0,2.0,3.0,2.0,1.0,2.0,4,,,,,,,,,,,,,,,,,,,,,,,,,,,,,,,,,0,4.0,6.0,3.0,4.0,3.0,2.0,5.0,6.0,5.0,4.0,3.0,4.0,3.0,3.0,4.0,5.0,5.0,4.0,4.0,3.0,3.0,4.0,4.0,4.0,3.0,5.0,3.0,4.0,6.0,4.0,5.0,4.0,7,,,,,,,,,,,,,,,,,,,,,,,,,,,,,,,,,3,,,,,,,,,,,,,,,,,,,,,,,,,,,,,,,,,11,,,,,,,,,,,,,,,,,,,,,,,,,,,,,,,,,5,,,,,,,,,,,,,,,,,,,,,,,,,,,,,,,,,10,,,,,,,,,,,,,,,,,,,,,,,,,,,,,,,,,13,,,,,,,,,,,,,,,,,,,,,,,,,,,,,,,,,8,,,,,,,,,,,,,,,,,,,,,,,,,,,,,,,,,1,5.0,6.0,5.0,6.0,5.0,6.0,5.0,6.0,5.0,5.0,3.0,5.0,6.0,5.0,6.0,6.0,4.0,6.0,5.0,5.0,5.0,5.0,5.0,6.0,5.0,4.0,4.0,5.0,6.0,5.0,5.0,5.0,12,,,,,,,,,,,,,,,,,,,,,,,,,,,,,,,,,9,,,,,,,,,,,,,,,,,,,,,,,,,,,,,,,,,14,,,,,,,,,,,,,,,,,,,,,,,,,,,,,,,,,"all good thank you
",575.73,22.89,,,,34.16,,30.15,,,,,55.89,,,,,,266.26,,,,,,,,,,,,,,,,,,,,,,,,99.96,,,,,,,,,,,,66.42,,APPROVED,Male,36.0,FALSE
836,2022-03-22 02:09:00,19,en,339416255,2022-03-22 02:03:21,2022-03-22 02:09:00,Y,Y,A1,,,11,,,,,,,,,,,,,,,,,,,,,,,,,,,,,,,,,3,,,,,,,,,,,,,,,,,,,,,,,,,,,,,,,,,5,,,,,,,,,,,,,,,,,,,,,,,,,,,,,,,,,2,6.0,7.0,6.0,4.0,7.0,3.0,7.0,6.0,6.0,6.0,2.0,6.0,6.0,6.0,7.0,1.0,6.0,6.0,6.0,2.0,2.0,6.0,5.0,6.0,6.0,2.0,7.0,6.0,3.0,6.0,6.0,4.0,12,,,,,,,,,,,,,,,,,,,,,,,,,,,,,,,,,9,,,,,,,,,,,,,,,,,,,,,,,,,,,,,,,,,1,6.0,7.0,6.0,6.0,3.0,3.0,5.0,6.0,6.0,5.0,2.0,4.0,6.0,4.0,5.0,4.0,6.0,5.0,6.0,5.0,3.0,5.0,2.0,6.0,6.0,2.0,6.0,6.0,4.0,4.0,3.0,7.0,6,,,,,,,,,,,,,,,,,,,,,,,,,,,,,,,,,10,,,,,,,,,,,,,,,,,,,,,,,,,,,,,,,,,0,1.0,1.0,1.0,1.0,1.0,1.0,6.0,1.0,1.0,1.0,1.0,1.0,1.0,1.0,1.0,1.0,1.0,1.0,1.0,1.0,1.0,1.0,1.0,1.0,1.0,1.0,6.0,3.0,1.0,1.0,1.0,3.0,7,,,,,,,,,,,,,,,,,,,,,,,,,,,,,,,,,4,,,,,,,,,,,,,,,,,,,,,,,,,,,,,,,,,8,,,,,,,,,,,,,,,,,,,,,,,,,,,,,,,,,13,,,,,,,,,,,,,,,,,,,,,,,,,,,,,,,,,14,,,,,,,,,,,,,,,,,,,,,,,,,,,,,,,,,,343.02,111.32,,,,13.58,,18.64,,,,,,,,,,,69.57,,,,,,,,,75.65,,,,,,,,,50.6,,,,,,,,,,,,,,,,,,3.66,,APPROVED,Male,20.0,FALSE
837,2022-03-22 02:19:13,19,en,1700913458,2022-03-22 02:03:25,2022-03-22 02:19:13,Y,Y,A2,,,8,,,,,,,,,,,,,,,,,,,,,,,,,,,,,,,,,12,,,,,,,,,,,,,,,,,,,,,,,,,,,,,,,,,14,,,,,,,,,,,,,,,,,,,,,,,,,,,,,,,,,13,,,,,,,,,,,,,,,,,,,,,,,,,,,,,,,,,2,5.0,1.0,4.0,2.0,3.0,3.0,5.0,1.0,3.0,2.0,4.0,5.0,4.0,6.0,2.0,3.0,5.0,6.0,4.0,3.0,3.0,4.0,5.0,5.0,3.0,5.0,3.0,4.0,6.0,5.0,2.0,5.0,6,,,,,,,,,,,,,,,,,,,,,,,,,,,,,,,,,4,,,,,,,,,,,,,,,,,,,,,,,,,,,,,,,,,11,,,,,,,,,,,,,,,,,,,,,,,,,,,,,,,,,7,,,,,,,,,,,,,,,,,,,,,,,,,,,,,,,,,3,,,,,,,,,,,,,,,,,,,,,,,,,,,,,,,,,0,3.0,5.0,4.0,1.0,3.0,4.0,4.0,5.0,6.0,3.0,1.0,5.0,4.0,4.0,5.0,1.0,5.0,5.0,4.0,4.0,2.0,3.0,2.0,4.0,4.0,2.0,5.0,3.0,3.0,1.0,1.0,4.0,1,6.0,6.0,5.0,4.0,6.0,5.0,3.0,7.0,7.0,5.0,5.0,5.0,6.0,5.0,6.0,6.0,7.0,6.0,6.0,6.0,5.0,6.0,3.0,6.0,6.0,4.0,6.0,4.0,5.0,5.0,6.0,5.0,10,,,,,,,,,,,,,,,,,,,,,,,,,,,,,,,,,5,,,,,,,,,,,,,,,,,,,,,,,,,,,,,,,,,9,,,,,,,,,,,,,,,,,,,,,,,,,,,,,,,,,"I believe that a larger sample could benefit you, you might consider using a few more visualizations.",951.17,113.57,,,,13.25,,74.39,,,,,,,,,,,,,,244.55,,,,,,,,,,,,,,,,,,194.48,,,120.65,,,,,,,,,,,,190.28,,APPROVED,Male,31.0,FALSE
838,2022-03-22 02:12:47,19,en,1175265761,2022-03-22 02:03:28,2022-03-22 02:12:47,Y,Y,-oth-,Highschool,,2,3.0,6.0,5.0,4.0,5.0,3.0,3.0,4.0,6.0,4.0,3.0,5.0,3.0,5.0,4.0,3.0,5.0,2.0,4.0,3.0,4.0,3.0,3.0,3.0,6.0,3.0,2.0,5.0,5.0,2.0,5.0,1.0,9,,,,,,,,,,,,,,,,,,,,,,,,,,,,,,,,,10,,,,,,,,,,,,,,,,,,,,,,,,,,,,,,,,,7,,,,,,,,,,,,,,,,,,,,,,,,,,,,,,,,,11,,,,,,,,,,,,,,,,,,,,,,,,,,,,,,,,,14,,,,,,,,,,,,,,,,,,,,,,,,,,,,,,,,,5,,,,,,,,,,,,,,,,,,,,,,,,,,,,,,,,,4,,,,,,,,,,,,,,,,,,,,,,,,,,,,,,,,,6,,,,,,,,,,,,,,,,,,,,,,,,,,,,,,,,,0,3.0,6.0,4.0,3.0,4.0,2.0,4.0,2.0,5.0,3.0,3.0,2.0,4.0,3.0,5.0,4.0,5.0,2.0,3.0,2.0,2.0,5.0,3.0,4.0,5.0,3.0,2.0,3.0,5.0,3.0,5.0,3.0,3,,,,,,,,,,,,,,,,,,,,,,,,,,,,,,,,,8,,,,,,,,,,,,,,,,,,,,,,,,,,,,,,,,,1,2.0,4.0,3.0,3.0,3.0,1.0,3.0,3.0,5.0,3.0,2.0,2.0,2.0,3.0,2.0,3.0,1.0,2.0,2.0,2.0,3.0,2.0,3.0,2.0,3.0,1.0,2.0,3.0,5.0,2.0,4.0,6.0,12,,,,,,,,,,,,,,,,,,,,,,,,,,,,,,,,,13,,,,,,,,,,,,,,,,,,,,,,,,,,,,,,,,,,561.53,128.38,,,,53.61,,48.69,,84.47,,,,,,,,,,,,,,,,,,,,,,,,,,,122.03,,,,,,,,,119.01,,,,,,,,,5.34,,APPROVED,Male,23.0,FALSE
839,2022-03-22 02:07:09,19,en,1416672671,2022-03-22 02:03:28,2022-03-22 02:07:09,Y,Y,-oth-,high school ,,13,,,,,,,,,,,,,,,,,,,,,,,,,,,,,,,,,1,6.0,2.0,6.0,6.0,6.0,6.0,1.0,7.0,3.0,6.0,6.0,6.0,6.0,5.0,6.0,7.0,6.0,5.0,6.0,6.0,6.0,6.0,6.0,5.0,6.0,7.0,1.0,6.0,6.0,6.0,6.0,2.0,9,,,,,,,,,,,,,,,,,,,,,,,,,,,,,,,,,0,2.0,6.0,3.0,5.0,3.0,2.0,7.0,6.0,2.0,1.0,2.0,3.0,2.0,2.0,3.0,4.0,2.0,2.0,3.0,2.0,3.0,2.0,5.0,2.0,3.0,1.0,6.0,4.0,1.0,5.0,3.0,4.0,14,,,,,,,,,,,,,,,,,,,,,,,,,,,,,,,,,6,,,,,,,,,,,,,,,,,,,,,,,,,,,,,,,,,8,,,,,,,,,,,,,,,,,,,,,,,,,,,,,,,,,4,,,,,,,,,,,,,,,,,,,,,,,,,,,,,,,,,2,2.0,1.0,1.0,1.0,1.0,2.0,7.0,7.0,1.0,1.0,1.0,1.0,1.0,1.0,1.0,6.0,2.0,2.0,2.0,1.0,1.0,1.0,2.0,2.0,1.0,1.0,1.0,1.0,2.0,2.0,1.0,2.0,12,,,,,,,,,,,,,,,,,,,,,,,,,,,,,,,,,10,,,,,,,,,,,,,,,,,,,,,,,,,,,,,,,,,7,,,,,,,,,,,,,,,,,,,,,,,,,,,,,,,,,5,,,,,,,,,,,,,,,,,,,,,,,,,,,,,,,,,3,,,,,,,,,,,,,,,,,,,,,,,,,,,,,,,,,11,,,,,,,,,,,,,,,,,,,,,,,,,,,,,,,,,,222.17,14.15,,,,19.63,,16.51,,,,,48.44,,,,,,72.33,,,,,,,,,,,,,,,48.43,,,,,,,,,,,,,,,,,,,,,2.68,,APPROVED,Male,23.0,FALSE
840,2022-03-22 02:08:20,19,en,758566910,2022-03-22 02:03:31,2022-03-22 02:08:20,Y,Y,A1,,,3,,,,,,,,,,,,,,,,,,,,,,,,,,,,,,,,,14,,,,,,,,,,,,,,,,,,,,,,,,,,,,,,,,,9,,,,,,,,,,,,,,,,,,,,,,,,,,,,,,,,,8,,,,,,,,,,,,,,,,,,,,,,,,,,,,,,,,,6,,,,,,,,,,,,,,,,,,,,,,,,,,,,,,,,,7,,,,,,,,,,,,,,,,,,,,,,,,,,,,,,,,,11,,,,,,,,,,,,,,,,,,,,,,,,,,,,,,,,,4,,,,,,,,,,,,,,,,,,,,,,,,,,,,,,,,,5,,,,,,,,,,,,,,,,,,,,,,,,,,,,,,,,,2,5.0,6.0,3.0,2.0,4.0,5.0,7.0,6.0,6.0,4.0,4.0,4.0,3.0,3.0,3.0,5.0,6.0,4.0,5.0,3.0,3.0,4.0,4.0,4.0,3.0,3.0,5.0,3.0,6.0,3.0,6.0,3.0,13,,,,,,,,,,,,,,,,,,,,,,,,,,,,,,,,,1,2.0,4.0,2.0,1.0,5.0,2.0,6.0,6.0,4.0,2.0,2.0,2.0,2.0,3.0,5.0,6.0,5.0,2.0,2.0,2.0,2.0,2.0,4.0,2.0,2.0,4.0,3.0,3.0,1.0,2.0,1.0,5.0,12,,,,,,,,,,,,,,,,,,,,,,,,,,,,,,,,,0,4.0,5.0,3.0,4.0,5.0,6.0,2.0,4.0,5.0,4.0,2.0,5.0,3.0,4.0,6.0,2.0,6.0,3.0,3.0,4.0,4.0,5.0,6.0,4.0,4.0,3.0,5.0,4.0,3.0,4.0,6.0,7.0,10,,,,,,,,,,,,,,,,,,,,,,,,,,,,,,,,,,292.98,18.75,,,,19.79,,24.81,,,,,,,,,,,,,,,,,,,,,,,,,,,,,61.93,,,,,,67.24,,,,,,95.99,,,,,,4.47,,APPROVED,Male,20.0,FALSE
841,2022-03-22 02:09:37,19,en,1063014902,2022-03-22 02:03:31,2022-03-22 02:09:37,Y,Y,A1,,,3,,,,,,,,,,,,,,,,,,,,,,,,,,,,,,,,,6,,,,,,,,,,,,,,,,,,,,,,,,,,,,,,,,,11,,,,,,,,,,,,,,,,,,,,,,,,,,,,,,,,,13,,,,,,,,,,,,,,,,,,,,,,,,,,,,,,,,,1,3.0,2.0,2.0,3.0,4.0,3.0,6.0,4.0,5.0,4.0,3.0,3.0,3.0,4.0,4.0,2.0,2.0,2.0,2.0,2.0,2.0,4.0,2.0,2.0,3.0,2.0,3.0,2.0,3.0,2.0,3.0,5.0,4,,,,,,,,,,,,,,,,,,,,,,,,,,,,,,,,,8,,,,,,,,,,,,,,,,,,,,,,,,,,,,,,,,,10,,,,,,,,,,,,,,,,,,,,,,,,,,,,,,,,,14,,,,,,,,,,,,,,,,,,,,,,,,,,,,,,,,,5,,,,,,,,,,,,,,,,,,,,,,,,,,,,,,,,,12,,,,,,,,,,,,,,,,,,,,,,,,,,,,,,,,,2,6.0,6.0,6.0,6.0,6.0,6.0,2.0,6.0,6.0,5.0,7.0,6.0,6.0,6.0,6.0,6.0,6.0,6.0,6.0,6.0,6.0,6.0,6.0,6.0,6.0,7.0,2.0,6.0,7.0,6.0,6.0,5.0,7,,,,,,,,,,,,,,,,,,,,,,,,,,,,,,,,,9,,,,,,,,,,,,,,,,,,,,,,,,,,,,,,,,,1,5.0,6.0,6.0,6.0,6.0,5.0,5.0,6.0,6.0,6.0,6.0,6.0,6.0,6.0,6.0,5.0,6.0,6.0,6.0,6.0,4.0,6.0,6.0,6.0,6.0,7.0,5.0,6.0,7.0,5.0,6.0,1.0,,370.36,36.56,,,,17.03,,47.62,,,,,,,,,,,,,,123.05,,,,,,,,,,,,,,,,,,,,,51.21,,,,,,,,,88.44,,,6.45,,APPROVED,Female,19.0,FALSE
842,2022-03-22 02:15:23,19,en,2092691096,2022-03-22 02:03:31,2022-03-22 02:15:23,Y,Y,A1,,,11,,,,,,,,,,,,,,,,,,,,,,,,,,,,,,,,,4,,,,,,,,,,,,,,,,,,,,,,,,,,,,,,,,,12,,,,,,,,,,,,,,,,,,,,,,,,,,,,,,,,,3,,,,,,,,,,,,,,,,,,,,,,,,,,,,,,,,,0,5.0,6.0,5.0,5.0,5.0,5.0,5.0,5.0,6.0,5.0,3.0,5.0,5.0,5.0,5.0,5.0,6.0,5.0,5.0,4.0,5.0,6.0,3.0,5.0,5.0,6.0,5.0,5.0,6.0,5.0,5.0,5.0,1,5.0,6.0,5.0,4.0,5.0,4.0,4.0,6.0,6.0,5.0,5.0,5.0,5.0,5.0,5.0,5.0,5.0,5.0,6.0,5.0,4.0,5.0,4.0,5.0,5.0,4.0,5.0,5.0,5.0,5.0,4.0,6.0,13,,,,,,,,,,,,,,,,,,,,,,,,,,,,,,,,,10,,,,,,,,,,,,,,,,,,,,,,,,,,,,,,,,,7,,,,,,,,,,,,,,,,,,,,,,,,,,,,,,,,,14,,,,,,,,,,,,,,,,,,,,,,,,,,,,,,,,,2,3.0,6.0,2.0,3.0,2.0,2.0,3.0,5.0,5.0,2.0,3.0,2.0,2.0,3.0,2.0,3.0,5.0,3.0,2.0,3.0,3.0,2.0,5.0,2.0,2.0,4.0,3.0,2.0,5.0,2.0,4.0,4.0,6,,,,,,,,,,,,,,,,,,,,,,,,,,,,,,,,,9,,,,,,,,,,,,,,,,,,,,,,,,,,,,,,,,,8,,,,,,,,,,,,,,,,,,,,,,,,,,,,,,,,,5,,,,,,,,,,,,,,,,,,,,,,,,,,,,,,,,,,715.22,16.19,,,,29.05,,404.67,,,,,,,,,,,,,,103.37,,,70.93,,,,,,,,,,,,,,,84.09,,,,,,,,,,,,,,,6.92,,APPROVED,Male,35.0,FALSE
843,2022-03-22 02:15:40,19,en,282189738,2022-03-22 02:03:32,2022-03-22 02:15:40,Y,Y,A2,,,13,,,,,,,,,,,,,,,,,,,,,,,,,,,,,,,,,8,,,,,,,,,,,,,,,,,,,,,,,,,,,,,,,,,10,,,,,,,,,,,,,,,,,,,,,,,,,,,,,,,,,7,,,,,,,,,,,,,,,,,,,,,,,,,,,,,,,,,6,,,,,,,,,,,,,,,,,,,,,,,,,,,,,,,,,2,7.0,7.0,7.0,7.0,7.0,6.0,1.0,7.0,7.0,7.0,7.0,7.0,7.0,5.0,7.0,7.0,6.0,7.0,6.0,6.0,5.0,7.0,7.0,7.0,7.0,7.0,6.0,6.0,7.0,7.0,7.0,6.0,3,,,,,,,,,,,,,,,,,,,,,,,,,,,,,,,,,5,,,,,,,,,,,,,,,,,,,,,,,,,,,,,,,,,1,2.0,2.0,2.0,5.0,2.0,1.0,7.0,5.0,2.0,2.0,2.0,2.0,1.0,1.0,2.0,2.0,3.0,2.0,2.0,2.0,1.0,2.0,1.0,2.0,2.0,6.0,2.0,1.0,5.0,3.0,2.0,2.0,12,,,,,,,,,,,,,,,,,,,,,,,,,,,,,,,,,14,,,,,,,,,,,,,,,,,,,,,,,,,,,,,,,,,9,,,,,,,,,,,,,,,,,,,,,,,,,,,,,,,,,0,6.0,7.0,6.0,6.0,7.0,2.0,5.0,3.0,7.0,5.0,7.0,6.0,6.0,4.0,7.0,5.0,6.0,6.0,6.0,6.0,4.0,6.0,5.0,6.0,7.0,7.0,6.0,6.0,7.0,4.0,7.0,6.0,11,,,,,,,,,,,,,,,,,,,,,,,,,,,,,,,,,4,,,,,,,,,,,,,,,,,,,,,,,,,,,,,,,,,The graphs were fascinating.,730.86,21.6,,,,10.92,,108.55,,,,,,,,,,,,,,,,,426.69,,,,,,,,,52.52,,,,,,,,,,,,62.69,,,,,,,,,47.89,,APPROVED,Male,43.0,FALSE
844,2022-03-22 02:11:23,19,en,1232547792,2022-03-22 02:03:34,2022-03-22 02:11:23,Y,Y,A1,,,1,3.0,7.0,4.0,3.0,6.0,4.0,6.0,4.0,5.0,4.0,5.0,3.0,5.0,4.0,5.0,4.0,4.0,3.0,5.0,4.0,3.0,4.0,3.0,3.0,4.0,3.0,3.0,5.0,3.0,4.0,5.0,1.0,13,,,,,,,,,,,,,,,,,,,,,,,,,,,,,,,,,7,,,,,,,,,,,,,,,,,,,,,,,,,,,,,,,,,8,,,,,,,,,,,,,,,,,,,,,,,,,,,,,,,,,2,5.0,6.0,5.0,5.0,4.0,4.0,5.0,5.0,6.0,6.0,3.0,6.0,4.0,5.0,5.0,4.0,5.0,6.0,5.0,6.0,4.0,4.0,5.0,5.0,5.0,6.0,6.0,5.0,5.0,5.0,4.0,5.0,9,,,,,,,,,,,,,,,,,,,,,,,,,,,,,,,,,6,,,,,,,,,,,,,,,,,,,,,,,,,,,,,,,,,14,,,,,,,,,,,,,,,,,,,,,,,,,,,,,,,,,5,,,,,,,,,,,,,,,,,,,,,,,,,,,,,,,,,12,,,,,,,,,,,,,,,,,,,,,,,,,,,,,,,,,4,,,,,,,,,,,,,,,,,,,,,,,,,,,,,,,,,11,,,,,,,,,,,,,,,,,,,,,,,,,,,,,,,,,0,5.0,7.0,4.0,5.0,5.0,4.0,5.0,4.0,7.0,6.0,6.0,5.0,5.0,6.0,6.0,6.0,7.0,4.0,5.0,6.0,6.0,7.0,4.0,5.0,6.0,6.0,7.0,6.0,5.0,4.0,5.0,7.0,3,,,,,,,,,,,,,,,,,,,,,,,,,,,,,,,,,10,,,,,,,,,,,,,,,,,,,,,,,,,,,,,,,,,,470.79,39.88,,,,10.6,,64.91,,110.87,,,,,,,,,,,,109.1,,,,,,,,,,,,,,,,,,,,,,,,130.83,,,,,,,,,4.6,,APPROVED,Female,25.0,FALSE
845,2022-03-22 02:13:51,19,en,511157405,2022-03-22 02:03:35,2022-03-22 02:13:51,Y,Y,A1,,,6,,,,,,,,,,,,,,,,,,,,,,,,,,,,,,,,,12,,,,,,,,,,,,,,,,,,,,,,,,,,,,,,,,,7,,,,,,,,,,,,,,,,,,,,,,,,,,,,,,,,,9,,,,,,,,,,,,,,,,,,,,,,,,,,,,,,,,,13,,,,,,,,,,,,,,,,,,,,,,,,,,,,,,,,,8,,,,,,,,,,,,,,,,,,,,,,,,,,,,,,,,,2,5.0,5.0,3.0,5.0,3.0,5.0,2.0,4.0,4.0,5.0,3.0,5.0,5.0,5.0,6.0,4.0,6.0,3.0,4.0,2.0,3.0,5.0,6.0,4.0,4.0,5.0,3.0,4.0,4.0,3.0,5.0,7.0,5,,,,,,,,,,,,,,,,,,,,,,,,,,,,,,,,,3,,,,,,,,,,,,,,,,,,,,,,,,,,,,,,,,,10,,,,,,,,,,,,,,,,,,,,,,,,,,,,,,,,,11,,,,,,,,,,,,,,,,,,,,,,,,,,,,,,,,,4,,,,,,,,,,,,,,,,,,,,,,,,,,,,,,,,,14,,,,,,,,,,,,,,,,,,,,,,,,,,,,,,,,,1,3.0,5.0,4.0,4.0,3.0,6.0,1.0,5.0,5.0,3.0,3.0,4.0,4.0,3.0,5.0,3.0,6.0,2.0,5.0,2.0,4.0,4.0,5.0,4.0,3.0,6.0,3.0,5.0,3.0,3.0,6.0,7.0,0,5.0,3.0,3.0,4.0,3.0,2.0,4.0,5.0,4.0,4.0,4.0,3.0,5.0,2.0,5.0,4.0,6.0,1.0,5.0,3.0,3.0,5.0,5.0,5.0,3.0,5.0,3.0,4.0,3.0,2.0,6.0,1.0,,620.04,120.88,,,,7.86,,36.05,,,,,,,,,,,,,,,,,,,,110.06,,,,,,,,,,,,,,,,,,,,,144.91,,,196.37,,,3.91,,APPROVED,Female,20.0,FALSE
846,2022-03-22 02:14:08,19,en,46491304,2022-03-22 02:03:35,2022-03-22 02:14:08,Y,Y,A2,,,12,,,,,,,,,,,,,,,,,,,,,,,,,,,,,,,,,8,,,,,,,,,,,,,,,,,,,,,,,,,,,,,,,,,1,5.0,5.0,4.0,4.0,6.0,5.0,3.0,5.0,5.0,5.0,6.0,5.0,4.0,5.0,4.0,6.0,5.0,5.0,6.0,6.0,5.0,5.0,5.0,6.0,6.0,5.0,3.0,5.0,4.0,6.0,4.0,3.0,0,3.0,3.0,3.0,4.0,5.0,3.0,5.0,5.0,5.0,4.0,4.0,4.0,4.0,4.0,4.0,3.0,4.0,4.0,5.0,4.0,4.0,4.0,4.0,3.0,2.0,4.0,5.0,4.0,4.0,4.0,3.0,4.0,11,,,,,,,,,,,,,,,,,,,,,,,,,,,,,,,,,2,2.0,1.0,3.0,1.0,1.0,1.0,7.0,1.0,1.0,1.0,1.0,1.0,1.0,1.0,1.0,1.0,1.0,1.0,2.0,2.0,3.0,1.0,1.0,1.0,1.0,1.0,7.0,2.0,1.0,1.0,1.0,6.0,5,,,,,,,,,,,,,,,,,,,,,,,,,,,,,,,,,3,,,,,,,,,,,,,,,,,,,,,,,,,,,,,,,,,4,,,,,,,,,,,,,,,,,,,,,,,,,,,,,,,,,14,,,,,,,,,,,,,,,,,,,,,,,,,,,,,,,,,13,,,,,,,,,,,,,,,,,,,,,,,,,,,,,,,,,6,,,,,,,,,,,,,,,,,,,,,,,,,,,,,,,,,10,,,,,,,,,,,,,,,,,,,,,,,,,,,,,,,,,7,,,,,,,,,,,,,,,,,,,,,,,,,,,,,,,,,9,,,,,,,,,,,,,,,,,,,,,,,,,,,,,,,,,interesting survey,636.31,18.6,,,,14.27,,83.93,,,,,,,,137.15,,,91.19,,,,,,277.77,,,,,,,,,,,,,,,,,,,,,,,,,,,,,,13.4,,APPROVED,Female,30.0,FALSE
847,2022-03-22 02:10:46,19,en,1065380417,2022-03-22 02:03:36,2022-03-22 02:10:46,Y,Y,A1,,,3,,,,,,,,,,,,,,,,,,,,,,,,,,,,,,,,,6,,,,,,,,,,,,,,,,,,,,,,,,,,,,,,,,,2,3.0,5.0,5.0,5.0,5.0,7.0,6.0,5.0,4.0,3.0,4.0,2.0,4.0,3.0,5.0,4.0,6.0,4.0,5.0,3.0,4.0,5.0,5.0,6.0,5.0,6.0,3.0,6.0,4.0,5.0,2.0,3.0,0,7.0,7.0,7.0,6.0,7.0,6.0,3.0,6.0,7.0,7.0,6.0,7.0,7.0,7.0,7.0,6.0,7.0,7.0,7.0,7.0,7.0,7.0,7.0,7.0,7.0,7.0,7.0,7.0,7.0,7.0,7.0,4.0,7,,,,,,,,,,,,,,,,,,,,,,,,,,,,,,,,,10,,,,,,,,,,,,,,,,,,,,,,,,,,,,,,,,,1,2.0,5.0,3.0,3.0,5.0,4.0,6.0,1.0,6.0,2.0,2.0,3.0,4.0,5.0,5.0,2.0,6.0,1.0,3.0,1.0,2.0,4.0,3.0,4.0,5.0,5.0,6.0,2.0,3.0,1.0,4.0,7.0,8,,,,,,,,,,,,,,,,,,,,,,,,,,,,,,,,,5,,,,,,,,,,,,,,,,,,,,,,,,,,,,,,,,,14,,,,,,,,,,,,,,,,,,,,,,,,,,,,,,,,,9,,,,,,,,,,,,,,,,,,,,,,,,,,,,,,,,,13,,,,,,,,,,,,,,,,,,,,,,,,,,,,,,,,,12,,,,,,,,,,,,,,,,,,,,,,,,,,,,,,,,,4,,,,,,,,,,,,,,,,,,,,,,,,,,,,,,,,,11,,,,,,,,,,,,,,,,,,,,,,,,,,,,,,,,,,432.49,55.65,,,,11.96,,35.02,,,,,,,,108.63,,,87.38,,,,,,,,,128.65,,,,,,,,,,,,,,,,,,,,,,,,,,,5.2,,APPROVED,Female,26.0,FALSE
848,2022-03-22 02:10:53,19,en,309017140,2022-03-22 02:03:37,2022-03-22 02:10:53,Y,Y,A2,,,14,,,,,,,,,,,,,,,,,,,,,,,,,,,,,,,,,5,,,,,,,,,,,,,,,,,,,,,,,,,,,,,,,,,1,6.0,6.0,7.0,7.0,6.0,5.0,4.0,7.0,6.0,5.0,6.0,6.0,6.0,7.0,6.0,7.0,7.0,5.0,6.0,6.0,5.0,5.0,5.0,7.0,7.0,6.0,6.0,7.0,5.0,6.0,6.0,3.0,10,,,,,,,,,,,,,,,,,,,,,,,,,,,,,,,,,4,,,,,,,,,,,,,,,,,,,,,,,,,,,,,,,,,0,6.0,7.0,5.0,3.0,6.0,3.0,7.0,6.0,7.0,5.0,5.0,6.0,6.0,7.0,6.0,5.0,6.0,6.0,6.0,6.0,5.0,5.0,3.0,5.0,7.0,5.0,5.0,5.0,3.0,3.0,4.0,6.0,2,2.0,5.0,1.0,6.0,1.0,1.0,4.0,7.0,6.0,2.0,1.0,2.0,2.0,1.0,5.0,6.0,6.0,1.0,1.0,1.0,2.0,2.0,2.0,2.0,1.0,2.0,6.0,2.0,2.0,1.0,1.0,7.0,3,,,,,,,,,,,,,,,,,,,,,,,,,,,,,,,,,11,,,,,,,,,,,,,,,,,,,,,,,,,,,,,,,,,7,,,,,,,,,,,,,,,,,,,,,,,,,,,,,,,,,12,,,,,,,,,,,,,,,,,,,,,,,,,,,,,,,,,13,,,,,,,,,,,,,,,,,,,,,,,,,,,,,,,,,8,,,,,,,,,,,,,,,,,,,,,,,,,,,,,,,,,9,,,,,,,,,,,,,,,,,,,,,,,,,,,,,,,,,6,,,,,,,,,,,,,,,,,,,,,,,,,,,,,,,,,,441.24,43.31,,,,10.24,,32.56,,,,,,,,116.76,,,,,,,,,91.63,,,138.8,,,,,,,,,,,,,,,,,,,,,,,,,,,7.94,,APPROVED,Female,45.0,FALSE
849,2022-03-22 02:08:54,19,en,1177006578,2022-03-22 02:03:38,2022-03-22 02:08:54,Y,Y,A3,,,10,,,,,,,,,,,,,,,,,,,,,,,,,,,,,,,,,4,,,,,,,,,,,,,,,,,,,,,,,,,,,,,,,,,0,6.0,7.0,7.0,4.0,7.0,6.0,5.0,5.0,7.0,6.0,7.0,6.0,7.0,6.0,5.0,5.0,6.0,6.0,6.0,5.0,5.0,6.0,5.0,6.0,7.0,6.0,5.0,5.0,4.0,6.0,4.0,3.0,2,2.0,4.0,5.0,5.0,2.0,5.0,2.0,6.0,4.0,4.0,5.0,5.0,5.0,2.0,6.0,4.0,7.0,3.0,5.0,2.0,3.0,6.0,4.0,3.0,2.0,7.0,6.0,6.0,6.0,5.0,4.0,4.0,6,,,,,,,,,,,,,,,,,,,,,,,,,,,,,,,,,12,,,,,,,,,,,,,,,,,,,,,,,,,,,,,,,,,13,,,,,,,,,,,,,,,,,,,,,,,,,,,,,,,,,7,,,,,,,,,,,,,,,,,,,,,,,,,,,,,,,,,5,,,,,,,,,,,,,,,,,,,,,,,,,,,,,,,,,9,,,,,,,,,,,,,,,,,,,,,,,,,,,,,,,,,11,,,,,,,,,,,,,,,,,,,,,,,,,,,,,,,,,3,,,,,,,,,,,,,,,,,,,,,,,,,,,,,,,,,14,,,,,,,,,,,,,,,,,,,,,,,,,,,,,,,,,1,7.0,5.0,7.0,4.0,5.0,7.0,7.0,7.0,5.0,6.0,6.0,7.0,6.0,6.0,6.0,5.0,7.0,6.0,7.0,6.0,7.0,7.0,6.0,6.0,5.0,6.0,7.0,7.0,6.0,7.0,7.0,7.0,8,,,,,,,,,,,,,,,,,,,,,,,,,,,,,,,,,,311.37,20.28,,,,15.52,,17.56,,,,,,,,109.69,,,73.76,,,,,,,,,,,,,,,,,,,,,,,,,,,,,,71.3,,,,,,3.26,,APPROVED,Female,25.0,FALSE
850,2022-03-22 02:12:10,19,en,2034456364,2022-03-22 02:03:38,2022-03-22 02:12:10,Y,Y,A1,,,11,,,,,,,,,,,,,,,,,,,,,,,,,,,,,,,,,13,,,,,,,,,,,,,,,,,,,,,,,,,,,,,,,,,4,,,,,,,,,,,,,,,,,,,,,,,,,,,,,,,,,0,1.0,7.0,4.0,1.0,1.0,4.0,7.0,7.0,7.0,1.0,1.0,5.0,1.0,5.0,6.0,4.0,6.0,1.0,3.0,1.0,1.0,1.0,1.0,2.0,4.0,7.0,1.0,1.0,7.0,4.0,4.0,4.0,2,1.0,3.0,1.0,1.0,1.0,1.0,7.0,3.0,7.0,1.0,1.0,1.0,1.0,1.0,2.0,3.0,3.0,1.0,4.0,1.0,1.0,2.0,1.0,1.0,1.0,4.0,2.0,1.0,4.0,1.0,1.0,5.0,2,7.0,7.0,7.0,4.0,6.0,5.0,6.0,7.0,7.0,6.0,4.0,6.0,6.0,7.0,7.0,6.0,7.0,4.0,6.0,6.0,4.0,7.0,7.0,6.0,6.0,5.0,5.0,7.0,6.0,6.0,4.0,6.0,14,,,,,,,,,,,,,,,,,,,,,,,,,,,,,,,,,8,,,,,,,,,,,,,,,,,,,,,,,,,,,,,,,,,7,,,,,,,,,,,,,,,,,,,,,,,,,,,,,,,,,3,,,,,,,,,,,,,,,,,,,,,,,,,,,,,,,,,12,,,,,,,,,,,,,,,,,,,,,,,,,,,,,,,,,6,,,,,,,,,,,,,,,,,,,,,,,,,,,,,,,,,10,,,,,,,,,,,,,,,,,,,,,,,,,,,,,,,,,5,,,,,,,,,,,,,,,,,,,,,,,,,,,,,,,,,9,,,,,,,,,,,,,,,,,,,,,,,,,,,,,,,,,,516.46,113.25,,,,11.22,,91.67,,,,,,,,,,,97.15,,,85.29,,,113.32,,,,,,,,,,,,,,,,,,,,,,,,,,,,,,4.56,,APPROVED,Female,24.0,FALSE
851,2022-03-22 02:13:41,19,en,1925284488,2022-03-22 02:03:39,2022-03-22 02:13:41,Y,Y,A1,,,10,,,,,,,,,,,,,,,,,,,,,,,,,,,,,,,,,13,,,,,,,,,,,,,,,,,,,,,,,,,,,,,,,,,4,,,,,,,,,,,,,,,,,,,,,,,,,,,,,,,,,0,6.0,2.0,4.0,4.0,3.0,4.0,4.0,2.0,2.0,3.0,1.0,5.0,5.0,6.0,5.0,4.0,5.0,4.0,3.0,2.0,4.0,2.0,5.0,3.0,3.0,5.0,3.0,3.0,2.0,3.0,5.0,4.0,2,1.0,1.0,1.0,1.0,1.0,1.0,4.0,4.0,1.0,1.0,1.0,4.0,1.0,1.0,2.0,2.0,4.0,2.0,2.0,1.0,1.0,1.0,1.0,1.0,1.0,3.0,4.0,1.0,1.0,1.0,1.0,5.0,1,2.0,1.0,1.0,1.0,1.0,4.0,2.0,1.0,1.0,1.0,1.0,4.0,1.0,1.0,2.0,4.0,4.0,1.0,2.0,1.0,1.0,2.0,4.0,2.0,1.0,4.0,4.0,2.0,1.0,1.0,1.0,6.0,7,,,,,,,,,,,,,,,,,,,,,,,,,,,,,,,,,3,,,,,,,,,,,,,,,,,,,,,,,,,,,,,,,,,5,,,,,,,,,,,,,,,,,,,,,,,,,,,,,,,,,8,,,,,,,,,,,,,,,,,,,,,,,,,,,,,,,,,14,,,,,,,,,,,,,,,,,,,,,,,,,,,,,,,,,6,,,,,,,,,,,,,,,,,,,,,,,,,,,,,,,,,11,,,,,,,,,,,,,,,,,,,,,,,,,,,,,,,,,12,,,,,,,,,,,,,,,,,,,,,,,,,,,,,,,,,9,,,,,,,,,,,,,,,,,,,,,,,,,,,,,,,,,,604.12,277.42,,,,7.22,,64.45,,,,,,,,,,,118.1,,,57.08,,,75.12,,,,,,,,,,,,,,,,,,,,,,,,,,,,,,4.73,,APPROVED,Female,25.0,FALSE
852,2022-03-22 02:14:27,19,en,194535964,2022-03-22 02:03:40,2022-03-22 02:14:26,Y,Y,-oth-,No academic degree,,5,,,,,,,,,,,,,,,,,,,,,,,,,,,,,,,,,10,,,,,,,,,,,,,,,,,,,,,,,,,,,,,,,,,8,,,,,,,,,,,,,,,,,,,,,,,,,,,,,,,,,13,,,,,,,,,,,,,,,,,,,,,,,,,,,,,,,,,2,2.0,2.0,3.0,2.0,3.0,1.0,7.0,5.0,3.0,2.0,3.0,4.0,2.0,3.0,4.0,3.0,4.0,1.0,2.0,2.0,1.0,2.0,2.0,1.0,2.0,3.0,4.0,2.0,5.0,3.0,1.0,5.0,3,,,,,,,,,,,,,,,,,,,,,,,,,,,,,,,,,6,,,,,,,,,,,,,,,,,,,,,,,,,,,,,,,,,7,,,,,,,,,,,,,,,,,,,,,,,,,,,,,,,,,0,2.0,2.0,1.0,4.0,1.0,3.0,7.0,2.0,5.0,1.0,3.0,4.0,3.0,1.0,2.0,2.0,3.0,2.0,3.0,1.0,2.0,3.0,5.0,2.0,1.0,4.0,4.0,3.0,5.0,5.0,4.0,2.0,1,4.0,6.0,5.0,4.0,5.0,3.0,7.0,4.0,6.0,4.0,5.0,5.0,4.0,5.0,5.0,5.0,5.0,3.0,3.0,3.0,2.0,3.0,3.0,4.0,4.0,5.0,5.0,4.0,6.0,4.0,2.0,3.0,12,,,,,,,,,,,,,,,,,,,,,,,,,,,,,,,,,11,,,,,,,,,,,,,,,,,,,,,,,,,,,,,,,,,9,,,,,,,,,,,,,,,,,,,,,,,,,,,,,,,,,14,,,,,,,,,,,,,,,,,,,,,,,,,,,,,,,,,4,,,,,,,,,,,,,,,,,,,,,,,,,,,,,,,,,,649.99,48.6,,,,34.76,,59.87,,,,,,,,,,,,,,151.16,,,,,,,,,,,,171.34,,,180.26,,,,,,,,,,,,,,,,,,4.0,,APPROVED,Male,27.0,FALSE
854,2022-03-22 02:12:11,19,en,77744503,2022-03-22 02:03:41,2022-03-22 02:12:11,Y,Y,-oth-,High School,,10,,,,,,,,,,,,,,,,,,,,,,,,,,,,,,,,,1,4.0,6.0,3.0,4.0,6.0,4.0,7.0,6.0,4.0,5.0,5.0,4.0,5.0,2.0,5.0,4.0,6.0,3.0,3.0,5.0,3.0,5.0,2.0,6.0,5.0,2.0,5.0,6.0,5.0,4.0,3.0,2.0,3,,,,,,,,,,,,,,,,,,,,,,,,,,,,,,,,,14,,,,,,,,,,,,,,,,,,,,,,,,,,,,,,,,,2,3.0,4.0,4.0,3.0,3.0,1.0,7.0,6.0,3.0,2.0,3.0,4.0,2.0,5.0,4.0,4.0,5.0,3.0,3.0,4.0,3.0,4.0,1.0,2.0,3.0,1.0,4.0,2.0,3.0,4.0,2.0,5.0,5,,,,,,,,,,,,,,,,,,,,,,,,,,,,,,,,,11,,,,,,,,,,,,,,,,,,,,,,,,,,,,,,,,,9,,,,,,,,,,,,,,,,,,,,,,,,,,,,,,,,,6,,,,,,,,,,,,,,,,,,,,,,,,,,,,,,,,,8,,,,,,,,,,,,,,,,,,,,,,,,,,,,,,,,,4,,,,,,,,,,,,,,,,,,,,,,,,,,,,,,,,,7,,,,,,,,,,,,,,,,,,,,,,,,,,,,,,,,,12,,,,,,,,,,,,,,,,,,,,,,,,,,,,,,,,,0,3.0,5.0,3.0,5.0,3.0,6.0,3.0,4.0,5.0,3.0,3.0,4.0,2.0,4.0,5.0,4.0,6.0,4.0,3.0,2.0,4.0,3.0,6.0,1.0,3.0,6.0,4.0,4.0,3.0,4.0,6.0,7.0,13,,,,,,,,,,,,,,,,,,,,,,,,,,,,,,,,,,514.26,88.46,,,,50.09,,56.94,,,,,119.49,,,,,,,,,90.48,,,,,,,,,,,,,,,,,,,,,,,,,,,104.64,,,,,,4.16,,APPROVED,Male,22.0,FALSE
855,2022-03-22 02:08:13,19,en,160403706,2022-03-22 02:03:43,2022-03-22 02:08:13,Y,Y,A2,,,9,,,,,,,,,,,,,,,,,,,,,,,,,,,,,,,,,11,,,,,,,,,,,,,,,,,,,,,,,,,,,,,,,,,5,,,,,,,,,,,,,,,,,,,,,,,,,,,,,,,,,0,7.0,6.0,6.0,5.0,5.0,5.0,4.0,6.0,6.0,5.0,6.0,4.0,6.0,5.0,5.0,6.0,7.0,6.0,6.0,4.0,4.0,6.0,3.0,6.0,5.0,7.0,4.0,5.0,7.0,1.0,6.0,4.0,2,5.0,4.0,4.0,5.0,3.0,5.0,4.0,5.0,4.0,4.0,4.0,4.0,4.0,3.0,4.0,4.0,5.0,4.0,5.0,4.0,4.0,4.0,5.0,4.0,4.0,6.0,4.0,4.0,6.0,4.0,5.0,5.0,10,,,,,,,,,,,,,,,,,,,,,,,,,,,,,,,,,6,,,,,,,,,,,,,,,,,,,,,,,,,,,,,,,,,8,,,,,,,,,,,,,,,,,,,,,,,,,,,,,,,,,4,,,,,,,,,,,,,,,,,,,,,,,,,,,,,,,,,1,4.0,5.0,4.0,5.0,4.0,4.0,4.0,1.0,6.0,4.0,3.0,5.0,4.0,4.0,5.0,3.0,5.0,4.0,4.0,4.0,4.0,5.0,2.0,4.0,3.0,5.0,3.0,4.0,5.0,4.0,4.0,3.0,13,,,,,,,,,,,,,,,,,,,,,,,,,,,,,,,,,3,,,,,,,,,,,,,,,,,,,,,,,,,,,,,,,,,12,,,,,,,,,,,,,,,,,,,,,,,,,,,,,,,,,14,,,,,,,,,,,,,,,,,,,,,,,,,,,,,,,,,7,,,,,,,,,,,,,,,,,,,,,,,,,,,,,,,,,,269.64,21.43,,,,15.27,,10.2,,,,,,,,,,,75.09,,,61.52,,,,,,,,,,,,,,,83.11,,,,,,,,,,,,,,,,,,3.02,,APPROVED,Male,19.0,FALSE
856,2022-03-22 02:09:44,19,en,2067888262,2022-03-22 02:03:45,2022-03-22 02:09:44,Y,Y,A1,,,8,,,,,,,,,,,,,,,,,,,,,,,,,,,,,,,,,5,,,,,,,,,,,,,,,,,,,,,,,,,,,,,,,,,12,,,,,,,,,,,,,,,,,,,,,,,,,,,,,,,,,10,,,,,,,,,,,,,,,,,,,,,,,,,,,,,,,,,4,,,,,,,,,,,,,,,,,,,,,,,,,,,,,,,,,9,,,,,,,,,,,,,,,,,,,,,,,,,,,,,,,,,13,,,,,,,,,,,,,,,,,,,,,,,,,,,,,,,,,0,6.0,7.0,7.0,2.0,5.0,7.0,6.0,6.0,7.0,4.0,1.0,6.0,7.0,2.0,6.0,2.0,6.0,7.0,7.0,5.0,2.0,7.0,6.0,6.0,7.0,4.0,6.0,5.0,1.0,4.0,7.0,1.0,11,,,,,,,,,,,,,,,,,,,,,,,,,,,,,,,,,1,1.0,1.0,1.0,1.0,1.0,1.0,7.0,1.0,1.0,1.0,1.0,1.0,1.0,1.0,5.0,1.0,1.0,1.0,1.0,1.0,1.0,1.0,2.0,1.0,1.0,4.0,1.0,1.0,1.0,1.0,1.0,3.0,6,,,,,,,,,,,,,,,,,,,,,,,,,,,,,,,,,14,,,,,,,,,,,,,,,,,,,,,,,,,,,,,,,,,3,,,,,,,,,,,,,,,,,,,,,,,,,,,,,,,,,2,1.0,2.0,2.0,5.0,4.0,6.0,1.0,7.0,2.0,2.0,1.0,2.0,1.0,2.0,3.0,2.0,6.0,1.0,1.0,1.0,1.0,5.0,7.0,1.0,4.0,7.0,3.0,2.0,2.0,2.0,6.0,7.0,7,,,,,,,,,,,,,,,,,,,,,,,,,,,,,,,,,,361.99,22.76,,,,34.45,,38.53,,,,,,,,,,,,,,,,,,,,,,,70.59,,,,,,50.75,,,,,,,,,,,,140.09,,,,,,4.82,,APPROVED,Female,24.0,FALSE
857,2022-03-22 02:09:25,19,en,481908159,2022-03-22 02:03:46,2022-03-22 02:09:25,Y,Y,A1,,,5,,,,,,,,,,,,,,,,,,,,,,,,,,,,,,,,,14,,,,,,,,,,,,,,,,,,,,,,,,,,,,,,,,,11,,,,,,,,,,,,,,,,,,,,,,,,,,,,,,,,,13,,,,,,,,,,,,,,,,,,,,,,,,,,,,,,,,,9,,,,,,,,,,,,,,,,,,,,,,,,,,,,,,,,,7,,,,,,,,,,,,,,,,,,,,,,,,,,,,,,,,,2,1.0,1.0,1.0,5.0,2.0,1.0,2.0,6.0,2.0,1.0,1.0,5.0,1.0,5.0,5.0,5.0,5.0,3.0,1.0,2.0,1.0,1.0,4.0,1.0,1.0,1.0,6.0,1.0,2.0,2.0,2.0,7.0,12,,,,,,,,,,,,,,,,,,,,,,,,,,,,,,,,,4,,,,,,,,,,,,,,,,,,,,,,,,,,,,,,,,,3,,,,,,,,,,,,,,,,,,,,,,,,,,,,,,,,,6,,,,,,,,,,,,,,,,,,,,,,,,,,,,,,,,,8,,,,,,,,,,,,,,,,,,,,,,,,,,,,,,,,,1,7.0,7.0,7.0,6.0,6.0,3.0,3.0,7.0,6.0,6.0,6.0,6.0,6.0,6.0,6.0,7.0,6.0,6.0,7.0,5.0,7.0,7.0,6.0,6.0,7.0,7.0,7.0,6.0,5.0,7.0,7.0,6.0,10,,,,,,,,,,,,,,,,,,,,,,,,,,,,,,,,,0,3.0,6.0,6.0,3.0,3.0,2.0,6.0,6.0,5.0,3.0,6.0,5.0,3.0,6.0,5.0,1.0,6.0,3.0,3.0,2.0,3.0,3.0,2.0,3.0,5.0,5.0,6.0,2.0,7.0,5.0,3.0,1.0,,341.54,38.58,,,,6.78,,40.8,,,,,,,,,,,,,,,,,,,,84.27,,,,,,,,,,,,,,,,,,70.03,,,,,,96.42,,,4.66,,APPROVED,Female,38.0,FALSE
858,2022-03-22 02:07:02,19,en,431335443,2022-03-22 02:03:46,2022-03-22 02:07:02,Y,Y,A1,,,1,3.0,7.0,3.0,3.0,3.0,2.0,3.0,3.0,3.0,4.0,3.0,4.0,3.0,4.0,3.0,4.0,6.0,3.0,3.0,3.0,2.0,4.0,3.0,4.0,4.0,4.0,4.0,4.0,3.0,3.0,4.0,1.0,6,,,,,,,,,,,,,,,,,,,,,,,,,,,,,,,,,4,,,,,,,,,,,,,,,,,,,,,,,,,,,,,,,,,14,,,,,,,,,,,,,,,,,,,,,,,,,,,,,,,,,12,,,,,,,,,,,,,,,,,,,,,,,,,,,,,,,,,9,,,,,,,,,,,,,,,,,,,,,,,,,,,,,,,,,3,,,,,,,,,,,,,,,,,,,,,,,,,,,,,,,,,13,,,,,,,,,,,,,,,,,,,,,,,,,,,,,,,,,10,,,,,,,,,,,,,,,,,,,,,,,,,,,,,,,,,8,,,,,,,,,,,,,,,,,,,,,,,,,,,,,,,,,11,,,,,,,,,,,,,,,,,,,,,,,,,,,,,,,,,2,6.0,7.0,6.0,6.0,6.0,7.0,3.0,7.0,6.0,5.0,7.0,5.0,4.0,5.0,6.0,5.0,6.0,6.0,6.0,5.0,2.0,5.0,6.0,6.0,5.0,5.0,6.0,7.0,6.0,6.0,6.0,5.0,5,,,,,,,,,,,,,,,,,,,,,,,,,,,,,,,,,0,4.0,5.0,4.0,4.0,4.0,6.0,4.0,6.0,6.0,3.0,4.0,6.0,3.0,4.0,6.0,5.0,5.0,3.0,3.0,4.0,4.0,4.0,6.0,4.0,4.0,6.0,6.0,4.0,5.0,4.0,6.0,7.0,7,,,,,,,,,,,,,,,,,,,,,,,,,,,,,,,,,,197.78,14.88,,,,15.04,,25.21,,37.78,,,,,,,,,,,,,,,,,,,,,,,,,,,,,,,,,53.43,,,,,,48.88,,,,,,2.56,,APPROVED,Male,25.0,FALSE
859,2022-03-22 02:14:52,19,en,1187707440,2022-03-22 02:03:47,2022-03-22 02:14:52,Y,Y,-oth-,Vocational,,8,,,,,,,,,,,,,,,,,,,,,,,,,,,,,,,,,7,,,,,,,,,,,,,,,,,,,,,,,,,,,,,,,,,11,,,,,,,,,,,,,,,,,,,,,,,,,,,,,,,,,13,,,,,,,,,,,,,,,,,,,,,,,,,,,,,,,,,5,,,,,,,,,,,,,,,,,,,,,,,,,,,,,,,,,4,,,,,,,,,,,,,,,,,,,,,,,,,,,,,,,,,3,,,,,,,,,,,,,,,,,,,,,,,,,,,,,,,,,10,,,,,,,,,,,,,,,,,,,,,,,,,,,,,,,,,0,2.0,2.0,2.0,2.0,1.0,2.0,7.0,4.0,4.0,2.0,1.0,4.0,2.0,4.0,4.0,2.0,4.0,2.0,2.0,2.0,4.0,2.0,2.0,2.0,1.0,3.0,4.0,4.0,4.0,4.0,2.0,2.0,12,,,,,,,,,,,,,,,,,,,,,,,,,,,,,,,,,1,2.0,5.0,4.0,3.0,2.0,4.0,5.0,6.0,4.0,3.0,4.0,4.0,3.0,3.0,3.0,4.0,4.0,2.0,2.0,3.0,4.0,4.0,3.0,3.0,4.0,3.0,4.0,3.0,3.0,4.0,2.0,4.0,9,,,,,,,,,,,,,,,,,,,,,,,,,,,,,,,,,6,,,,,,,,,,,,,,,,,,,,,,,,,,,,,,,,,2,5.0,6.0,4.0,5.0,4.0,5.0,5.0,5.0,5.0,4.0,4.0,6.0,5.0,4.0,6.0,5.0,6.0,4.0,6.0,4.0,4.0,5.0,6.0,5.0,4.0,6.0,5.0,6.0,5.0,5.0,5.0,7.0,14,,,,,,,,,,,,,,,,,,,,,,,,,,,,,,,,,Good luck with your research!,667.56,57.79,,,,29.92,,37.9,,,,,,,,,,,,,,,,,,,,,,,,,,193.12,,,,,,176.15,,,,,,,,,140.84,,,,,,31.84,,APPROVED,Male,50.0,FALSE
860,2022-03-22 02:19:35,19,en,812096148,2022-03-22 02:03:48,2022-03-22 02:19:35,Y,Y,A2,,,12,,,,,,,,,,,,,,,,,,,,,,,,,,,,,,,,,2,6.0,5.0,6.0,6.0,5.0,6.0,7.0,6.0,5.0,6.0,6.0,6.0,6.0,6.0,6.0,6.0,6.0,5.0,6.0,5.0,5.0,7.0,6.0,6.0,5.0,7.0,6.0,5.0,5.0,5.0,5.0,2.0,13,,,,,,,,,,,,,,,,,,,,,,,,,,,,,,,,,10,,,,,,,,,,,,,,,,,,,,,,,,,,,,,,,,,1,6.0,6.0,5.0,4.0,5.0,4.0,7.0,5.0,6.0,5.0,4.0,3.0,5.0,5.0,6.0,4.0,6.0,4.0,6.0,6.0,4.0,6.0,2.0,3.0,5.0,7.0,5.0,5.0,7.0,5.0,7.0,5.0,7,,,,,,,,,,,,,,,,,,,,,,,,,,,,,,,,,1,5.0,6.0,4.0,4.0,6.0,4.0,5.0,6.0,6.0,6.0,5.0,3.0,3.0,3.0,6.0,4.0,5.0,3.0,6.0,5.0,4.0,2.0,4.0,4.0,4.0,6.0,4.0,6.0,7.0,3.0,6.0,7.0,14,,,,,,,,,,,,,,,,,,,,,,,,,,,,,,,,,11,,,,,,,,,,,,,,,,,,,,,,,,,,,,,,,,,8,,,,,,,,,,,,,,,,,,,,,,,,,,,,,,,,,3,,,,,,,,,,,,,,,,,,,,,,,,,,,,,,,,,6,,,,,,,,,,,,,,,,,,,,,,,,,,,,,,,,,4,,,,,,,,,,,,,,,,,,,,,,,,,,,,,,,,,9,,,,,,,,,,,,,,,,,,,,,,,,,,,,,,,,,5,,,,,,,,,,,,,,,,,,,,,,,,,,,,,,,,,,952.65,446.76,,,,15.77,,78.93,,,,,92.92,,,,,,,,,196.57,,,,,,117.62,,,,,,,,,,,,,,,,,,,,,,,,,,,4.08,,APPROVED,Male,56.0,FALSE
861,2022-03-22 02:10:47,19,en,486052896,2022-03-22 02:03:50,2022-03-22 02:10:47,Y,Y,A2,,,6,,,,,,,,,,,,,,,,,,,,,,,,,,,,,,,,,3,,,,,,,,,,,,,,,,,,,,,,,,,,,,,,,,,14,,,,,,,,,,,,,,,,,,,,,,,,,,,,,,,,,2,4.0,5.0,3.0,4.0,2.0,3.0,6.0,5.0,5.0,1.0,2.0,5.0,3.0,5.0,5.0,4.0,5.0,5.0,4.0,2.0,4.0,3.0,5.0,3.0,1.0,5.0,4.0,3.0,6.0,5.0,5.0,4.0,5,,,,,,,,,,,,,,,,,,,,,,,,,,,,,,,,,1,6.0,7.0,6.0,5.0,5.0,5.0,6.0,6.0,7.0,4.0,4.0,7.0,7.0,5.0,6.0,5.0,6.0,6.0,5.0,7.0,6.0,6.0,6.0,6.0,5.0,4.0,6.0,6.0,4.0,5.0,5.0,6.0,0,5.0,6.0,5.0,2.0,5.0,4.0,5.0,2.0,6.0,2.0,5.0,6.0,5.0,2.0,6.0,4.0,5.0,6.0,5.0,2.0,4.0,6.0,3.0,3.0,5.0,5.0,6.0,4.0,2.0,5.0,4.0,7.0,9,,,,,,,,,,,,,,,,,,,,,,,,,,,,,,,,,13,,,,,,,,,,,,,,,,,,,,,,,,,,,,,,,,,12,,,,,,,,,,,,,,,,,,,,,,,,,,,,,,,,,8,,,,,,,,,,,,,,,,,,,,,,,,,,,,,,,,,4,,,,,,,,,,,,,,,,,,,,,,,,,,,,,,,,,11,,,,,,,,,,,,,,,,,,,,,,,,,,,,,,,,,7,,,,,,,,,,,,,,,,,,,,,,,,,,,,,,,,,10,,,,,,,,,,,,,,,,,,,,,,,,,,,,,,,,,,419.61,47.27,,,,8.78,,48.68,,,,,,,,,,,136.68,,,,,,73.87,,,100.09,,,,,,,,,,,,,,,,,,,,,,,,,,,4.24,,APPROVED,Female,31.0,FALSE
862,2022-03-22 02:10:45,19,en,471193129,2022-03-22 02:03:51,2022-03-22 02:10:45,Y,Y,A3,,,3,,,,,,,,,,,,,,,,,,,,,,,,,,,,,,,,,2,5.0,3.0,4.0,6.0,3.0,6.0,3.0,5.0,3.0,3.0,4.0,5.0,5.0,4.0,4.0,3.0,5.0,5.0,5.0,4.0,4.0,5.0,6.0,5.0,3.0,5.0,3.0,5.0,3.0,5.0,5.0,2.0,10,,,,,,,,,,,,,,,,,,,,,,,,,,,,,,,,,5,,,,,,,,,,,,,,,,,,,,,,,,,,,,,,,,,9,,,,,,,,,,,,,,,,,,,,,,,,,,,,,,,,,12,,,,,,,,,,,,,,,,,,,,,,,,,,,,,,,,,13,,,,,,,,,,,,,,,,,,,,,,,,,,,,,,,,,14,,,,,,,,,,,,,,,,,,,,,,,,,,,,,,,,,4,,,,,,,,,,,,,,,,,,,,,,,,,,,,,,,,,6,,,,,,,,,,,,,,,,,,,,,,,,,,,,,,,,,11,,,,,,,,,,,,,,,,,,,,,,,,,,,,,,,,,8,,,,,,,,,,,,,,,,,,,,,,,,,,,,,,,,,0,5.0,4.0,5.0,3.0,3.0,5.0,6.0,2.0,5.0,2.0,2.0,4.0,5.0,4.0,4.0,2.0,5.0,3.0,5.0,3.0,4.0,5.0,3.0,5.0,3.0,4.0,3.0,5.0,5.0,4.0,3.0,6.0,7,,,,,,,,,,,,,,,,,,,,,,,,,,,,,,,,,1,5.0,5.0,5.0,4.0,4.0,5.0,5.0,3.0,6.0,4.0,6.0,5.0,5.0,5.0,4.0,4.0,6.0,5.0,5.0,4.0,4.0,5.0,3.0,5.0,4.0,4.0,3.0,5.0,5.0,5.0,3.0,1.0,,405.76,20.68,,,,8.27,,42.83,,,,,76.09,,,,,,,,,,,,,,,,,,,,,,,,,,,,,,,,,156.53,,,,,,98.09,,,3.27,,APPROVED,Female,36.0,FALSE
863,2022-03-22 02:10:49,19,en,1059750926,2022-03-22 02:03:51,2022-03-22 02:10:49,Y,Y,A1,,,5,,,,,,,,,,,,,,,,,,,,,,,,,,,,,,,,,14,,,,,,,,,,,,,,,,,,,,,,,,,,,,,,,,,1,5.0,5.0,4.0,3.0,4.0,3.0,4.0,5.0,6.0,5.0,3.0,5.0,5.0,5.0,6.0,4.0,5.0,5.0,5.0,4.0,5.0,5.0,3.0,3.0,5.0,3.0,3.0,3.0,2.0,4.0,5.0,3.0,11,,,,,,,,,,,,,,,,,,,,,,,,,,,,,,,,,4,,,,,,,,,,,,,,,,,,,,,,,,,,,,,,,,,6,,,,,,,,,,,,,,,,,,,,,,,,,,,,,,,,,0,2.0,2.0,2.0,2.0,2.0,2.0,6.0,2.0,2.0,2.0,1.0,2.0,2.0,2.0,2.0,2.0,2.0,2.0,2.0,2.0,2.0,2.0,2.0,1.0,2.0,2.0,2.0,2.0,1.0,2.0,2.0,7.0,9,,,,,,,,,,,,,,,,,,,,,,,,,,,,,,,,,10,,,,,,,,,,,,,,,,,,,,,,,,,,,,,,,,,8,,,,,,,,,,,,,,,,,,,,,,,,,,,,,,,,,13,,,,,,,,,,,,,,,,,,,,,,,,,,,,,,,,,12,,,,,,,,,,,,,,,,,,,,,,,,,,,,,,,,,3,,,,,,,,,,,,,,,,,,,,,,,,,,,,,,,,,7,,,,,,,,,,,,,,,,,,,,,,,,,,,,,,,,,2,2.0,3.0,2.0,2.0,2.0,1.0,6.0,2.0,2.0,2.0,2.0,2.0,2.0,2.0,1.0,1.0,2.0,2.0,2.0,2.0,2.0,2.0,2.0,2.0,2.0,2.0,2.0,1.0,2.0,2.0,2.0,1.0,,420.99,63.67,,,,5.54,,41.35,,,,,,,,117.32,,,,,,,,,,,,105.17,,,,,,,,,,,,,,,,,,,,,,,,82.58,,,5.36,,APPROVED,Female,25.0,FALSE
864,2022-03-22 02:11:11,19,en,785290093,2022-03-22 02:03:56,2022-03-22 02:11:11,Y,Y,A1,,,3,,,,,,,,,,,,,,,,,,,,,,,,,,,,,,,,,5,,,,,,,,,,,,,,,,,,,,,,,,,,,,,,,,,4,,,,,,,,,,,,,,,,,,,,,,,,,,,,,,,,,2,6.0,6.0,5.0,5.0,6.0,6.0,4.0,4.0,4.0,4.0,5.0,5.0,5.0,6.0,5.0,4.0,6.0,5.0,6.0,6.0,5.0,5.0,6.0,5.0,5.0,6.0,1.0,6.0,5.0,4.0,5.0,4.0,12,,,,,,,,,,,,,,,,,,,,,,,,,,,,,,,,,10,,,,,,,,,,,,,,,,,,,,,,,,,,,,,,,,,1,6.0,6.0,7.0,6.0,5.0,6.0,5.0,1.0,4.0,4.0,5.0,6.0,6.0,6.0,6.0,5.0,6.0,5.0,6.0,6.0,4.0,6.0,6.0,6.0,6.0,7.0,2.0,7.0,6.0,4.0,7.0,7.0,14,,,,,,,,,,,,,,,,,,,,,,,,,,,,,,,,,9,,,,,,,,,,,,,,,,,,,,,,,,,,,,,,,,,11,,,,,,,,,,,,,,,,,,,,,,,,,,,,,,,,,0,6.0,6.0,5.0,4.0,6.0,5.0,4.0,4.0,6.0,4.0,5.0,6.0,6.0,5.0,6.0,3.0,6.0,6.0,7.0,6.0,5.0,6.0,2.0,6.0,5.0,4.0,2.0,6.0,6.0,5.0,6.0,4.0,7,,,,,,,,,,,,,,,,,,,,,,,,,,,,,,,,,13,,,,,,,,,,,,,,,,,,,,,,,,,,,,,,,,,8,,,,,,,,,,,,,,,,,,,,,,,,,,,,,,,,,6,,,,,,,,,,,,,,,,,,,,,,,,,,,,,,,,,,433.77,15.6,,,,16.04,,132.14,,,,,,,,,,,94.17,,,,,,,,,63.7,,,,,,,,,,,,109.27,,,,,,,,,,,,,,,2.85,,APPROVED,Male,22.0,FALSE
865,2022-03-22 02:20:00,19,en,1251979167,2022-03-22 02:03:56,2022-03-22 02:20:00,Y,Y,A1,,,1,3.0,6.0,4.0,4.0,2.0,2.0,6.0,2.0,7.0,2.0,3.0,6.0,3.0,4.0,5.0,2.0,7.0,2.0,3.0,2.0,2.0,3.0,5.0,4.0,2.0,5.0,6.0,4.0,5.0,2.0,4.0,1.0,10,,,,,,,,,,,,,,,,,,,,,,,,,,,,,,,,,0,5.0,6.0,5.0,5.0,4.0,3.0,2.0,4.0,7.0,3.0,5.0,6.0,5.0,2.0,4.0,5.0,6.0,4.0,5.0,4.0,4.0,5.0,7.0,5.0,4.0,6.0,2.0,4.0,5.0,5.0,6.0,3.0,7,,,,,,,,,,,,,,,,,,,,,,,,,,,,,,,,,6,,,,,,,,,,,,,,,,,,,,,,,,,,,,,,,,,3,,,,,,,,,,,,,,,,,,,,,,,,,,,,,,,,,4,,,,,,,,,,,,,,,,,,,,,,,,,,,,,,,,,2,2.0,2.0,2.0,1.0,2.0,2.0,4.0,3.0,5.0,1.0,2.0,4.0,2.0,1.0,3.0,3.0,5.0,1.0,2.0,2.0,4.0,2.0,4.0,1.0,1.0,2.0,2.0,1.0,3.0,3.0,3.0,1.0,11,,,,,,,,,,,,,,,,,,,,,,,,,,,,,,,,,14,,,,,,,,,,,,,,,,,,,,,,,,,,,,,,,,,8,,,,,,,,,,,,,,,,,,,,,,,,,,,,,,,,,5,,,,,,,,,,,,,,,,,,,,,,,,,,,,,,,,,9,,,,,,,,,,,,,,,,,,,,,,,,,,,,,,,,,13,,,,,,,,,,,,,,,,,,,,,,,,,,,,,,,,,12,,,,,,,,,,,,,,,,,,,,,,,,,,,,,,,,,"Hi , I think I would have found it easier to rate the visualisations if I had seen them together. Good luck with your research. :-)",967.82,28.53,,,,12.28,,72.56,,167.48,,,,,,333.7,,,,,,,,,,,,,,,260.55,,,,,,,,,,,,,,,,,,,,,,,,92.72,,APPROVED,Female,49.0,FALSE
866,2022-03-22 02:06:50,19,en,1079720054,2022-03-22 02:03:59,2022-03-22 02:06:50,Y,Y,A1,,,10,,,,,,,,,,,,,,,,,,,,,,,,,,,,,,,,,9,,,,,,,,,,,,,,,,,,,,,,,,,,,,,,,,,0,5.0,6.0,5.0,5.0,6.0,6.0,3.0,6.0,4.0,6.0,5.0,5.0,5.0,5.0,5.0,6.0,5.0,6.0,4.0,5.0,5.0,6.0,4.0,5.0,6.0,4.0,5.0,6.0,5.0,4.0,5.0,3.0,8,,,,,,,,,,,,,,,,,,,,,,,,,,,,,,,,,3,,,,,,,,,,,,,,,,,,,,,,,,,,,,,,,,,14,,,,,,,,,,,,,,,,,,,,,,,,,,,,,,,,,1,2.0,3.0,3.0,3.0,3.0,5.0,5.0,3.0,4.0,2.0,3.0,3.0,2.0,3.0,3.0,3.0,3.0,2.0,2.0,3.0,3.0,3.0,3.0,2.0,3.0,3.0,3.0,2.0,4.0,2.0,3.0,7.0,4,,,,,,,,,,,,,,,,,,,,,,,,,,,,,,,,,12,,,,,,,,,,,,,,,,,,,,,,,,,,,,,,,,,13,,,,,,,,,,,,,,,,,,,,,,,,,,,,,,,,,7,,,,,,,,,,,,,,,,,,,,,,,,,,,,,,,,,6,,,,,,,,,,,,,,,,,,,,,,,,,,,,,,,,,2,2.0,3.0,3.0,3.0,2.0,2.0,6.0,3.0,3.0,3.0,3.0,3.0,2.0,3.0,4.0,3.0,5.0,3.0,3.0,3.0,3.0,3.0,2.0,2.0,3.0,2.0,5.0,3.0,5.0,3.0,3.0,6.0,11,,,,,,,,,,,,,,,,,,,,,,,,,,,,,,,,,5,,,,,,,,,,,,,,,,,,,,,,,,,,,,,,,,,,173.28,12.94,,,,7.64,,18.83,,,,,,,,47.8,,,,,,,,,,,,46.35,,,,,,,,,,,,,,,,,,35.55,,,,,,,,,4.17,,APPROVED,Female,22.0,FALSE
868,2022-03-22 02:33:42,19,en,1970326745,2022-03-22 02:03:59,2022-03-22 02:33:42,Y,Y,A1,,,5,,,,,,,,,,,,,,,,,,,,,,,,,,,,,,,,,9,,,,,,,,,,,,,,,,,,,,,,,,,,,,,,,,,2,5.0,7.0,6.0,4.0,7.0,5.0,5.0,7.0,5.0,5.0,3.0,5.0,6.0,5.0,7.0,5.0,7.0,6.0,5.0,5.0,6.0,2.0,3.0,6.0,7.0,3.0,3.0,6.0,3.0,4.0,6.0,3.0,10,,,,,,,,,,,,,,,,,,,,,,,,,,,,,,,,,4,,,,,,,,,,,,,,,,,,,,,,,,,,,,,,,,,7,,,,,,,,,,,,,,,,,,,,,,,,,,,,,,,,,13,,,,,,,,,,,,,,,,,,,,,,,,,,,,,,,,,6,,,,,,,,,,,,,,,,,,,,,,,,,,,,,,,,,1,3.0,1.0,3.0,3.0,5.0,6.0,5.0,1.0,3.0,6.0,6.0,3.0,4.0,1.0,3.0,4.0,4.0,5.0,4.0,3.0,2.0,5.0,4.0,3.0,2.0,7.0,2.0,5.0,5.0,6.0,6.0,2.0,11,,,,,,,,,,,,,,,,,,,,,,,,,,,,,,,,,0,3.0,5.0,5.0,2.0,4.0,1.0,6.0,6.0,5.0,5.0,2.0,5.0,3.0,5.0,5.0,4.0,5.0,5.0,3.0,3.0,4.0,3.0,1.0,5.0,4.0,3.0,5.0,2.0,2.0,3.0,2.0,4.0,8,,,,,,,,,,,,,,,,,,,,,,,,,,,,,,,,,14,,,,,,,,,,,,,,,,,,,,,,,,,,,,,,,,,3,,,,,,,,,,,,,,,,,,,,,,,,,,,,,,,,,12,,,,,,,,,,,,,,,,,,,,,,,,,,,,,,,,,"The analyzing of the data is very important as to understand how well a graph is capable of understanding the information, depending on how well you understand the information you’ll see if it's clustered or rather well spaced, perception without it seems incomplete, and biased, like I am being forced to give an answer rather than it coming naturally.",1785.88,48.7,,,,13.95,,78.69,,,,,,,,214.33,,,,,,,,,,,,,,,,,,462.52,,,,,,320.32,,,,,,,,,,,,,,,647.37,,APPROVED,Male,21.0,FALSE
869,2022-03-22 02:27:53,19,en,1745615369,2022-03-22 02:03:59,2022-03-22 02:27:53,Y,Y,A1,,,1,3.0,6.0,2.0,3.0,2.0,3.0,5.0,5.0,6.0,5.0,3.0,3.0,3.0,6.0,5.0,3.0,5.0,3.0,2.0,3.0,5.0,2.0,3.0,3.0,3.0,3.0,5.0,2.0,2.0,2.0,2.0,1.0,5,,,,,,,,,,,,,,,,,,,,,,,,,,,,,,,,,7,,,,,,,,,,,,,,,,,,,,,,,,,,,,,,,,,13,,,,,,,,,,,,,,,,,,,,,,,,,,,,,,,,,9,,,,,,,,,,,,,,,,,,,,,,,,,,,,,,,,,3,,,,,,,,,,,,,,,,,,,,,,,,,,,,,,,,,10,,,,,,,,,,,,,,,,,,,,,,,,,,,,,,,,,14,,,,,,,,,,,,,,,,,,,,,,,,,,,,,,,,,6,,,,,,,,,,,,,,,,,,,,,,,,,,,,,,,,,8,,,,,,,,,,,,,,,,,,,,,,,,,,,,,,,,,4,,,,,,,,,,,,,,,,,,,,,,,,,,,,,,,,,0,3.0,6.0,3.0,3.0,5.0,3.0,5.0,5.0,3.0,3.0,2.0,6.0,3.0,3.0,5.0,3.0,5.0,6.0,2.0,3.0,7.0,2.0,3.0,2.0,6.0,2.0,5.0,3.0,3.0,2.0,3.0,5.0,11,,,,,,,,,,,,,,,,,,,,,,,,,,,,,,,,,12,,,,,,,,,,,,,,,,,,,,,,,,,,,,,,,,,2,5.0,6.0,5.0,2.0,5.0,3.0,5.0,6.0,7.0,3.0,3.0,5.0,5.0,5.0,5.0,3.0,6.0,3.0,3.0,2.0,5.0,5.0,3.0,5.0,5.0,2.0,6.0,2.0,3.0,3.0,2.0,1.0,,1436.64,28.55,,,,9.29,,225.6,,499.52,,,,,,,,,,,,,,,,,,,,,,,,,,,,,,,,,398.67,,,,,,,,,272.32,,,2.69,,APPROVED,Male,36.0,FALSE
870,2022-03-22 02:14:19,19,en,584846966,2022-03-22 02:04:00,2022-03-22 02:14:19,Y,Y,A1,,,1,7.0,7.0,7.0,3.0,7.0,4.0,4.0,7.0,7.0,7.0,6.0,6.0,7.0,7.0,7.0,6.0,7.0,4.0,7.0,7.0,7.0,7.0,1.0,7.0,7.0,5.0,7.0,4.0,6.0,5.0,7.0,1.0,3,,,,,,,,,,,,,,,,,,,,,,,,,,,,,,,,,0,6.0,6.0,5.0,5.0,3.0,4.0,2.0,7.0,6.0,5.0,5.0,6.0,4.0,4.0,6.0,6.0,6.0,4.0,5.0,4.0,4.0,6.0,4.0,6.0,6.0,4.0,4.0,5.0,4.0,6.0,6.0,3.0,7,,,,,,,,,,,,,,,,,,,,,,,,,,,,,,,,,5,,,,,,,,,,,,,,,,,,,,,,,,,,,,,,,,,9,,,,,,,,,,,,,,,,,,,,,,,,,,,,,,,,,4,,,,,,,,,,,,,,,,,,,,,,,,,,,,,,,,,8,,,,,,,,,,,,,,,,,,,,,,,,,,,,,,,,,6,,,,,,,,,,,,,,,,,,,,,,,,,,,,,,,,,11,,,,,,,,,,,,,,,,,,,,,,,,,,,,,,,,,12,,,,,,,,,,,,,,,,,,,,,,,,,,,,,,,,,2,1.0,6.0,2.0,1.0,3.0,1.0,6.0,7.0,5.0,1.0,2.0,2.0,1.0,5.0,5.0,1.0,5.0,1.0,4.0,2.0,2.0,2.0,1.0,2.0,2.0,2.0,5.0,4.0,2.0,4.0,3.0,5.0,13,,,,,,,,,,,,,,,,,,,,,,,,,,,,,,,,,10,,,,,,,,,,,,,,,,,,,,,,,,,,,,,,,,,14,,,,,,,,,,,,,,,,,,,,,,,,,,,,,,,,,No,623.01,167.73,,,,5.89,,36.39,,80.86,,,,,,230.64,,,,,,,,,,,,,,,,,,,,,,,,,,,94.22,,,,,,,,,,,,7.28,,APPROVED,Female,69.0,FALSE
871,2022-03-22 02:09:05,19,en,480931392,2022-03-22 02:04:04,2022-03-22 02:09:05,Y,Y,A1,,,7,,,,,,,,,,,,,,,,,,,,,,,,,,,,,,,,,13,,,,,,,,,,,,,,,,,,,,,,,,,,,,,,,,,2,5.0,4.0,7.0,5.0,4.0,7.0,2.0,7.0,5.0,4.0,6.0,4.0,5.0,4.0,4.0,5.0,3.0,4.0,5.0,4.0,4.0,5.0,6.0,5.0,5.0,7.0,3.0,5.0,5.0,4.0,5.0,3.0,6,,,,,,,,,,,,,,,,,,,,,,,,,,,,,,,,,3,,,,,,,,,,,,,,,,,,,,,,,,,,,,,,,,,0,6.0,6.0,6.0,3.0,5.0,2.0,6.0,6.0,7.0,4.0,6.0,7.0,5.0,4.0,5.0,4.0,5.0,4.0,5.0,5.0,4.0,5.0,3.0,5.0,7.0,1.0,4.0,4.0,3.0,4.0,5.0,6.0,1,3.0,5.0,3.0,2.0,3.0,5.0,6.0,4.0,5.0,4.0,3.0,2.0,4.0,4.0,4.0,4.0,5.0,4.0,4.0,4.0,2.0,3.0,3.0,3.0,2.0,2.0,4.0,3.0,2.0,4.0,4.0,7.0,14,,,,,,,,,,,,,,,,,,,,,,,,,,,,,,,,,9,,,,,,,,,,,,,,,,,,,,,,,,,,,,,,,,,11,,,,,,,,,,,,,,,,,,,,,,,,,,,,,,,,,8,,,,,,,,,,,,,,,,,,,,,,,,,,,,,,,,,10,,,,,,,,,,,,,,,,,,,,,,,,,,,,,,,,,12,,,,,,,,,,,,,,,,,,,,,,,,,,,,,,,,,5,,,,,,,,,,,,,,,,,,,,,,,,,,,,,,,,,4,,,,,,,,,,,,,,,,,,,,,,,,,,,,,,,,,,295.72,14.37,,,,18.1,,39.86,,,,,,,,57.33,,,,,,,,,91.23,,,71.71,,,,,,,,,,,,,,,,,,,,,,,,,,,3.12,,APPROVED,Female,21.0,FALSE
872,2022-03-22 02:10:53,19,en,1094489496,2022-03-22 02:04:04,2022-03-22 02:10:53,Y,Y,A1,,,11,,,,,,,,,,,,,,,,,,,,,,,,,,,,,,,,,10,,,,,,,,,,,,,,,,,,,,,,,,,,,,,,,,,4,,,,,,,,,,,,,,,,,,,,,,,,,,,,,,,,,12,,,,,,,,,,,,,,,,,,,,,,,,,,,,,,,,,14,,,,,,,,,,,,,,,,,,,,,,,,,,,,,,,,,1,5.0,5.0,6.0,3.0,5.0,4.0,6.0,5.0,5.0,4.0,3.0,6.0,5.0,6.0,6.0,4.0,5.0,5.0,4.0,4.0,5.0,5.0,3.0,5.0,5.0,6.0,3.0,3.0,3.0,6.0,3.0,6.0,7,,,,,,,,,,,,,,,,,,,,,,,,,,,,,,,,,6,,,,,,,,,,,,,,,,,,,,,,,,,,,,,,,,,9,,,,,,,,,,,,,,,,,,,,,,,,,,,,,,,,,5,,,,,,,,,,,,,,,,,,,,,,,,,,,,,,,,,13,,,,,,,,,,,,,,,,,,,,,,,,,,,,,,,,,2,6.0,6.0,6.0,6.0,6.0,5.0,2.0,6.0,5.0,5.0,6.0,5.0,5.0,5.0,5.0,5.0,6.0,5.0,5.0,5.0,3.0,5.0,5.0,5.0,6.0,5.0,4.0,4.0,6.0,5.0,5.0,5.0,3,,,,,,,,,,,,,,,,,,,,,,,,,,,,,,,,,0,5.0,5.0,4.0,4.0,3.0,5.0,3.0,5.0,6.0,2.0,3.0,5.0,4.0,5.0,6.0,3.0,6.0,5.0,4.0,2.0,4.0,5.0,5.0,5.0,3.0,5.0,6.0,4.0,3.0,3.0,5.0,7.0,8,,,,,,,,,,,,,,,,,,,,,,,,,,,,,,,,,.,411.8,27.6,,,,11.44,,49.3,,,,,,,,,,,,,,,,,91.03,,,,,,,,,,,,,,,,,,136.22,,,,,,86.52,,,,,,9.69,,APPROVED,Male,27.0,FALSE
873,2022-03-22 02:08:45,19,en,765851675,2022-03-22 02:04:04,2022-03-22 02:08:45,Y,Y,A1,,,10,,,,,,,,,,,,,,,,,,,,,,,,,,,,,,,,,14,,,,,,,,,,,,,,,,,,,,,,,,,,,,,,,,,0,3.0,7.0,7.0,7.0,6.0,1.0,6.0,4.0,7.0,3.0,7.0,3.0,1.0,2.0,7.0,7.0,6.0,1.0,3.0,5.0,4.0,6.0,4.0,7.0,7.0,7.0,7.0,3.0,4.0,5.0,1.0,3.0,2,7.0,5.0,7.0,3.0,7.0,7.0,2.0,7.0,2.0,6.0,4.0,7.0,7.0,3.0,7.0,2.0,6.0,2.0,6.0,5.0,2.0,5.0,6.0,6.0,7.0,7.0,3.0,5.0,6.0,6.0,7.0,4.0,11,,,,,,,,,,,,,,,,,,,,,,,,,,,,,,,,,8,,,,,,,,,,,,,,,,,,,,,,,,,,,,,,,,,13,,,,,,,,,,,,,,,,,,,,,,,,,,,,,,,,,5,,,,,,,,,,,,,,,,,,,,,,,,,,,,,,,,,6,,,,,,,,,,,,,,,,,,,,,,,,,,,,,,,,,4,,,,,,,,,,,,,,,,,,,,,,,,,,,,,,,,,7,,,,,,,,,,,,,,,,,,,,,,,,,,,,,,,,,12,,,,,,,,,,,,,,,,,,,,,,,,,,,,,,,,,9,,,,,,,,,,,,,,,,,,,,,,,,,,,,,,,,,3,,,,,,,,,,,,,,,,,,,,,,,,,,,,,,,,,1,1.0,7.0,3.0,6.0,4.0,2.0,1.0,7.0,7.0,2.0,2.0,2.0,3.0,2.0,6.0,2.0,6.0,6.0,5.0,7.0,6.0,2.0,1.0,2.0,3.0,1.0,7.0,2.0,7.0,4.0,1.0,1.0,,284.42,16.31,,,,10.16,,31.22,,,,,,,,75.82,,,71.84,,,,,,,,,,,,,,,,,,,,,,,,,,,,,,,,,75.68,,,3.39,,APPROVED,Male,27.0,FALSE
874,2022-03-22 02:14:42,19,en,1196293382,2022-03-22 02:04:07,2022-03-22 02:14:42,Y,Y,-oth-,city & guilds,,5,,,,,,,,,,,,,,,,,,,,,,,,,,,,,,,,,4,,,,,,,,,,,,,,,,,,,,,,,,,,,,,,,,,6,,,,,,,,,,,,,,,,,,,,,,,,,,,,,,,,,0,4.0,5.0,4.0,4.0,3.0,5.0,5.0,5.0,6.0,3.0,6.0,4.0,4.0,4.0,5.0,5.0,5.0,4.0,3.0,4.0,3.0,5.0,6.0,4.0,4.0,3.0,3.0,4.0,5.0,5.0,4.0,4.0,3,,,,,,,,,,,,,,,,,,,,,,,,,,,,,,,,,13,,,,,,,,,,,,,,,,,,,,,,,,,,,,,,,,,12,,,,,,,,,,,,,,,,,,,,,,,,,,,,,,,,,2,1.0,3.0,1.0,3.0,1.0,4.0,2.0,5.0,4.0,3.0,2.0,3.0,2.0,3.0,2.0,4.0,5.0,2.0,3.0,2.0,4.0,3.0,5.0,2.0,1.0,4.0,2.0,3.0,4.0,1.0,4.0,1.0,10,,,,,,,,,,,,,,,,,,,,,,,,,,,,,,,,,11,,,,,,,,,,,,,,,,,,,,,,,,,,,,,,,,,14,,,,,,,,,,,,,,,,,,,,,,,,,,,,,,,,,8,,,,,,,,,,,,,,,,,,,,,,,,,,,,,,,,,1,6.0,6.0,6.0,6.0,6.0,6.0,4.0,6.0,6.0,5.0,6.0,6.0,5.0,6.0,5.0,6.0,6.0,5.0,6.0,5.0,5.0,6.0,6.0,6.0,6.0,5.0,5.0,6.0,6.0,6.0,6.0,6.0,7,,,,,,,,,,,,,,,,,,,,,,,,,,,,,,,,,9,,,,,,,,,,,,,,,,,,,,,,,,,,,,,,,,,I found the survey interesting and easy to complete.,637.71,76.52,,,,48.56,,49.03,,,,,,,,,,,166.26,,,,,,,,,,,,136.33,,,,,,,,,,,,,,,118.58,,,,,,,,,42.43,,APPROVED,Male,50.0,FALSE
875,2022-03-22 02:12:28,19,en,195231088,2022-03-22 02:04:07,2022-03-22 02:12:28,Y,Y,-oth-,high school,,12,,,,,,,,,,,,,,,,,,,,,,,,,,,,,,,,,3,,,,,,,,,,,,,,,,,,,,,,,,,,,,,,,,,0,6.0,7.0,7.0,5.0,6.0,6.0,5.0,7.0,6.0,5.0,5.0,7.0,6.0,6.0,6.0,6.0,6.0,6.0,6.0,6.0,5.0,6.0,4.0,6.0,6.0,5.0,6.0,6.0,6.0,5.0,6.0,3.0,9,,,,,,,,,,,,,,,,,,,,,,,,,,,,,,,,,14,,,,,,,,,,,,,,,,,,,,,,,,,,,,,,,,,13,,,,,,,,,,,,,,,,,,,,,,,,,,,,,,,,,4,,,,,,,,,,,,,,,,,,,,,,,,,,,,,,,,,7,,,,,,,,,,,,,,,,,,,,,,,,,,,,,,,,,8,,,,,,,,,,,,,,,,,,,,,,,,,,,,,,,,,6,,,,,,,,,,,,,,,,,,,,,,,,,,,,,,,,,2,4.0,6.0,6.0,4.0,6.0,4.0,4.0,6.0,7.0,6.0,5.0,4.0,7.0,6.0,6.0,4.0,6.0,5.0,6.0,5.0,6.0,6.0,3.0,6.0,6.0,5.0,6.0,6.0,6.0,6.0,5.0,4.0,10,,,,,,,,,,,,,,,,,,,,,,,,,,,,,,,,,5,,,,,,,,,,,,,,,,,,,,,,,,,,,,,,,,,1,3.0,3.0,3.0,4.0,3.0,3.0,4.0,3.0,5.0,3.0,2.0,3.0,3.0,4.0,5.0,4.0,4.0,4.0,3.0,3.0,3.0,3.0,5.0,3.0,3.0,4.0,3.0,3.0,2.0,3.0,4.0,5.0,11,,,,,,,,,,,,,,,,,,,,,,,,,,,,,,,,,,503.19,60.95,,,,14.97,,25.7,,,,,,,,84.42,,,,,,,,,,,,,,,,,,,,,,,,237.69,,,,,,,,,75.13,,,,,,4.33,,APPROVED,Male,21.0,FALSE
876,2022-03-22 02:07:24,19,en,1895848968,2022-03-22 02:04:26,2022-03-22 02:07:24,Y,Y,A1,,,5,,,,,,,,,,,,,,,,,,,,,,,,,,,,,,,,,0,6.0,5.0,5.0,6.0,5.0,6.0,2.0,6.0,3.0,4.0,5.0,5.0,5.0,5.0,4.0,6.0,5.0,5.0,5.0,4.0,4.0,5.0,6.0,5.0,5.0,6.0,5.0,5.0,3.0,5.0,5.0,2.0,12,,,,,,,,,,,,,,,,,,,,,,,,,,,,,,,,,6,,,,,,,,,,,,,,,,,,,,,,,,,,,,,,,,,3,,,,,,,,,,,,,,,,,,,,,,,,,,,,,,,,,10,,,,,,,,,,,,,,,,,,,,,,,,,,,,,,,,,9,,,,,,,,,,,,,,,,,,,,,,,,,,,,,,,,,13,,,,,,,,,,,,,,,,,,,,,,,,,,,,,,,,,11,,,,,,,,,,,,,,,,,,,,,,,,,,,,,,,,,2,2.0,1.0,2.0,1.0,2.0,1.0,7.0,4.0,2.0,2.0,2.0,1.0,2.0,2.0,2.0,3.0,2.0,2.0,2.0,2.0,2.0,2.0,1.0,2.0,2.0,1.0,2.0,2.0,1.0,2.0,1.0,3.0,14,,,,,,,,,,,,,,,,,,,,,,,,,,,,,,,,,4,,,,,,,,,,,,,,,,,,,,,,,,,,,,,,,,,7,,,,,,,,,,,,,,,,,,,,,,,,,,,,,,,,,1,4.0,5.0,4.0,5.0,4.0,5.0,2.0,5.0,6.0,4.0,4.0,6.0,5.0,6.0,6.0,5.0,7.0,4.0,5.0,4.0,4.0,4.0,6.0,4.0,4.0,5.0,6.0,5.0,6.0,5.0,5.0,7.0,8,,,,,,,,,,,,,,,,,,,,,,,,,,,,,,,,,,180.78,11.28,,,,4.93,,16.56,,,,,56.35,,,,,,,,,,,,,,,,,,,,,,,,40.1,,,,,,,,,,,,48.79,,,,,,2.77,,APPROVED,Male,22.0,FALSE
877,2022-03-22 02:09:53,19,en,129784389,2022-03-22 02:04:53,2022-03-22 02:09:53,Y,Y,A1,,,7,,,,,,,,,,,,,,,,,,,,,,,,,,,,,,,,,0,6.0,4.0,5.0,7.0,4.0,7.0,1.0,7.0,3.0,4.0,4.0,6.0,6.0,4.0,4.0,6.0,6.0,5.0,6.0,5.0,4.0,6.0,6.0,6.0,5.0,6.0,1.0,6.0,4.0,5.0,5.0,2.0,8,,,,,,,,,,,,,,,,,,,,,,,,,,,,,,,,,1,3.0,5.0,2.0,2.0,2.0,1.0,7.0,1.0,6.0,3.0,2.0,3.0,5.0,3.0,5.0,3.0,5.0,3.0,2.0,3.0,2.0,3.0,1.0,3.0,2.0,2.0,1.0,5.0,4.0,2.0,1.0,4.0,14,,,,,,,,,,,,,,,,,,,,,,,,,,,,,,,,,5,,,,,,,,,,,,,,,,,,,,,,,,,,,,,,,,,9,,,,,,,,,,,,,,,,,,,,,,,,,,,,,,,,,2,1.0,1.0,1.0,1.0,1.0,1.0,7.0,1.0,1.0,1.0,1.0,1.0,1.0,1.0,1.0,1.0,1.0,1.0,1.0,1.0,1.0,1.0,1.0,1.0,1.0,1.0,1.0,1.0,4.0,1.0,1.0,1.0,10,,,,,,,,,,,,,,,,,,,,,,,,,,,,,,,,,11,,,,,,,,,,,,,,,,,,,,,,,,,,,,,,,,,6,,,,,,,,,,,,,,,,,,,,,,,,,,,,,,,,,3,,,,,,,,,,,,,,,,,,,,,,,,,,,,,,,,,4,,,,,,,,,,,,,,,,,,,,,,,,,,,,,,,,,12,,,,,,,,,,,,,,,,,,,,,,,,,,,,,,,,,13,,,,,,,,,,,,,,,,,,,,,,,,,,,,,,,,,,303.52,12.53,,,,9.61,,45.69,,,,,93.06,,,,,,92.62,,,,,,,,,,,,47.23,,,,,,,,,,,,,,,,,,,,,,,,2.78,,APPROVED,Male,19.0,FALSE
878,2022-03-22 02:15:03,19,en,674245338,2022-03-22 02:05:23,2022-03-22 02:15:03,Y,Y,A1,,,2,2.0,5.0,2.0,2.0,2.0,2.0,2.0,2.0,5.0,2.0,2.0,2.0,2.0,2.0,2.0,2.0,4.0,2.0,2.0,2.0,2.0,2.0,2.0,2.0,2.0,2.0,3.0,2.0,2.0,4.0,2.0,1.0,3,,,,,,,,,,,,,,,,,,,,,,,,,,,,,,,,,7,,,,,,,,,,,,,,,,,,,,,,,,,,,,,,,,,5,,,,,,,,,,,,,,,,,,,,,,,,,,,,,,,,,13,,,,,,,,,,,,,,,,,,,,,,,,,,,,,,,,,6,,,,,,,,,,,,,,,,,,,,,,,,,,,,,,,,,14,,,,,,,,,,,,,,,,,,,,,,,,,,,,,,,,,12,,,,,,,,,,,,,,,,,,,,,,,,,,,,,,,,,1,2.0,2.0,2.0,2.0,2.0,2.0,5.0,2.0,2.0,3.0,3.0,2.0,2.0,2.0,2.0,4.0,3.0,2.0,2.0,2.0,3.0,4.0,2.0,2.0,2.0,2.0,4.0,3.0,2.0,3.0,2.0,2.0,10,,,,,,,,,,,,,,,,,,,,,,,,,,,,,,,,,0,4.0,5.0,4.0,5.0,4.0,5.0,3.0,4.0,5.0,4.0,4.0,4.0,3.0,3.0,3.0,4.0,3.0,4.0,4.0,3.0,3.0,4.0,4.0,4.0,4.0,5.0,3.0,3.0,4.0,5.0,3.0,4.0,8,,,,,,,,,,,,,,,,,,,,,,,,,,,,,,,,,4,,,,,,,,,,,,,,,,,,,,,,,,,,,,,,,,,9,,,,,,,,,,,,,,,,,,,,,,,,,,,,,,,,,11,,,,,,,,,,,,,,,,,,,,,,,,,,,,,,,,,No comment,582.3,35.99,,,,14.43,,87.41,,105.83,,,,,,,,,,,,,,,,,,,,,,,,124.95,,,,,,168.66,,,,,,,,,,,,,,,45.03,,APPROVED,Male,27.0,FALSE
879,2022-03-22 02:27:24,19,en,1588537000,2022-03-22 02:05:52,2022-03-22 02:27:24,Y,Y,A1,,,10,,,,,,,,,,,,,,,,,,,,,,,,,,,,,,,,,12,,,,,,,,,,,,,,,,,,,,,,,,,,,,,,,,,8,,,,,,,,,,,,,,,,,,,,,,,,,,,,,,,,,7,,,,,,,,,,,,,,,,,,,,,,,,,,,,,,,,,13,,,,,,,,,,,,,,,,,,,,,,,,,,,,,,,,,6,,,,,,,,,,,,,,,,,,,,,,,,,,,,,,,,,4,,,,,,,,,,,,,,,,,,,,,,,,,,,,,,,,,1,3.0,2.0,2.0,5.0,3.0,2.0,5.0,2.0,6.0,2.0,3.0,6.0,3.0,5.0,5.0,3.0,7.0,5.0,5.0,1.0,3.0,5.0,6.0,4.0,3.0,2.0,2.0,5.0,3.0,2.0,6.0,1.0,11,,,,,,,,,,,,,,,,,,,,,,,,,,,,,,,,,3,,,,,,,,,,,,,,,,,,,,,,,,,,,,,,,,,14,,,,,,,,,,,,,,,,,,,,,,,,,,,,,,,,,5,,,,,,,,,,,,,,,,,,,,,,,,,,,,,,,,,2,5.0,3.0,6.0,5.0,5.0,6.0,1.0,3.0,3.0,4.0,6.0,6.0,5.0,3.0,6.0,5.0,6.0,6.0,5.0,2.0,3.0,5.0,6.0,3.0,6.0,7.0,5.0,5.0,6.0,2.0,7.0,6.0,0,5.0,2.0,2.0,5.0,5.0,5.0,1.0,6.0,5.0,4.0,3.0,5.0,3.0,2.0,2.0,3.0,6.0,2.0,5.0,3.0,2.0,5.0,6.0,3.0,3.0,5.0,1.0,1.0,3.0,2.0,6.0,1.0,9,,,,,,,,,,,,,,,,,,,,,,,,,,,,,,,,,,1294.38,40.53,,,,7.31,,723.22,,,,,,,,,,,,,,,,,,,,,,,150.74,,,,,,,,,,,,,,,156.02,,,213.34,,,,,,3.22,,APPROVED,Female,22.0,FALSE
880,2022-03-22 02:15:12,19,en,1646380089,2022-03-22 02:05:56,2022-03-22 02:15:12,Y,Y,-oth-,High school diploma,,5,,,,,,,,,,,,,,,,,,,,,,,,,,,,,,,,,11,,,,,,,,,,,,,,,,,,,,,,,,,,,,,,,,,3,,,,,,,,,,,,,,,,,,,,,,,,,,,,,,,,,14,,,,,,,,,,,,,,,,,,,,,,,,,,,,,,,,,6,,,,,,,,,,,,,,,,,,,,,,,,,,,,,,,,,4,,,,,,,,,,,,,,,,,,,,,,,,,,,,,,,,,9,,,,,,,,,,,,,,,,,,,,,,,,,,,,,,,,,13,,,,,,,,,,,,,,,,,,,,,,,,,,,,,,,,,7,,,,,,,,,,,,,,,,,,,,,,,,,,,,,,,,,1,1.0,1.0,1.0,2.0,1.0,1.0,7.0,1.0,2.0,3.0,1.0,3.0,2.0,1.0,3.0,2.0,5.0,1.0,2.0,2.0,1.0,3.0,1.0,1.0,1.0,6.0,4.0,2.0,4.0,2.0,2.0,3.0,2,3.0,5.0,3.0,3.0,5.0,3.0,6.0,5.0,6.0,4.0,3.0,5.0,5.0,5.0,5.0,3.0,6.0,5.0,4.0,3.0,5.0,5.0,2.0,4.0,4.0,3.0,4.0,4.0,5.0,4.0,4.0,4.0,1,3.0,2.0,2.0,5.0,2.0,3.0,3.0,3.0,6.0,3.0,4.0,5.0,3.0,5.0,5.0,3.0,6.0,5.0,3.0,4.0,2.0,5.0,3.0,3.0,3.0,6.0,3.0,3.0,4.0,4.0,4.0,5.0,12,,,,,,,,,,,,,,,,,,,,,,,,,,,,,,,,,10,,,,,,,,,,,,,,,,,,,,,,,,,,,,,,,,,8,,,,,,,,,,,,,,,,,,,,,,,,,,,,,,,,,I found it very interesting what different types of visualisations there actually are and this survey gave me some insight.,559.81,10.94,,,,85.55,,51.17,,,,,,,,,,,,,,,,,,,,,,,,,,,,,83.72,,,93.01,,,128.65,,,,,,,,,,,,106.77,,APPROVED,Male,23.0,FALSE
881,2022-03-22 02:17:52,19,en,913442849,2022-03-22 02:06:57,2022-03-22 02:17:52,Y,Y,A1,,,9,,,,,,,,,,,,,,,,,,,,,,,,,,,,,,,,,1,1.0,2.0,3.0,6.0,2.0,7.0,1.0,7.0,2.0,1.0,4.0,3.0,4.0,2.0,1.0,6.0,6.0,2.0,4.0,1.0,7.0,3.0,7.0,4.0,2.0,7.0,1.0,4.0,5.0,4.0,6.0,2.0,2,5.0,6.0,6.0,6.0,5.0,7.0,1.0,7.0,6.0,5.0,5.0,6.0,7.0,2.0,5.0,7.0,7.0,5.0,7.0,5.0,4.0,6.0,6.0,7.0,7.0,7.0,1.0,6.0,7.0,6.0,7.0,3.0,11,,,,,,,,,,,,,,,,,,,,,,,,,,,,,,,,,4,,,,,,,,,,,,,,,,,,,,,,,,,,,,,,,,,8,,,,,,,,,,,,,,,,,,,,,,,,,,,,,,,,,6,,,,,,,,,,,,,,,,,,,,,,,,,,,,,,,,,7,,,,,,,,,,,,,,,,,,,,,,,,,,,,,,,,,12,,,,,,,,,,,,,,,,,,,,,,,,,,,,,,,,,10,,,,,,,,,,,,,,,,,,,,,,,,,,,,,,,,,5,,,,,,,,,,,,,,,,,,,,,,,,,,,,,,,,,13,,,,,,,,,,,,,,,,,,,,,,,,,,,,,,,,,3,,,,,,,,,,,,,,,,,,,,,,,,,,,,,,,,,14,,,,,,,,,,,,,,,,,,,,,,,,,,,,,,,,,0,5.0,6.0,5.0,5.0,1.0,4.0,6.0,5.0,6.0,2.0,2.0,7.0,5.0,5.0,5.0,6.0,6.0,5.0,4.0,5.0,4.0,2.0,1.0,6.0,2.0,4.0,3.0,6.0,6.0,5.0,4.0,1.0,,657.28,100.45,,,,15.23,,52.14,,,,,151.82,,,145.35,,,,,,,,,,,,,,,,,,,,,,,,,,,,,,,,,,,,189.11,,,3.18,,APPROVED,Male,32.0,FALSE
882,2022-03-22 02:11:25,19,en,217441269,2022-03-22 02:07:48,2022-03-22 02:11:25,Y,Y,A1,,,1,2.0,5.0,2.0,3.0,4.0,3.0,5.0,4.0,6.0,6.0,5.0,5.0,5.0,5.0,6.0,5.0,4.0,3.0,4.0,6.0,5.0,5.0,5.0,5.0,6.0,4.0,6.0,3.0,5.0,5.0,4.0,1.0,6,,,,,,,,,,,,,,,,,,,,,,,,,,,,,,,,,4,,,,,,,,,,,,,,,,,,,,,,,,,,,,,,,,,3,,,,,,,,,,,,,,,,,,,,,,,,,,,,,,,,,8,,,,,,,,,,,,,,,,,,,,,,,,,,,,,,,,,0,5.0,5.0,5.0,2.0,4.0,5.0,5.0,3.0,6.0,5.0,4.0,5.0,3.0,4.0,5.0,4.0,5.0,5.0,3.0,5.0,5.0,6.0,4.0,6.0,3.0,5.0,5.0,5.0,4.0,6.0,5.0,6.0,11,,,,,,,,,,,,,,,,,,,,,,,,,,,,,,,,,10,,,,,,,,,,,,,,,,,,,,,,,,,,,,,,,,,2,3.0,4.0,3.0,3.0,3.0,3.0,3.0,4.0,3.0,2.0,4.0,3.0,3.0,3.0,3.0,3.0,3.0,3.0,4.0,3.0,3.0,2.0,3.0,3.0,3.0,3.0,3.0,3.0,5.0,3.0,4.0,2.0,9,,,,,,,,,,,,,,,,,,,,,,,,,,,,,,,,,5,,,,,,,,,,,,,,,,,,,,,,,,,,,,,,,,,13,,,,,,,,,,,,,,,,,,,,,,,,,,,,,,,,,7,,,,,,,,,,,,,,,,,,,,,,,,,,,,,,,,,14,,,,,,,,,,,,,,,,,,,,,,,,,,,,,,,,,12,,,,,,,,,,,,,,,,,,,,,,,,,,,,,,,,,,218.8,28.0,,,,8.72,,9.58,,51.9,,,,,,,,,,,,,,,80.13,,,,,,,,,37.09,,,,,,,,,,,,,,,,,,,,,3.38,,APPROVED,Female,18.0,FALSE
883,2022-03-22 02:15:39,19,en,2028862834,2022-03-22 02:09:12,2022-03-22 02:15:39,Y,Y,A1,,,1,6.0,6.0,5.0,4.0,5.0,1.0,4.0,6.0,5.0,4.0,4.0,3.0,5.0,3.0,4.0,4.0,6.0,3.0,5.0,4.0,2.0,5.0,2.0,5.0,5.0,3.0,6.0,6.0,3.0,3.0,3.0,1.0,9,,,,,,,,,,,,,,,,,,,,,,,,,,,,,,,,,7,,,,,,,,,,,,,,,,,,,,,,,,,,,,,,,,,13,,,,,,,,,,,,,,,,,,,,,,,,,,,,,,,,,0,1.0,1.0,1.0,1.0,1.0,1.0,1.0,4.0,2.0,1.0,1.0,2.0,2.0,1.0,1.0,1.0,3.0,2.0,2.0,2.0,1.0,2.0,2.0,1.0,1.0,3.0,1.0,1.0,2.0,2.0,2.0,3.0,3,,,,,,,,,,,,,,,,,,,,,,,,,,,,,,,,,4,,,,,,,,,,,,,,,,,,,,,,,,,,,,,,,,,12,,,,,,,,,,,,,,,,,,,,,,,,,,,,,,,,,5,,,,,,,,,,,,,,,,,,,,,,,,,,,,,,,,,2,3.0,5.0,3.0,2.0,2.0,3.0,5.0,1.0,1.0,3.0,4.0,3.0,4.0,3.0,3.0,2.0,4.0,3.0,4.0,2.0,3.0,4.0,4.0,5.0,3.0,5.0,2.0,3.0,3.0,2.0,2.0,3.0,11,,,,,,,,,,,,,,,,,,,,,,,,,,,,,,,,,10,,,,,,,,,,,,,,,,,,,,,,,,,,,,,,,,,6,,,,,,,,,,,,,,,,,,,,,,,,,,,,,,,,,8,,,,,,,,,,,,,,,,,,,,,,,,,,,,,,,,,14,,,,,,,,,,,,,,,,,,,,,,,,,,,,,,,,,,389.22,61.52,,,,6.88,,42.01,,90.24,,,,,,,,,,,,85.57,,,,,,,,,,,,,,,99.29,,,,,,,,,,,,,,,,,,3.71,,APPROVED,Male,37.0,FALSE
884,2022-03-22 02:14:18,19,en,1507663986,2022-03-22 02:09:12,2022-03-22 02:14:18,Y,Y,-oth-,Highschool diploma,,9,,,,,,,,,,,,,,,,,,,,,,,,,,,,,,,,,6,,,,,,,,,,,,,,,,,,,,,,,,,,,,,,,,,5,,,,,,,,,,,,,,,,,,,,,,,,,,,,,,,,,1,6.0,7.0,5.0,5.0,7.0,6.0,3.0,5.0,6.0,5.0,3.0,5.0,6.0,6.0,5.0,5.0,7.0,5.0,6.0,5.0,6.0,5.0,6.0,6.0,6.0,3.0,2.0,5.0,5.0,6.0,7.0,4.0,11,,,,,,,,,,,,,,,,,,,,,,,,,,,,,,,,,10,,,,,,,,,,,,,,,,,,,,,,,,,,,,,,,,,3,,,,,,,,,,,,,,,,,,,,,,,,,,,,,,,,,12,,,,,,,,,,,,,,,,,,,,,,,,,,,,,,,,,4,,,,,,,,,,,,,,,,,,,,,,,,,,,,,,,,,0,5.0,5.0,3.0,2.0,5.0,3.0,6.0,7.0,5.0,5.0,6.0,6.0,3.0,3.0,5.0,6.0,6.0,3.0,2.0,5.0,3.0,3.0,2.0,5.0,5.0,3.0,2.0,5.0,5.0,5.0,3.0,3.0,13,,,,,,,,,,,,,,,,,,,,,,,,,,,,,,,,,14,,,,,,,,,,,,,,,,,,,,,,,,,,,,,,,,,2,1.0,5.0,3.0,2.0,2.0,5.0,6.0,6.0,5.0,2.0,5.0,2.0,3.0,3.0,2.0,6.0,6.0,3.0,3.0,3.0,2.0,2.0,2.0,2.0,3.0,4.0,3.0,3.0,5.0,2.0,3.0,6.0,7,,,,,,,,,,,,,,,,,,,,,,,,,,,,,,,,,8,,,,,,,,,,,,,,,,,,,,,,,,,,,,,,,,,,308.72,23.16,,,,39.08,,38.56,,,,,,,,,,,53.9,,,,,,,,,,,,,,,,,,88.79,,,,,,,,,60.91,,,,,,,,,4.32,,APPROVED,Male,21.0,FALSE
885,2022-03-22 02:14:37,19,en,545546721,2022-03-22 02:09:15,2022-03-22 02:14:37,Y,Y,A1,,,2,4.0,5.0,5.0,4.0,4.0,3.0,4.0,4.0,5.0,4.0,4.0,5.0,4.0,4.0,4.0,3.0,3.0,4.0,4.0,4.0,4.0,4.0,3.0,4.0,4.0,4.0,5.0,3.0,5.0,4.0,4.0,1.0,0,4.0,5.0,6.0,4.0,5.0,4.0,4.0,5.0,4.0,4.0,5.0,4.0,5.0,4.0,6.0,4.0,6.0,4.0,4.0,3.0,4.0,4.0,4.0,4.0,4.0,6.0,3.0,4.0,4.0,3.0,6.0,2.0,4,,,,,,,,,,,,,,,,,,,,,,,,,,,,,,,,,14,,,,,,,,,,,,,,,,,,,,,,,,,,,,,,,,,10,,,,,,,,,,,,,,,,,,,,,,,,,,,,,,,,,11,,,,,,,,,,,,,,,,,,,,,,,,,,,,,,,,,9,,,,,,,,,,,,,,,,,,,,,,,,,,,,,,,,,6,,,,,,,,,,,,,,,,,,,,,,,,,,,,,,,,,13,,,,,,,,,,,,,,,,,,,,,,,,,,,,,,,,,7,,,,,,,,,,,,,,,,,,,,,,,,,,,,,,,,,3,,,,,,,,,,,,,,,,,,,,,,,,,,,,,,,,,8,,,,,,,,,,,,,,,,,,,,,,,,,,,,,,,,,5,,,,,,,,,,,,,,,,,,,,,,,,,,,,,,,,,12,,,,,,,,,,,,,,,,,,,,,,,,,,,,,,,,,1,4.0,5.0,4.0,4.0,4.0,4.0,4.0,5.0,5.0,4.0,5.0,3.0,4.0,5.0,5.0,4.0,4.0,4.0,4.0,4.0,4.0,5.0,4.0,4.0,4.0,5.0,5.0,4.0,4.0,4.0,4.0,1.0,Thank you for the opportunity to take part. ,326.35,19.54,,,,9.65,,52.52,,60.32,,,105.86,,,,,,,,,,,,,,,,,,,,,,,,,,,,,,,,,,,,,,,60.9,,,17.56,,APPROVED,Male,32.0,FALSE
886,2022-03-22 02:13:44,19,en,577774903,2022-03-22 02:09:15,2022-03-22 02:13:44,Y,Y,A1,,,3,,,,,,,,,,,,,,,,,,,,,,,,,,,,,,,,,13,,,,,,,,,,,,,,,,,,,,,,,,,,,,,,,,,8,,,,,,,,,,,,,,,,,,,,,,,,,,,,,,,,,12,,,,,,,,,,,,,,,,,,,,,,,,,,,,,,,,,1,3.0,4.0,5.0,2.0,4.0,2.0,5.0,5.0,5.0,3.0,3.0,4.0,4.0,4.0,4.0,3.0,4.0,3.0,3.0,3.0,3.0,4.0,4.0,4.0,5.0,4.0,3.0,4.0,3.0,4.0,3.0,5.0,4,,,,,,,,,,,,,,,,,,,,,,,,,,,,,,,,,2,3.0,4.0,5.0,5.0,2.0,5.0,3.0,2.0,4.0,3.0,3.0,3.0,3.0,3.0,4.0,5.0,4.0,4.0,3.0,2.0,3.0,2.0,5.0,4.0,3.0,4.0,3.0,3.0,3.0,3.0,4.0,7.0,14,,,,,,,,,,,,,,,,,,,,,,,,,,,,,,,,,6,,,,,,,,,,,,,,,,,,,,,,,,,,,,,,,,,9,,,,,,,,,,,,,,,,,,,,,,,,,,,,,,,,,5,,,,,,,,,,,,,,,,,,,,,,,,,,,,,,,,,11,,,,,,,,,,,,,,,,,,,,,,,,,,,,,,,,,0,3.0,3.0,3.0,4.0,3.0,5.0,5.0,2.0,5.0,4.0,3.0,3.0,4.0,4.0,4.0,4.0,5.0,3.0,3.0,3.0,3.0,3.0,5.0,3.0,3.0,5.0,4.0,3.0,6.0,4.0,4.0,6.0,7,,,,,,,,,,,,,,,,,,,,,,,,,,,,,,,,,10,,,,,,,,,,,,,,,,,,,,,,,,,,,,,,,,,,271.38,11.31,,,,5.3,,25.96,,,,,,,,,,,,,,83.3,,,,,,71.53,,,,,,,,,,,,,,,,,,70.8,,,,,,,,,3.18,,APPROVED,Male,28.0,FALSE
887,2022-03-22 02:20:49,19,en,161664890,2022-03-22 02:09:19,2022-03-22 02:20:49,Y,Y,A1,,,9,,,,,,,,,,,,,,,,,,,,,,,,,,,,,,,,,6,,,,,,,,,,,,,,,,,,,,,,,,,,,,,,,,,5,,,,,,,,,,,,,,,,,,,,,,,,,,,,,,,,,7,,,,,,,,,,,,,,,,,,,,,,,,,,,,,,,,,8,,,,,,,,,,,,,,,,,,,,,,,,,,,,,,,,,13,,,,,,,,,,,,,,,,,,,,,,,,,,,,,,,,,3,,,,,,,,,,,,,,,,,,,,,,,,,,,,,,,,,10,,,,,,,,,,,,,,,,,,,,,,,,,,,,,,,,,11,,,,,,,,,,,,,,,,,,,,,,,,,,,,,,,,,14,,,,,,,,,,,,,,,,,,,,,,,,,,,,,,,,,4,,,,,,,,,,,,,,,,,,,,,,,,,,,,,,,,,12,,,,,,,,,,,,,,,,,,,,,,,,,,,,,,,,,1,4.0,5.0,5.0,5.0,4.0,2.0,6.0,5.0,6.0,4.0,6.0,3.0,6.0,2.0,5.0,5.0,4.0,2.0,6.0,2.0,4.0,6.0,6.0,4.0,4.0,6.0,2.0,4.0,4.0,5.0,3.0,6.0,0,3.0,5.0,1.0,5.0,1.0,4.0,2.0,4.0,6.0,2.0,1.0,5.0,2.0,1.0,4.0,5.0,4.0,2.0,1.0,3.0,3.0,4.0,6.0,3.0,1.0,5.0,2.0,3.0,1.0,4.0,5.0,7.0,2,5.0,6.0,6.0,7.0,4.0,7.0,2.0,7.0,6.0,4.0,5.0,6.0,5.0,4.0,4.0,7.0,6.0,4.0,5.0,4.0,4.0,4.0,7.0,5.0,4.0,6.0,1.0,5.0,5.0,5.0,4.0,1.0,,691.99,72.61,,,,6.43,,128.11,,,,,,,,,,,,,,,,,,,,,,,,,,,,,,,,,,,,,,118.09,,,244.0,,,107.7,,,15.05,,APPROVED,Female,25.0,FALSE
889,2022-03-22 02:14:51,19,en,393349398,2022-03-22 02:09:26,2022-03-22 02:14:51,Y,Y,A1,,,10,,,,,,,,,,,,,,,,,,,,,,,,,,,,,,,,,5,,,,,,,,,,,,,,,,,,,,,,,,,,,,,,,,,14,,,,,,,,,,,,,,,,,,,,,,,,,,,,,,,,,7,,,,,,,,,,,,,,,,,,,,,,,,,,,,,,,,,3,,,,,,,,,,,,,,,,,,,,,,,,,,,,,,,,,2,6.0,7.0,5.0,5.0,6.0,5.0,5.0,7.0,7.0,6.0,2.0,7.0,6.0,7.0,7.0,7.0,7.0,7.0,6.0,6.0,5.0,6.0,6.0,6.0,5.0,6.0,6.0,6.0,3.0,6.0,3.0,6.0,13,,,,,,,,,,,,,,,,,,,,,,,,,,,,,,,,,9,,,,,,,,,,,,,,,,,,,,,,,,,,,,,,,,,8,,,,,,,,,,,,,,,,,,,,,,,,,,,,,,,,,11,,,,,,,,,,,,,,,,,,,,,,,,,,,,,,,,,6,,,,,,,,,,,,,,,,,,,,,,,,,,,,,,,,,12,,,,,,,,,,,,,,,,,,,,,,,,,,,,,,,,,4,,,,,,,,,,,,,,,,,,,,,,,,,,,,,,,,,1,1.0,6.0,1.0,5.0,1.0,1.0,5.0,1.0,5.0,1.0,1.0,6.0,1.0,5.0,7.0,1.0,6.0,6.0,1.0,1.0,1.0,1.0,5.0,1.0,1.0,5.0,7.0,1.0,1.0,1.0,5.0,7.0,0,5.0,7.0,5.0,3.0,6.0,1.0,7.0,3.0,6.0,5.0,5.0,5.0,6.0,6.0,7.0,3.0,6.0,3.0,6.0,5.0,6.0,5.0,1.0,5.0,5.0,3.0,7.0,5.0,5.0,5.0,3.0,1.0,,328.76,45.25,,,,5.69,,41.85,,,,,,,,,,,,,,,,,69.47,,,,,,,,,,,,,,,,,,,,,,,,84.02,,,79.27,,,3.21,,APPROVED,Female,24.0,FALSE
890,2022-03-22 02:15:34,19,en,158013197,2022-03-22 02:09:27,2022-03-22 02:15:34,Y,Y,A1,,,4,,,,,,,,,,,,,,,,,,,,,,,,,,,,,,,,,7,,,,,,,,,,,,,,,,,,,,,,,,,,,,,,,,,6,,,,,,,,,,,,,,,,,,,,,,,,,,,,,,,,,9,,,,,,,,,,,,,,,,,,,,,,,,,,,,,,,,,14,,,,,,,,,,,,,,,,,,,,,,,,,,,,,,,,,11,,,,,,,,,,,,,,,,,,,,,,,,,,,,,,,,,1,3.0,5.0,2.0,3.0,3.0,2.0,7.0,3.0,4.0,3.0,3.0,5.0,3.0,5.0,4.0,3.0,5.0,4.0,2.0,3.0,3.0,3.0,4.0,2.0,3.0,3.0,6.0,4.0,3.0,3.0,4.0,7.0,0,6.0,2.0,6.0,6.0,4.0,3.0,6.0,5.0,6.0,5.0,5.0,6.0,5.0,6.0,6.0,5.0,5.0,6.0,5.0,5.0,5.0,6.0,3.0,5.0,6.0,3.0,3.0,6.0,5.0,4.0,4.0,1.0,5,,,,,,,,,,,,,,,,,,,,,,,,,,,,,,,,,8,,,,,,,,,,,,,,,,,,,,,,,,,,,,,,,,,2,3.0,2.0,3.0,2.0,1.0,3.0,7.0,3.0,3.0,3.0,3.0,5.0,3.0,3.0,4.0,3.0,3.0,2.0,3.0,3.0,3.0,3.0,2.0,5.0,3.0,3.0,4.0,2.0,1.0,3.0,3.0,4.0,10,,,,,,,,,,,,,,,,,,,,,,,,,,,,,,,,,13,,,,,,,,,,,,,,,,,,,,,,,,,,,,,,,,,12,,,,,,,,,,,,,,,,,,,,,,,,,,,,,,,,,3,,,,,,,,,,,,,,,,,,,,,,,,,,,,,,,,,,370.58,14.87,,,,7.26,,21.1,,,,,,,,,,,,,,,,,,,,78.81,,,103.7,,,,,,,,,142.05,,,,,,,,,,,,,,,2.79,,APPROVED,Male,21.0,FALSE
891,2022-03-22 02:14:45,19,en,1926300167,2022-03-22 02:09:28,2022-03-22 02:14:45,Y,Y,A3,,,14,,,,,,,,,,,,,,,,,,,,,,,,,,,,,,,,,11,,,,,,,,,,,,,,,,,,,,,,,,,,,,,,,,,2,3.0,2.0,3.0,3.0,3.0,2.0,4.0,6.0,4.0,3.0,3.0,3.0,4.0,3.0,3.0,4.0,4.0,3.0,3.0,3.0,3.0,3.0,5.0,3.0,3.0,5.0,3.0,3.0,3.0,3.0,2.0,3.0,10,,,,,,,,,,,,,,,,,,,,,,,,,,,,,,,,,8,,,,,,,,,,,,,,,,,,,,,,,,,,,,,,,,,13,,,,,,,,,,,,,,,,,,,,,,,,,,,,,,,,,3,,,,,,,,,,,,,,,,,,,,,,,,,,,,,,,,,1,2.0,2.0,2.0,2.0,2.0,1.0,7.0,2.0,4.0,2.0,2.0,2.0,2.0,2.0,2.0,2.0,3.0,2.0,2.0,2.0,2.0,2.0,2.0,2.0,2.0,4.0,2.0,2.0,2.0,2.0,1.0,1.0,9,,,,,,,,,,,,,,,,,,,,,,,,,,,,,,,,,5,,,,,,,,,,,,,,,,,,,,,,,,,,,,,,,,,7,,,,,,,,,,,,,,,,,,,,,,,,,,,,,,,,,6,,,,,,,,,,,,,,,,,,,,,,,,,,,,,,,,,0,6.0,7.0,6.0,5.0,6.0,4.0,4.0,5.0,6.0,6.0,3.0,7.0,6.0,6.0,6.0,5.0,6.0,6.0,6.0,6.0,4.0,6.0,4.0,6.0,6.0,5.0,5.0,6.0,6.0,6.0,5.0,6.0,12,,,,,,,,,,,,,,,,,,,,,,,,,,,,,,,,,4,,,,,,,,,,,,,,,,,,,,,,,,,,,,,,,,,,319.08,34.26,,,,6.38,,29.12,,,,,,,,73.9,,,,,,,,,,,,,,,80.19,,,,,,,,,,,,,,,92.21,,,,,,,,,3.02,,APPROVED,Female,26.0,FALSE
892,2022-03-22 02:18:56,19,en,693308404,2022-03-22 02:09:33,2022-03-22 02:18:56,Y,Y,A2,,,7,,,,,,,,,,,,,,,,,,,,,,,,,,,,,,,,,0,6.0,3.0,5.0,3.0,5.0,6.0,7.0,6.0,3.0,3.0,5.0,6.0,6.0,4.0,2.0,6.0,6.0,4.0,7.0,4.0,5.0,6.0,5.0,6.0,5.0,6.0,3.0,5.0,3.0,6.0,5.0,2.0,4,,,,,,,,,,,,,,,,,,,,,,,,,,,,,,,,,10,,,,,,,,,,,,,,,,,,,,,,,,,,,,,,,,,9,,,,,,,,,,,,,,,,,,,,,,,,,,,,,,,,,8,,,,,,,,,,,,,,,,,,,,,,,,,,,,,,,,,12,,,,,,,,,,,,,,,,,,,,,,,,,,,,,,,,,13,,,,,,,,,,,,,,,,,,,,,,,,,,,,,,,,,2,3.0,3.0,2.0,6.0,2.0,6.0,3.0,3.0,2.0,2.0,5.0,4.0,3.0,3.0,2.0,5.0,4.0,4.0,3.0,3.0,3.0,3.0,6.0,3.0,3.0,5.0,3.0,5.0,3.0,4.0,5.0,2.0,3,,,,,,,,,,,,,,,,,,,,,,,,,,,,,,,,,14,,,,,,,,,,,,,,,,,,,,,,,,,,,,,,,,,5,,,,,,,,,,,,,,,,,,,,,,,,,,,,,,,,,1,6.0,5.0,5.0,3.0,5.0,1.0,6.0,4.0,6.0,5.0,2.0,5.0,7.0,7.0,6.0,2.0,7.0,6.0,3.0,5.0,5.0,5.0,3.0,6.0,5.0,2.0,5.0,5.0,7.0,5.0,4.0,6.0,11,,,,,,,,,,,,,,,,,,,,,,,,,,,,,,,,,6,,,,,,,,,,,,,,,,,,,,,,,,,,,,,,,,,"Some of the attributes asked about are hard to project into a data visualization. Likeable? Lovely? I may feel that toward people, but toward data visualizations these adjectives seem out of place.",565.77,99.6,,,,5.26,,52.76,,,,,122.49,,,,,,,,,,,,,,,,,,,,,112.2,,,,,,,,,,,,111.03,,,,,,,,,62.43,,APPROVED,Male,34.0,FALSE
893,2022-03-22 02:16:35,19,en,963990633,2022-03-22 02:09:42,2022-03-22 02:16:35,Y,Y,A1,,,4,,,,,,,,,,,,,,,,,,,,,,,,,,,,,,,,,0,5.0,3.0,6.0,6.0,5.0,6.0,2.0,7.0,3.0,4.0,6.0,5.0,6.0,4.0,3.0,6.0,5.0,5.0,7.0,4.0,4.0,7.0,6.0,5.0,6.0,7.0,3.0,5.0,4.0,6.0,5.0,2.0,3,,,,,,,,,,,,,,,,,,,,,,,,,,,,,,,,,14,,,,,,,,,,,,,,,,,,,,,,,,,,,,,,,,,5,,,,,,,,,,,,,,,,,,,,,,,,,,,,,,,,,7,,,,,,,,,,,,,,,,,,,,,,,,,,,,,,,,,13,,,,,,,,,,,,,,,,,,,,,,,,,,,,,,,,,12,,,,,,,,,,,,,,,,,,,,,,,,,,,,,,,,,2,1.0,2.0,1.0,1.0,1.0,1.0,6.0,2.0,2.0,2.0,2.0,5.0,2.0,3.0,3.0,2.0,4.0,2.0,1.0,1.0,1.0,1.0,2.0,1.0,1.0,2.0,6.0,1.0,3.0,4.0,2.0,2.0,10,,,,,,,,,,,,,,,,,,,,,,,,,,,,,,,,,6,,,,,,,,,,,,,,,,,,,,,,,,,,,,,,,,,1,3.0,6.0,2.0,4.0,3.0,3.0,3.0,2.0,5.0,4.0,3.0,6.0,2.0,4.0,5.0,2.0,6.0,3.0,3.0,3.0,3.0,3.0,4.0,3.0,2.0,4.0,6.0,2.0,3.0,4.0,4.0,5.0,8,,,,,,,,,,,,,,,,,,,,,,,,,,,,,,,,,11,,,,,,,,,,,,,,,,,,,,,,,,,,,,,,,,,9,,,,,,,,,,,,,,,,,,,,,,,,,,,,,,,,,,417.47,76.92,,,,7.6,,30.82,,,,,92.46,,,,,,,,,,,,,,,,,,,,,95.78,,,,,,,,,110.38,,,,,,,,,,,,3.51,,APPROVED,Female,27.0,FALSE
895,2022-03-22 02:19:14,19,en,822472252,2022-03-22 02:09:49,2022-03-22 02:19:14,Y,Y,A1,,,2,3.0,5.0,2.0,2.0,3.0,1.0,6.0,3.0,5.0,3.0,2.0,5.0,3.0,4.0,5.0,2.0,5.0,3.0,5.0,2.0,3.0,3.0,1.0,4.0,2.0,3.0,2.0,3.0,3.0,3.0,2.0,1.0,5,,,,,,,,,,,,,,,,,,,,,,,,,,,,,,,,,13,,,,,,,,,,,,,,,,,,,,,,,,,,,,,,,,,3,,,,,,,,,,,,,,,,,,,,,,,,,,,,,,,,,9,,,,,,,,,,,,,,,,,,,,,,,,,,,,,,,,,10,,,,,,,,,,,,,,,,,,,,,,,,,,,,,,,,,0,1.0,4.0,2.0,3.0,3.0,2.0,5.0,4.0,4.0,2.0,2.0,5.0,3.0,3.0,3.0,2.0,5.0,1.0,1.0,1.0,2.0,3.0,2.0,2.0,2.0,2.0,2.0,1.0,2.0,1.0,3.0,7.0,6,,,,,,,,,,,,,,,,,,,,,,,,,,,,,,,,,11,,,,,,,,,,,,,,,,,,,,,,,,,,,,,,,,,4,,,,,,,,,,,,,,,,,,,,,,,,,,,,,,,,,7,,,,,,,,,,,,,,,,,,,,,,,,,,,,,,,,,1,5.0,6.0,6.0,5.0,7.0,5.0,5.0,7.0,6.0,4.0,6.0,6.0,6.0,6.0,6.0,6.0,6.0,5.0,6.0,5.0,5.0,6.0,3.0,6.0,6.0,4.0,5.0,6.0,4.0,5.0,5.0,5.0,14,,,,,,,,,,,,,,,,,,,,,,,,,,,,,,,,,12,,,,,,,,,,,,,,,,,,,,,,,,,,,,,,,,,8,,,,,,,,,,,,,,,,,,,,,,,,,,,,,,,,,No comments :) It was interesting.,567.46,51.13,,,,9.59,,43.8,,130.0,,,,,,,,,,,,,,,,,,150.19,,,,,,,,,,,,,,,159.71,,,,,,,,,,,,23.04,,APPROVED,Female,25.0,FALSE
896,2022-03-22 02:13:48,19,en,700612155,2022-03-22 02:09:51,2022-03-22 02:13:48,Y,Y,A2,,,9,,,,,,,,,,,,,,,,,,,,,,,,,,,,,,,,,11,,,,,,,,,,,,,,,,,,,,,,,,,,,,,,,,,4,,,,,,,,,,,,,,,,,,,,,,,,,,,,,,,,,14,,,,,,,,,,,,,,,,,,,,,,,,,,,,,,,,,2,3.0,5.0,5.0,5.0,4.0,5.0,6.0,6.0,5.0,5.0,4.0,5.0,4.0,4.0,5.0,5.0,2.0,4.0,4.0,4.0,4.0,5.0,5.0,2.0,3.0,5.0,4.0,4.0,4.0,5.0,5.0,5.0,8,,,,,,,,,,,,,,,,,,,,,,,,,,,,,,,,,12,,,,,,,,,,,,,,,,,,,,,,,,,,,,,,,,,10,,,,,,,,,,,,,,,,,,,,,,,,,,,,,,,,,5,,,,,,,,,,,,,,,,,,,,,,,,,,,,,,,,,1,3.0,3.0,2.0,3.0,3.0,2.0,6.0,3.0,2.0,3.0,2.0,3.0,3.0,2.0,2.0,2.0,2.0,3.0,3.0,4.0,4.0,2.0,1.0,1.0,1.0,2.0,3.0,3.0,2.0,3.0,2.0,3.0,6,,,,,,,,,,,,,,,,,,,,,,,,,,,,,,,,,13,,,,,,,,,,,,,,,,,,,,,,,,,,,,,,,,,3,,,,,,,,,,,,,,,,,,,,,,,,,,,,,,,,,0,3.0,2.0,3.0,4.0,2.0,2.0,6.0,3.0,6.0,1.0,1.0,3.0,3.0,2.0,4.0,3.0,6.0,3.0,3.0,2.0,3.0,3.0,6.0,2.0,2.0,5.0,5.0,5.0,3.0,3.0,4.0,7.0,7,,,,,,,,,,,,,,,,,,,,,,,,,,,,,,,,,,240.45,13.17,,,,14.15,,60.61,,,,,,,,,,,,,,34.69,,,,,,,,,,,,,,,53.7,,,,,,,,,,,,59.85,,,,,,4.28,,APPROVED,Male,20.0,FALSE
897,2022-03-22 02:23:31,19,en,248611270,2022-03-22 02:09:51,2022-03-22 02:23:31,Y,Y,-oth-,GCSE,,9,,,,,,,,,,,,,,,,,,,,,,,,,,,,,,,,,12,,,,,,,,,,,,,,,,,,,,,,,,,,,,,,,,,8,,,,,,,,,,,,,,,,,,,,,,,,,,,,,,,,,10,,,,,,,,,,,,,,,,,,,,,,,,,,,,,,,,,14,,,,,,,,,,,,,,,,,,,,,,,,,,,,,,,,,3,,,,,,,,,,,,,,,,,,,,,,,,,,,,,,,,,1,2.0,3.0,2.0,2.0,3.0,3.0,3.0,5.0,3.0,3.0,3.0,3.0,3.0,3.0,3.0,3.0,3.0,3.0,3.0,3.0,3.0,3.0,3.0,3.0,3.0,3.0,3.0,3.0,3.0,3.0,3.0,7.0,5,,,,,,,,,,,,,,,,,,,,,,,,,,,,,,,,,2,3.0,4.0,3.0,5.0,3.0,2.0,4.0,6.0,4.0,3.0,3.0,4.0,4.0,3.0,4.0,2.0,4.0,3.0,3.0,3.0,4.0,3.0,4.0,3.0,2.0,5.0,4.0,3.0,6.0,4.0,3.0,2.0,11,,,,,,,,,,,,,,,,,,,,,,,,,,,,,,,,,6,,,,,,,,,,,,,,,,,,,,,,,,,,,,,,,,,7,,,,,,,,,,,,,,,,,,,,,,,,,,,,,,,,,0,3.0,6.0,4.0,4.0,4.0,4.0,4.0,4.0,5.0,4.0,5.0,4.0,4.0,4.0,4.0,5.0,5.0,4.0,5.0,4.0,4.0,4.0,2.0,4.0,5.0,4.0,4.0,5.0,5.0,5.0,4.0,6.0,13,,,,,,,,,,,,,,,,,,,,,,,,,,,,,,,,,4,,,,,,,,,,,,,,,,,,,,,,,,,,,,,,,,,,823.07,482.76,,,,32.13,,31.41,,,,,,,,,,,,,,,,,,,,72.18,,,,,,122.78,,,,,,,,,,,,78.24,,,,,,,,,3.57,,APPROVED,Female,40.0,FALSE
898,2022-03-22 02:22:38,19,en,1449224744,2022-03-22 02:09:53,2022-03-22 02:22:38,Y,Y,-oth-,Some college,,13,,,,,,,,,,,,,,,,,,,,,,,,,,,,,,,,,5,,,,,,,,,,,,,,,,,,,,,,,,,,,,,,,,,14,,,,,,,,,,,,,,,,,,,,,,,,,,,,,,,,,10,,,,,,,,,,,,,,,,,,,,,,,,,,,,,,,,,1,4.0,4.0,6.0,3.0,3.0,3.0,6.0,5.0,5.0,4.0,3.0,4.0,4.0,4.0,4.0,3.0,5.0,3.0,4.0,4.0,3.0,4.0,2.0,4.0,5.0,4.0,3.0,4.0,5.0,3.0,2.0,5.0,12,,,,,,,,,,,,,,,,,,,,,,,,,,,,,,,,,3,,,,,,,,,,,,,,,,,,,,,,,,,,,,,,,,,8,,,,,,,,,,,,,,,,,,,,,,,,,,,,,,,,,0,2.0,3.0,2.0,3.0,1.0,1.0,5.0,4.0,2.0,2.0,1.0,2.0,1.0,2.0,4.0,2.0,4.0,2.0,2.0,2.0,1.0,1.0,2.0,2.0,1.0,3.0,4.0,2.0,2.0,2.0,2.0,2.0,2,1.0,2.0,2.0,2.0,2.0,2.0,6.0,4.0,2.0,1.0,2.0,3.0,2.0,3.0,3.0,1.0,4.0,2.0,2.0,2.0,1.0,2.0,2.0,3.0,1.0,3.0,3.0,1.0,2.0,3.0,1.0,3.0,11,,,,,,,,,,,,,,,,,,,,,,,,,,,,,,,,,7,,,,,,,,,,,,,,,,,,,,,,,,,,,,,,,,,4,,,,,,,,,,,,,,,,,,,,,,,,,,,,,,,,,9,,,,,,,,,,,,,,,,,,,,,,,,,,,,,,,,,6,,,,,,,,,,,,,,,,,,,,,,,,,,,,,,,,,,768.96,26.34,,,,29.53,,6.82,,,,,,,,,,,,,,39.79,,,,,,,,,,,,215.09,,,224.56,,,,,,,,,,,,,,,,,,226.83,,APPROVED,Male,26.0,FALSE
899,2022-03-22 02:14:24,19,en,657432016,2022-03-22 02:10:00,2022-03-22 02:14:24,Y,Y,A1,,,7,,,,,,,,,,,,,,,,,,,,,,,,,,,,,,,,,9,,,,,,,,,,,,,,,,,,,,,,,,,,,,,,,,,1,6.0,3.0,6.0,6.0,5.0,5.0,3.0,5.0,5.0,5.0,3.0,5.0,5.0,5.0,5.0,6.0,5.0,6.0,6.0,2.0,3.0,6.0,5.0,5.0,5.0,6.0,2.0,5.0,3.0,2.0,5.0,3.0,12,,,,,,,,,,,,,,,,,,,,,,,,,,,,,,,,,4,,,,,,,,,,,,,,,,,,,,,,,,,,,,,,,,,11,,,,,,,,,,,,,,,,,,,,,,,,,,,,,,,,,5,,,,,,,,,,,,,,,,,,,,,,,,,,,,,,,,,10,,,,,,,,,,,,,,,,,,,,,,,,,,,,,,,,,3,,,,,,,,,,,,,,,,,,,,,,,,,,,,,,,,,2,2.0,5.0,2.0,1.0,2.0,1.0,3.0,6.0,6.0,2.0,2.0,5.0,2.0,3.0,3.0,1.0,5.0,5.0,2.0,1.0,2.0,2.0,1.0,2.0,2.0,3.0,3.0,2.0,3.0,2.0,2.0,3.0,13,,,,,,,,,,,,,,,,,,,,,,,,,,,,,,,,,0,4.0,6.0,5.0,4.0,5.0,3.0,3.0,6.0,6.0,3.0,5.0,5.0,5.0,3.0,5.0,5.0,6.0,5.0,3.0,3.0,3.0,5.0,5.0,3.0,4.0,5.0,2.0,5.0,5.0,2.0,6.0,7.0,14,,,,,,,,,,,,,,,,,,,,,,,,,,,,,,,,,6,,,,,,,,,,,,,,,,,,,,,,,,,,,,,,,,,8,,,,,,,,,,,,,,,,,,,,,,,,,,,,,,,,,,268.04,31.57,,,,5.83,,33.29,,,,,,,,59.84,,,,,,,,,,,,,,,,,,,,,67.42,,,,,,64.73,,,,,,,,,,,,5.36,,APPROVED,Male,20.0,FALSE
900,2022-03-22 02:16:39,19,en,1732650163,2022-03-22 02:11:13,2022-03-22 02:16:39,Y,Y,A1,,,14,,,,,,,,,,,,,,,,,,,,,,,,,,,,,,,,,2,6.0,4.0,6.0,7.0,5.0,7.0,1.0,7.0,2.0,3.0,6.0,6.0,5.0,4.0,5.0,7.0,7.0,5.0,6.0,4.0,2.0,6.0,7.0,5.0,6.0,6.0,5.0,6.0,5.0,7.0,7.0,2.0,10,,,,,,,,,,,,,,,,,,,,,,,,,,,,,,,,,13,,,,,,,,,,,,,,,,,,,,,,,,,,,,,,,,,0,5.0,2.0,3.0,4.0,2.0,2.0,7.0,6.0,3.0,1.0,2.0,4.0,3.0,3.0,5.0,4.0,5.0,2.0,3.0,2.0,5.0,4.0,7.0,2.0,1.0,5.0,6.0,6.0,6.0,3.0,5.0,5.0,5,,,,,,,,,,,,,,,,,,,,,,,,,,,,,,,,,6,,,,,,,,,,,,,,,,,,,,,,,,,,,,,,,,,3,,,,,,,,,,,,,,,,,,,,,,,,,,,,,,,,,11,,,,,,,,,,,,,,,,,,,,,,,,,,,,,,,,,4,,,,,,,,,,,,,,,,,,,,,,,,,,,,,,,,,7,,,,,,,,,,,,,,,,,,,,,,,,,,,,,,,,,8,,,,,,,,,,,,,,,,,,,,,,,,,,,,,,,,,1,1.0,4.0,1.0,3.0,2.0,3.0,6.0,4.0,7.0,3.0,3.0,2.0,1.0,3.0,2.0,4.0,2.0,1.0,1.0,1.0,1.0,1.0,5.0,1.0,1.0,2.0,2.0,1.0,3.0,2.0,2.0,6.0,12,,,,,,,,,,,,,,,,,,,,,,,,,,,,,,,,,9,,,,,,,,,,,,,,,,,,,,,,,,,,,,,,,,,,329.64,29.4,,,,10.41,,26.42,,,,,75.03,,,,,,,,,104.32,,,,,,,,,,,,,,,,,,,,,,,,71.55,,,,,,,,,12.51,,APPROVED,Female,49.0,FALSE
901,2022-03-22 02:26:40,19,en,1727754219,2022-03-22 02:14:34,2022-03-22 02:26:40,Y,Y,A2,,,12,,,,,,,,,,,,,,,,,,,,,,,,,,,,,,,,,7,,,,,,,,,,,,,,,,,,,,,,,,,,,,,,,,,8,,,,,,,,,,,,,,,,,,,,,,,,,,,,,,,,,9,,,,,,,,,,,,,,,,,,,,,,,,,,,,,,,,,1,6.0,5.0,5.0,1.0,6.0,5.0,5.0,6.0,5.0,3.0,2.0,3.0,3.0,4.0,6.0,5.0,6.0,5.0,5.0,2.0,3.0,5.0,3.0,4.0,5.0,2.0,5.0,2.0,5.0,3.0,1.0,5.0,2,5.0,4.0,6.0,5.0,5.0,5.0,5.0,7.0,7.0,5.0,2.0,5.0,2.0,3.0,7.0,6.0,6.0,5.0,6.0,3.0,2.0,5.0,5.0,2.0,5.0,4.0,6.0,2.0,5.0,3.0,4.0,6.0,10,,,,,,,,,,,,,,,,,,,,,,,,,,,,,,,,,13,,,,,,,,,,,,,,,,,,,,,,,,,,,,,,,,,0,1.0,1.0,1.0,1.0,1.0,2.0,6.0,1.0,1.0,1.0,1.0,1.0,1.0,2.0,5.0,1.0,5.0,1.0,1.0,1.0,1.0,1.0,1.0,2.0,1.0,2.0,5.0,1.0,1.0,1.0,1.0,2.0,5,,,,,,,,,,,,,,,,,,,,,,,,,,,,,,,,,4,,,,,,,,,,,,,,,,,,,,,,,,,,,,,,,,,6,,,,,,,,,,,,,,,,,,,,,,,,,,,,,,,,,11,,,,,,,,,,,,,,,,,,,,,,,,,,,,,,,,,14,,,,,,,,,,,,,,,,,,,,,,,,,,,,,,,,,3,,,,,,,,,,,,,,,,,,,,,,,,,,,,,,,,,,729.72,93.53,,,,8.07,,105.71,,,,,,,,,,,,,,152.78,,,208.53,,,,,,,,,151.86,,,,,,,,,,,,,,,,,,,,,9.24,,APPROVED,Female,27.0,FALSE
902,2022-03-22 02:26:06,19,en,418500639,2022-03-22 02:18:47,2022-03-22 02:26:06,Y,Y,A2,,,0,5.0,4.0,4.0,4.0,4.0,3.0,4.0,5.0,7.0,6.0,5.0,5.0,4.0,4.0,5.0,4.0,6.0,5.0,5.0,5.0,4.0,5.0,5.0,5.0,6.0,5.0,5.0,6.0,6.0,5.0,5.0,1.0,11,,,,,,,,,,,,,,,,,,,,,,,,,,,,,,,,,6,,,,,,,,,,,,,,,,,,,,,,,,,,,,,,,,,8,,,,,,,,,,,,,,,,,,,,,,,,,,,,,,,,,14,,,,,,,,,,,,,,,,,,,,,,,,,,,,,,,,,2,5.0,6.0,5.0,5.0,4.0,3.0,5.0,5.0,5.0,5.0,5.0,5.0,5.0,4.0,4.0,6.0,5.0,4.0,5.0,6.0,4.0,6.0,5.0,5.0,4.0,5.0,5.0,6.0,5.0,5.0,5.0,6.0,5,,,,,,,,,,,,,,,,,,,,,,,,,,,,,,,,,10,,,,,,,,,,,,,,,,,,,,,,,,,,,,,,,,,7,,,,,,,,,,,,,,,,,,,,,,,,,,,,,,,,,13,,,,,,,,,,,,,,,,,,,,,,,,,,,,,,,,,12,,,,,,,,,,,,,,,,,,,,,,,,,,,,,,,,,3,,,,,,,,,,,,,,,,,,,,,,,,,,,,,,,,,4,,,,,,,,,,,,,,,,,,,,,,,,,,,,,,,,,1,5.0,5.0,5.0,4.0,4.0,4.0,5.0,6.0,6.0,6.0,5.0,5.0,5.0,6.0,4.0,5.0,5.0,4.0,5.0,5.0,6.0,6.0,5.0,6.0,5.0,5.0,6.0,5.0,5.0,5.0,5.0,7.0,9,,,,,,,,,,,,,,,,,,,,,,,,,,,,,,,,,,444.64,6.88,,,,6.65,,281.69,,46.77,,,,,,,,,,,,,,,57.61,,,,,,,,,,,,,,,,,,,,,,,,41.12,,,,,,3.92,,APPROVED,Male,23.0,FALSE
903,2022-03-22 02:25:32,19,en,65187338,2022-03-22 02:18:47,2022-03-22 02:25:32,Y,Y,A1,,,8,,,,,,,,,,,,,,,,,,,,,,,,,,,,,,,,,6,,,,,,,,,,,,,,,,,,,,,,,,,,,,,,,,,10,,,,,,,,,,,,,,,,,,,,,,,,,,,,,,,,,14,,,,,,,,,,,,,,,,,,,,,,,,,,,,,,,,,7,,,,,,,,,,,,,,,,,,,,,,,,,,,,,,,,,3,,,,,,,,,,,,,,,,,,,,,,,,,,,,,,,,,5,,,,,,,,,,,,,,,,,,,,,,,,,,,,,,,,,12,,,,,,,,,,,,,,,,,,,,,,,,,,,,,,,,,4,,,,,,,,,,,,,,,,,,,,,,,,,,,,,,,,,9,,,,,,,,,,,,,,,,,,,,,,,,,,,,,,,,,2,5.0,5.0,4.0,5.0,5.0,4.0,6.0,5.0,5.0,4.0,5.0,5.0,5.0,4.0,5.0,6.0,5.0,6.0,3.0,4.0,4.0,5.0,5.0,5.0,5.0,4.0,4.0,6.0,4.0,4.0,4.0,4.0,0,5.0,6.0,5.0,6.0,6.0,6.0,4.0,6.0,5.0,5.0,5.0,6.0,6.0,5.0,5.0,5.0,6.0,5.0,5.0,5.0,4.0,6.0,3.0,5.0,6.0,5.0,2.0,7.0,5.0,5.0,5.0,5.0,11,,,,,,,,,,,,,,,,,,,,,,,,,,,,,,,,,13,,,,,,,,,,,,,,,,,,,,,,,,,,,,,,,,,1,4.0,5.0,3.0,3.0,4.0,5.0,5.0,4.0,5.0,3.0,5.0,5.0,4.0,4.0,4.0,3.0,5.0,3.0,4.0,3.0,2.0,3.0,2.0,4.0,4.0,4.0,5.0,4.0,4.0,4.0,4.0,1.0,,408.08,15.49,,,,7.66,,72.56,,,,,,,,,,,,,,,,,,,,,,,,,,,,,,,,116.93,,,86.0,,,,,,,,,98.27,,,11.17,,APPROVED,Female,22.0,FALSE
904,2022-03-22 02:48:43,19,en,1474227543,2022-03-22 02:18:50,2022-03-22 02:48:43,Y,Y,A1,,,6,,,,,,,,,,,,,,,,,,,,,,,,,,,,,,,,,8,,,,,,,,,,,,,,,,,,,,,,,,,,,,,,,,,1,2.0,2.0,3.0,2.0,2.0,3.0,2.0,3.0,2.0,2.0,2.0,2.0,2.0,3.0,3.0,2.0,2.0,3.0,2.0,2.0,2.0,2.0,2.0,2.0,3.0,2.0,2.0,3.0,2.0,3.0,2.0,3.0,9,,,,,,,,,,,,,,,,,,,,,,,,,,,,,,,,,12,,,,,,,,,,,,,,,,,,,,,,,,,,,,,,,,,2,2.0,2.0,3.0,2.0,3.0,2.0,3.0,3.0,3.0,3.0,2.0,2.0,3.0,3.0,2.0,2.0,2.0,3.0,2.0,3.0,3.0,2.0,2.0,3.0,3.0,3.0,3.0,3.0,4.0,2.0,3.0,6.0,7,,,,,,,,,,,,,,,,,,,,,,,,,,,,,,,,,0,2.0,2.0,2.0,3.0,2.0,2.0,6.0,2.0,4.0,2.0,2.0,2.0,2.0,2.0,2.0,2.0,2.0,1.0,2.0,3.0,2.0,5.0,1.0,2.0,2.0,2.0,2.0,3.0,2.0,2.0,2.0,1.0,13,,,,,,,,,,,,,,,,,,,,,,,,,,,,,,,,,4,,,,,,,,,,,,,,,,,,,,,,,,,,,,,,,,,3,,,,,,,,,,,,,,,,,,,,,,,,,,,,,,,,,10,,,,,,,,,,,,,,,,,,,,,,,,,,,,,,,,,11,,,,,,,,,,,,,,,,,,,,,,,,,,,,,,,,,14,,,,,,,,,,,,,,,,,,,,,,,,,,,,,,,,,5,,,,,,,,,,,,,,,,,,,,,,,,,,,,,,,,,,1795.79,1657.51,,,,6.43,,11.73,,,,,,,,36.22,,,,,,,,,27.37,,,,,,54.15,,,,,,,,,,,,,,,,,,,,,,,,2.38,,APPROVED,Male,26.0,FALSE
905,2022-03-22 02:36:10,19,en,2141054209,2022-03-22 02:18:51,2022-03-22 02:36:10,Y,Y,A1,,,10,,,,,,,,,,,,,,,,,,,,,,,,,,,,,,,,,2,5.0,4.0,5.0,6.0,5.0,6.0,2.0,6.0,4.0,5.0,5.0,4.0,4.0,4.0,4.0,6.0,5.0,4.0,5.0,4.0,4.0,4.0,6.0,5.0,5.0,6.0,2.0,5.0,4.0,5.0,6.0,2.0,0,4.0,6.0,5.0,3.0,5.0,2.0,6.0,5.0,5.0,3.0,4.0,5.0,5.0,6.0,5.0,5.0,5.0,3.0,5.0,5.0,4.0,5.0,4.0,3.0,5.0,4.0,5.0,5.0,5.0,5.0,3.0,3.0,5,,,,,,,,,,,,,,,,,,,,,,,,,,,,,,,,,9,,,,,,,,,,,,,,,,,,,,,,,,,,,,,,,,,3,,,,,,,,,,,,,,,,,,,,,,,,,,,,,,,,,4,,,,,,,,,,,,,,,,,,,,,,,,,,,,,,,,,8,,,,,,,,,,,,,,,,,,,,,,,,,,,,,,,,,13,,,,,,,,,,,,,,,,,,,,,,,,,,,,,,,,,1,2.0,4.0,2.0,2.0,3.0,3.0,7.0,6.0,5.0,2.0,2.0,4.0,2.0,5.0,4.0,2.0,4.0,1.0,3.0,3.0,2.0,3.0,4.0,1.0,2.0,4.0,5.0,2.0,4.0,3.0,2.0,3.0,7,,,,,,,,,,,,,,,,,,,,,,,,,,,,,,,,,14,,,,,,,,,,,,,,,,,,,,,,,,,,,,,,,,,11,,,,,,,,,,,,,,,,,,,,,,,,,,,,,,,,,6,,,,,,,,,,,,,,,,,,,,,,,,,,,,,,,,,12,,,,,,,,,,,,,,,,,,,,,,,,,,,,,,,,,,1042.38,47.43,,,,24.54,,605.91,,,,,84.0,,,59.07,,,,,,,,,,,,,,,,,,,,,219.29,,,,,,,,,,,,,,,,,,2.14,,APPROVED,Male,23.0,FALSE
906,2022-03-22 02:23:26,19,en,1651973180,2022-03-22 02:18:54,2022-03-22 02:23:26,Y,Y,A1,,,6,,,,,,,,,,,,,,,,,,,,,,,,,,,,,,,,,2,5.0,5.0,5.0,5.0,4.0,5.0,3.0,7.0,3.0,5.0,5.0,5.0,5.0,3.0,4.0,7.0,5.0,6.0,5.0,5.0,5.0,6.0,5.0,5.0,4.0,5.0,2.0,5.0,5.0,4.0,5.0,2.0,4,,,,,,,,,,,,,,,,,,,,,,,,,,,,,,,,,12,,,,,,,,,,,,,,,,,,,,,,,,,,,,,,,,,10,,,,,,,,,,,,,,,,,,,,,,,,,,,,,,,,,1,4.0,5.0,3.0,3.0,4.0,1.0,5.0,4.0,6.0,3.0,3.0,3.0,3.0,4.0,5.0,3.0,5.0,2.0,3.0,3.0,3.0,3.0,3.0,2.0,2.0,3.0,4.0,3.0,3.0,3.0,4.0,6.0,8,,,,,,,,,,,,,,,,,,,,,,,,,,,,,,,,,5,,,,,,,,,,,,,,,,,,,,,,,,,,,,,,,,,7,,,,,,,,,,,,,,,,,,,,,,,,,,,,,,,,,11,,,,,,,,,,,,,,,,,,,,,,,,,,,,,,,,,3,,,,,,,,,,,,,,,,,,,,,,,,,,,,,,,,,13,,,,,,,,,,,,,,,,,,,,,,,,,,,,,,,,,0,7.0,3.0,6.0,5.0,7.0,6.0,2.0,5.0,3.0,7.0,6.0,6.0,7.0,4.0,7.0,6.0,5.0,7.0,6.0,6.0,5.0,6.0,5.0,6.0,6.0,7.0,2.0,7.0,7.0,7.0,6.0,6.0,9,,,,,,,,,,,,,,,,,,,,,,,,,,,,,,,,,14,,,,,,,,,,,,,,,,,,,,,,,,,,,,,,,,,,274.86,42.39,,,,5.9,,24.36,,,,,47.36,,,,,,,,,,,,93.19,,,,,,,,,,,,,,,,,,,,,59.22,,,,,,,,,2.44,,APPROVED,Female,35.0,FALSE
907,2022-03-22 02:33:14,19,en,1281709191,2022-03-22 02:18:55,2022-03-22 02:33:14,Y,Y,A2,,,1,6.0,5.0,7.0,4.0,7.0,6.0,4.0,5.0,7.0,7.0,5.0,5.0,6.0,4.0,7.0,5.0,6.0,7.0,6.0,6.0,5.0,6.0,5.0,7.0,7.0,5.0,5.0,5.0,7.0,6.0,6.0,1.0,12,,,,,,,,,,,,,,,,,,,,,,,,,,,,,,,,,13,,,,,,,,,,,,,,,,,,,,,,,,,,,,,,,,,14,,,,,,,,,,,,,,,,,,,,,,,,,,,,,,,,,2,4.0,1.0,4.0,3.0,2.0,6.0,2.0,3.0,3.0,5.0,2.0,1.0,2.0,1.0,3.0,2.0,2.0,5.0,3.0,3.0,2.0,4.0,4.0,2.0,4.0,3.0,1.0,3.0,3.0,1.0,4.0,5.0,0,4.0,6.0,4.0,3.0,6.0,5.0,2.0,5.0,7.0,5.0,5.0,5.0,4.0,6.0,5.0,4.0,5.0,6.0,6.0,6.0,4.0,6.0,5.0,6.0,7.0,5.0,3.0,5.0,7.0,2.0,6.0,6.0,11,,,,,,,,,,,,,,,,,,,,,,,,,,,,,,,,,5,,,,,,,,,,,,,,,,,,,,,,,,,,,,,,,,,6,,,,,,,,,,,,,,,,,,,,,,,,,,,,,,,,,7,,,,,,,,,,,,,,,,,,,,,,,,,,,,,,,,,9,,,,,,,,,,,,,,,,,,,,,,,,,,,,,,,,,3,,,,,,,,,,,,,,,,,,,,,,,,,,,,,,,,,8,,,,,,,,,,,,,,,,,,,,,,,,,,,,,,,,,4,,,,,,,,,,,,,,,,,,,,,,,,,,,,,,,,,10,,,,,,,,,,,,,,,,,,,,,,,,,,,,,,,,,,862.89,136.21,,,,9.85,,59.1,,135.27,,,,,,,,,,,,166.46,,,345.47,,,,,,,,,,,,,,,,,,,,,,,,,,,,,,10.53,,APPROVED,Female,33.0,FALSE
908,2022-03-22 02:28:21,19,en,1622622007,2022-03-22 02:18:56,2022-03-22 02:28:21,Y,Y,A1,,,5,,,,,,,,,,,,,,,,,,,,,,,,,,,,,,,,,1,4.0,1.0,4.0,7.0,5.0,5.0,3.0,7.0,4.0,5.0,5.0,5.0,4.0,4.0,4.0,5.0,4.0,4.0,6.0,4.0,2.0,5.0,6.0,4.0,4.0,6.0,2.0,4.0,3.0,5.0,6.0,2.0,8,,,,,,,,,,,,,,,,,,,,,,,,,,,,,,,,,0,6.0,7.0,6.0,1.0,6.0,2.0,5.0,6.0,6.0,4.0,6.0,4.0,5.0,3.0,5.0,3.0,6.0,6.0,6.0,3.0,2.0,7.0,4.0,4.0,6.0,6.0,6.0,4.0,6.0,6.0,6.0,4.0,10,,,,,,,,,,,,,,,,,,,,,,,,,,,,,,,,,3,,,,,,,,,,,,,,,,,,,,,,,,,,,,,,,,,14,,,,,,,,,,,,,,,,,,,,,,,,,,,,,,,,,9,,,,,,,,,,,,,,,,,,,,,,,,,,,,,,,,,12,,,,,,,,,,,,,,,,,,,,,,,,,,,,,,,,,2,1.0,3.0,1.0,1.0,1.0,1.0,7.0,1.0,5.0,3.0,1.0,1.0,1.0,1.0,1.0,1.0,4.0,1.0,1.0,3.0,1.0,1.0,1.0,1.0,1.0,3.0,4.0,1.0,5.0,2.0,1.0,3.0,4,,,,,,,,,,,,,,,,,,,,,,,,,,,,,,,,,6,,,,,,,,,,,,,,,,,,,,,,,,,,,,,,,,,11,,,,,,,,,,,,,,,,,,,,,,,,,,,,,,,,,7,,,,,,,,,,,,,,,,,,,,,,,,,,,,,,,,,13,,,,,,,,,,,,,,,,,,,,,,,,,,,,,,,,,Thanks for the study. Everything worked fine.,568.4,144.75,,,,10.26,,48.82,,,,,99.32,,,,,,131.04,,,,,,,,,,,,,,,,,,93.82,,,,,,,,,,,,,,,,,,40.39,,APPROVED,Male,25.0,FALSE
909,2022-03-22 02:22:34,19,en,1176349156,2022-03-22 02:18:57,2022-03-22 02:22:34,Y,Y,A1,,,6,,,,,,,,,,,,,,,,,,,,,,,,,,,,,,,,,1,4.0,4.0,5.0,6.0,5.0,6.0,3.0,5.0,5.0,4.0,5.0,6.0,6.0,4.0,5.0,5.0,5.0,5.0,6.0,4.0,5.0,5.0,5.0,5.0,5.0,5.0,4.0,6.0,5.0,5.0,6.0,2.0,4,,,,,,,,,,,,,,,,,,,,,,,,,,,,,,,,,5,,,,,,,,,,,,,,,,,,,,,,,,,,,,,,,,,9,,,,,,,,,,,,,,,,,,,,,,,,,,,,,,,,,13,,,,,,,,,,,,,,,,,,,,,,,,,,,,,,,,,10,,,,,,,,,,,,,,,,,,,,,,,,,,,,,,,,,0,5.0,4.0,6.0,3.0,4.0,4.0,6.0,3.0,6.0,6.0,3.0,3.0,6.0,6.0,5.0,3.0,6.0,3.0,5.0,6.0,3.0,6.0,5.0,6.0,6.0,4.0,6.0,6.0,4.0,4.0,5.0,1.0,8,,,,,,,,,,,,,,,,,,,,,,,,,,,,,,,,,7,,,,,,,,,,,,,,,,,,,,,,,,,,,,,,,,,2,5.0,5.0,3.0,3.0,4.0,2.0,6.0,4.0,6.0,4.0,4.0,3.0,4.0,3.0,4.0,3.0,3.0,2.0,5.0,3.0,4.0,3.0,5.0,3.0,4.0,3.0,3.0,3.0,3.0,2.0,4.0,4.0,11,,,,,,,,,,,,,,,,,,,,,,,,,,,,,,,,,12,,,,,,,,,,,,,,,,,,,,,,,,,,,,,,,,,14,,,,,,,,,,,,,,,,,,,,,,,,,,,,,,,,,3,,,,,,,,,,,,,,,,,,,,,,,,,,,,,,,,,,220.77,16.37,,,,12.43,,15.67,,,,,53.32,,,,,,,,,,,,,,,,,,69.49,,,,,,,,,48.87,,,,,,,,,,,,,,,4.62,,APPROVED,Male,38.0,FALSE
910,2022-03-22 02:29:59,19,en,1100217205,2022-03-22 02:18:57,2022-03-22 02:29:59,Y,Y,A2,,,6,,,,,,,,,,,,,,,,,,,,,,,,,,,,,,,,,3,,,,,,,,,,,,,,,,,,,,,,,,,,,,,,,,,0,5.0,6.0,6.0,3.0,5.0,3.0,5.0,5.0,5.0,6.0,6.0,3.0,5.0,3.0,5.0,3.0,5.0,5.0,6.0,5.0,4.0,6.0,2.0,5.0,5.0,1.0,1.0,5.0,6.0,5.0,5.0,3.0,4,,,,,,,,,,,,,,,,,,,,,,,,,,,,,,,,,5,,,,,,,,,,,,,,,,,,,,,,,,,,,,,,,,,1,3.0,1.0,3.0,2.0,1.0,2.0,3.0,6.0,3.0,3.0,2.0,2.0,2.0,2.0,3.0,3.0,1.0,1.0,3.0,3.0,3.0,2.0,2.0,2.0,3.0,2.0,5.0,2.0,3.0,2.0,1.0,6.0,8,,,,,,,,,,,,,,,,,,,,,,,,,,,,,,,,,10,,,,,,,,,,,,,,,,,,,,,,,,,,,,,,,,,2,2.0,2.0,2.0,2.0,2.0,1.0,3.0,1.0,1.0,3.0,1.0,1.0,1.0,1.0,1.0,1.0,1.0,1.0,2.0,1.0,1.0,2.0,1.0,1.0,1.0,1.0,1.0,2.0,1.0,2.0,1.0,2.0,9,,,,,,,,,,,,,,,,,,,,,,,,,,,,,,,,,7,,,,,,,,,,,,,,,,,,,,,,,,,,,,,,,,,12,,,,,,,,,,,,,,,,,,,,,,,,,,,,,,,,,13,,,,,,,,,,,,,,,,,,,,,,,,,,,,,,,,,14,,,,,,,,,,,,,,,,,,,,,,,,,,,,,,,,,11,,,,,,,,,,,,,,,,,,,,,,,,,,,,,,,,,,186.67,15.57,,,,3.2,,28.17,,,,,,,,64.57,,,,,,,,,40.38,,,,,,,,,30.97,,,,,,,,,,,,,,,,,,,,,3.81,,APPROVED,Female,28.0,FALSE
911,2022-03-22 02:41:16,19,en,738012659,2022-03-22 02:18:58,2022-03-22 02:41:16,Y,Y,A2,,,14,,,,,,,,,,,,,,,,,,,,,,,,,,,,,,,,,10,,,,,,,,,,,,,,,,,,,,,,,,,,,,,,,,,13,,,,,,,,,,,,,,,,,,,,,,,,,,,,,,,,,7,,,,,,,,,,,,,,,,,,,,,,,,,,,,,,,,,0,2.0,4.0,4.0,2.0,2.0,1.0,5.0,3.0,5.0,2.0,2.0,5.0,5.0,1.0,2.0,3.0,3.0,4.0,5.0,3.0,3.0,2.0,1.0,1.0,2.0,3.0,3.0,3.0,2.0,5.0,2.0,5.0,6,,,,,,,,,,,,,,,,,,,,,,,,,,,,,,,,,12,,,,,,,,,,,,,,,,,,,,,,,,,,,,,,,,,11,,,,,,,,,,,,,,,,,,,,,,,,,,,,,,,,,5,,,,,,,,,,,,,,,,,,,,,,,,,,,,,,,,,2,5.0,6.0,6.0,5.0,3.0,2.0,5.0,3.0,6.0,4.0,5.0,5.0,5.0,6.0,3.0,4.0,5.0,6.0,6.0,2.0,2.0,5.0,1.0,2.0,3.0,5.0,6.0,6.0,5.0,4.0,4.0,3.0,3,,,,,,,,,,,,,,,,,,,,,,,,,,,,,,,,,1,5.0,6.0,4.0,5.0,4.0,2.0,4.0,5.0,6.0,3.0,3.0,5.0,6.0,5.0,5.0,3.0,3.0,4.0,4.0,4.0,4.0,7.0,1.0,5.0,4.0,4.0,6.0,3.0,3.0,2.0,5.0,5.0,9,,,,,,,,,,,,,,,,,,,,,,,,,,,,,,,,,4,,,,,,,,,,,,,,,,,,,,,,,,,,,,,,,,,8,,,,,,,,,,,,,,,,,,,,,,,,,,,,,,,,,,1341.58,122.0,,,,4.88,,508.37,,,,,,,,,,,,,,168.81,,,,,,,,,,,,,,,218.81,,,,,,313.89,,,,,,,,,,,,4.82,,APPROVED,Male,52.0,FALSE
912,2022-03-22 02:24:16,19,en,1111219621,2022-03-22 02:18:58,2022-03-22 02:24:16,Y,Y,A1,,,5,,,,,,,,,,,,,,,,,,,,,,,,,,,,,,,,,11,,,,,,,,,,,,,,,,,,,,,,,,,,,,,,,,,12,,,,,,,,,,,,,,,,,,,,,,,,,,,,,,,,,1,2.0,4.0,4.0,3.0,3.0,2.0,6.0,2.0,4.0,2.0,3.0,3.0,2.0,3.0,4.0,3.0,4.0,2.0,2.0,2.0,2.0,2.0,2.0,2.0,3.0,2.0,3.0,2.0,3.0,2.0,3.0,4.0,9,,,,,,,,,,,,,,,,,,,,,,,,,,,,,,,,,8,,,,,,,,,,,,,,,,,,,,,,,,,,,,,,,,,0,1.0,3.0,2.0,2.0,2.0,2.0,6.0,6.0,4.0,1.0,1.0,3.0,2.0,2.0,3.0,2.0,5.0,2.0,1.0,1.0,2.0,1.0,2.0,2.0,1.0,2.0,3.0,2.0,2.0,2.0,2.0,7.0,10,,,,,,,,,,,,,,,,,,,,,,,,,,,,,,,,,14,,,,,,,,,,,,,,,,,,,,,,,,,,,,,,,,,6,,,,,,,,,,,,,,,,,,,,,,,,,,,,,,,,,4,,,,,,,,,,,,,,,,,,,,,,,,,,,,,,,,,3,,,,,,,,,,,,,,,,,,,,,,,,,,,,,,,,,13,,,,,,,,,,,,,,,,,,,,,,,,,,,,,,,,,7,,,,,,,,,,,,,,,,,,,,,,,,,,,,,,,,,2,2.0,5.0,2.0,2.0,2.0,2.0,6.0,5.0,5.0,1.0,3.0,2.0,2.0,2.0,3.0,2.0,3.0,1.0,2.0,1.0,2.0,2.0,1.0,2.0,2.0,5.0,2.0,1.0,2.0,3.0,3.0,1.0,,319.26,32.47,,,,5.35,,18.75,,,,,,,,,,,77.0,,,,,,,,,98.22,,,,,,,,,,,,,,,,,,,,,,,,85.37,,,2.1,,APPROVED,Female,33.0,FALSE
913,2022-03-22 02:26:25,19,en,928860227,2022-03-22 02:18:59,2022-03-22 02:26:24,Y,Y,A1,,,12,,,,,,,,,,,,,,,,,,,,,,,,,,,,,,,,,11,,,,,,,,,,,,,,,,,,,,,,,,,,,,,,,,,8,,,,,,,,,,,,,,,,,,,,,,,,,,,,,,,,,0,7.0,7.0,6.0,5.0,6.0,5.0,5.0,4.0,7.0,5.0,6.0,7.0,6.0,6.0,7.0,6.0,7.0,4.0,5.0,6.0,5.0,6.0,6.0,6.0,6.0,6.0,6.0,6.0,7.0,6.0,6.0,4.0,5,,,,,,,,,,,,,,,,,,,,,,,,,,,,,,,,,13,,,,,,,,,,,,,,,,,,,,,,,,,,,,,,,,,4,,,,,,,,,,,,,,,,,,,,,,,,,,,,,,,,,2,5.0,5.0,5.0,5.0,4.0,4.0,6.0,5.0,4.0,4.0,3.0,5.0,5.0,4.0,4.0,5.0,5.0,5.0,5.0,4.0,4.0,4.0,5.0,5.0,4.0,3.0,4.0,5.0,3.0,5.0,4.0,1.0,9,,,,,,,,,,,,,,,,,,,,,,,,,,,,,,,,,10,,,,,,,,,,,,,,,,,,,,,,,,,,,,,,,,,1,3.0,4.0,2.0,2.0,4.0,4.0,6.0,4.0,4.0,3.0,3.0,3.0,3.0,4.0,3.0,3.0,3.0,3.0,3.0,4.0,4.0,3.0,4.0,3.0,2.0,3.0,3.0,3.0,3.0,4.0,3.0,4.0,14,,,,,,,,,,,,,,,,,,,,,,,,,,,,,,,,,3,,,,,,,,,,,,,,,,,,,,,,,,,,,,,,,,,6,,,,,,,,,,,,,,,,,,,,,,,,,,,,,,,,,7,,,,,,,,,,,,,,,,,,,,,,,,,,,,,,,,,,447.82,18.16,,,,12.18,,65.78,,,,,,,,,,,103.12,,,,,,,,,,,,122.98,,,,,,,,,120.6,,,,,,,,,,,,,,,5.0,,APPROVED,Male,38.0,FALSE
914,2022-03-22 02:25:31,19,en,1637767198,2022-03-22 02:18:59,2022-03-22 02:25:31,Y,Y,A1,,,10,,,,,,,,,,,,,,,,,,,,,,,,,,,,,,,,,8,,,,,,,,,,,,,,,,,,,,,,,,,,,,,,,,,3,,,,,,,,,,,,,,,,,,,,,,,,,,,,,,,,,6,,,,,,,,,,,,,,,,,,,,,,,,,,,,,,,,,1,4.0,4.0,5.0,4.0,5.0,5.0,4.0,6.0,5.0,4.0,4.0,5.0,5.0,4.0,6.0,5.0,5.0,5.0,4.0,5.0,3.0,5.0,4.0,5.0,5.0,6.0,3.0,5.0,6.0,4.0,5.0,5.0,13,,,,,,,,,,,,,,,,,,,,,,,,,,,,,,,,,7,,,,,,,,,,,,,,,,,,,,,,,,,,,,,,,,,9,,,,,,,,,,,,,,,,,,,,,,,,,,,,,,,,,11,,,,,,,,,,,,,,,,,,,,,,,,,,,,,,,,,0,4.0,6.0,4.0,3.0,5.0,3.0,7.0,2.0,6.0,4.0,4.0,3.0,4.0,2.0,6.0,5.0,4.0,4.0,3.0,4.0,3.0,4.0,3.0,4.0,6.0,3.0,5.0,4.0,6.0,4.0,4.0,3.0,14,,,,,,,,,,,,,,,,,,,,,,,,,,,,,,,,,4,,,,,,,,,,,,,,,,,,,,,,,,,,,,,,,,,2,4.0,6.0,6.0,3.0,6.0,3.0,5.0,4.0,5.0,6.0,6.0,3.0,4.0,2.0,6.0,3.0,5.0,3.0,4.0,5.0,3.0,4.0,2.0,4.0,6.0,4.0,2.0,6.0,5.0,3.0,4.0,6.0,5,,,,,,,,,,,,,,,,,,,,,,,,,,,,,,,,,12,,,,,,,,,,,,,,,,,,,,,,,,,,,,,,,,,,396.63,26.42,,,,8.91,,36.34,,,,,,,,,,,,,,100.49,,,,,,,,,,,,,,,116.72,,,,,,,,,99.95,,,,,,,,,7.8,,APPROVED,Male,30.0,FALSE
915,2022-03-22 02:24:26,19,en,1941213499,2022-03-22 02:18:59,2022-03-22 02:24:26,Y,Y,-oth-,Some Highschool ,,8,,,,,,,,,,,,,,,,,,,,,,,,,,,,,,,,,4,,,,,,,,,,,,,,,,,,,,,,,,,,,,,,,,,7,,,,,,,,,,,,,,,,,,,,,,,,,,,,,,,,,3,,,,,,,,,,,,,,,,,,,,,,,,,,,,,,,,,10,,,,,,,,,,,,,,,,,,,,,,,,,,,,,,,,,1,5.0,5.0,5.0,5.0,5.0,6.0,3.0,6.0,6.0,5.0,3.0,5.0,5.0,4.0,7.0,4.0,6.0,5.0,4.0,4.0,4.0,6.0,4.0,5.0,5.0,5.0,5.0,6.0,5.0,4.0,5.0,6.0,13,,,,,,,,,,,,,,,,,,,,,,,,,,,,,,,,,6,,,,,,,,,,,,,,,,,,,,,,,,,,,,,,,,,9,,,,,,,,,,,,,,,,,,,,,,,,,,,,,,,,,14,,,,,,,,,,,,,,,,,,,,,,,,,,,,,,,,,11,,,,,,,,,,,,,,,,,,,,,,,,,,,,,,,,,12,,,,,,,,,,,,,,,,,,,,,,,,,,,,,,,,,5,,,,,,,,,,,,,,,,,,,,,,,,,,,,,,,,,2,3.0,6.0,3.0,4.0,3.0,6.0,2.0,5.0,5.0,3.0,4.0,5.0,3.0,3.0,5.0,6.0,6.0,2.0,3.0,2.0,2.0,1.0,6.0,3.0,3.0,7.0,6.0,2.0,7.0,4.0,7.0,7.0,0,3.0,2.0,2.0,4.0,3.0,6.0,5.0,4.0,5.0,2.0,3.0,3.0,2.0,2.0,4.0,4.0,5.0,2.0,4.0,4.0,2.0,3.0,3.0,2.0,3.0,5.0,5.0,2.0,4.0,4.0,4.0,1.0,,330.31,38.78,,,,12.61,,24.95,,,,,,,,,,,,,,,,,97.42,,,,,,,,,,,,,,,,,,,,,,,,68.91,,,82.04,,,5.6,,APPROVED,Male,21.0,FALSE
916,2022-03-22 02:26:05,19,en,1837990847,2022-03-22 02:19:00,2022-03-22 02:26:05,Y,Y,-oth-,High school,,5,,,,,,,,,,,,,,,,,,,,,,,,,,,,,,,,,4,,,,,,,,,,,,,,,,,,,,,,,,,,,,,,,,,7,,,,,,,,,,,,,,,,,,,,,,,,,,,,,,,,,2,6.0,5.0,5.0,5.0,6.0,3.0,6.0,5.0,5.0,6.0,6.0,6.0,6.0,6.0,5.0,5.0,5.0,6.0,5.0,5.0,4.0,6.0,4.0,6.0,6.0,5.0,4.0,6.0,5.0,5.0,5.0,4.0,0,2.0,2.0,4.0,2.0,2.0,4.0,6.0,4.0,5.0,1.0,3.0,5.0,2.0,5.0,4.0,2.0,5.0,2.0,3.0,1.0,3.0,5.0,3.0,2.0,5.0,6.0,4.0,1.0,6.0,4.0,4.0,5.0,3,,,,,,,,,,,,,,,,,,,,,,,,,,,,,,,,,9,,,,,,,,,,,,,,,,,,,,,,,,,,,,,,,,,11,,,,,,,,,,,,,,,,,,,,,,,,,,,,,,,,,12,,,,,,,,,,,,,,,,,,,,,,,,,,,,,,,,,8,,,,,,,,,,,,,,,,,,,,,,,,,,,,,,,,,1,4.0,5.0,5.0,1.0,4.0,2.0,5.0,1.0,5.0,4.0,2.0,5.0,4.0,5.0,4.0,2.0,4.0,4.0,3.0,2.0,1.0,3.0,1.0,4.0,4.0,1.0,4.0,5.0,1.0,3.0,2.0,4.0,14,,,,,,,,,,,,,,,,,,,,,,,,,,,,,,,,,13,,,,,,,,,,,,,,,,,,,,,,,,,,,,,,,,,6,,,,,,,,,,,,,,,,,,,,,,,,,,,,,,,,,10,,,,,,,,,,,,,,,,,,,,,,,,,,,,,,,,,,426.58,62.96,,,,16.56,,40.23,,,,,,,,,,,77.62,,,117.1,,,,,,,,,,,,,,,,,,105.04,,,,,,,,,,,,,,,7.07,,APPROVED,Male,27.0,FALSE
918,2022-03-22 02:26:27,19,en,249090216,2022-03-22 02:19:01,2022-03-22 02:26:27,Y,Y,A2,,,14,,,,,,,,,,,,,,,,,,,,,,,,,,,,,,,,,0,7.0,6.0,6.0,6.0,5.0,7.0,2.0,7.0,5.0,4.0,6.0,5.0,5.0,4.0,5.0,5.0,5.0,5.0,6.0,5.0,5.0,6.0,7.0,6.0,7.0,6.0,1.0,5.0,6.0,1.0,7.0,2.0,6,,,,,,,,,,,,,,,,,,,,,,,,,,,,,,,,,7,,,,,,,,,,,,,,,,,,,,,,,,,,,,,,,,,10,,,,,,,,,,,,,,,,,,,,,,,,,,,,,,,,,5,,,,,,,,,,,,,,,,,,,,,,,,,,,,,,,,,12,,,,,,,,,,,,,,,,,,,,,,,,,,,,,,,,,4,,,,,,,,,,,,,,,,,,,,,,,,,,,,,,,,,2,4.0,2.0,5.0,4.0,2.0,1.0,6.0,1.0,4.0,1.0,1.0,5.0,1.0,3.0,1.0,3.0,2.0,2.0,5.0,1.0,1.0,3.0,5.0,3.0,3.0,3.0,3.0,2.0,3.0,2.0,4.0,2.0,13,,,,,,,,,,,,,,,,,,,,,,,,,,,,,,,,,11,,,,,,,,,,,,,,,,,,,,,,,,,,,,,,,,,1,7.0,7.0,7.0,7.0,7.0,7.0,2.0,7.0,7.0,7.0,7.0,7.0,6.0,7.0,7.0,7.0,7.0,7.0,6.0,7.0,7.0,7.0,6.0,7.0,7.0,7.0,5.0,7.0,7.0,5.0,6.0,5.0,3,,,,,,,,,,,,,,,,,,,,,,,,,,,,,,,,,9,,,,,,,,,,,,,,,,,,,,,,,,,,,,,,,,,8,,,,,,,,,,,,,,,,,,,,,,,,,,,,,,,,,,448.56,73.36,,,,7.21,,98.12,,,,,126.01,,,,,,,,,,,,,,,,,,,,,76.9,,,,,,,,,63.25,,,,,,,,,,,,3.71,,APPROVED,Male,21.0,FALSE
919,2022-03-22 02:23:23,19,en,1352182419,2022-03-22 02:19:03,2022-03-22 02:23:23,Y,Y,A2,,,2,5.0,7.0,7.0,1.0,6.0,1.0,3.0,6.0,7.0,2.0,4.0,6.0,6.0,3.0,3.0,5.0,7.0,6.0,6.0,1.0,5.0,2.0,3.0,5.0,1.0,1.0,6.0,5.0,7.0,3.0,7.0,1.0,11,,,,,,,,,,,,,,,,,,,,,,,,,,,,,,,,,9,,,,,,,,,,,,,,,,,,,,,,,,,,,,,,,,,7,,,,,,,,,,,,,,,,,,,,,,,,,,,,,,,,,10,,,,,,,,,,,,,,,,,,,,,,,,,,,,,,,,,3,,,,,,,,,,,,,,,,,,,,,,,,,,,,,,,,,5,,,,,,,,,,,,,,,,,,,,,,,,,,,,,,,,,4,,,,,,,,,,,,,,,,,,,,,,,,,,,,,,,,,12,,,,,,,,,,,,,,,,,,,,,,,,,,,,,,,,,14,,,,,,,,,,,,,,,,,,,,,,,,,,,,,,,,,1,1.0,5.0,1.0,2.0,2.0,1.0,3.0,6.0,1.0,5.0,3.0,1.0,3.0,1.0,1.0,1.0,1.0,1.0,1.0,1.0,1.0,2.0,1.0,1.0,1.0,7.0,1.0,1.0,7.0,1.0,1.0,4.0,8,,,,,,,,,,,,,,,,,,,,,,,,,,,,,,,,,6,,,,,,,,,,,,,,,,,,,,,,,,,,,,,,,,,0,1.0,1.0,1.0,5.0,2.0,3.0,2.0,5.0,3.0,2.0,1.0,1.0,1.0,1.0,2.0,5.0,5.0,1.0,3.0,1.0,1.0,3.0,5.0,1.0,2.0,5.0,1.0,1.0,5.0,3.0,6.0,7.0,13,,,,,,,,,,,,,,,,,,,,,,,,,,,,,,,,,,264.21,14.9,,,,9.41,,46.26,,62.89,,,,,,,,,,,,,,,,,,,,,,,,,,,,,,66.01,,,,,,,,,60.93,,,,,,3.81,,APPROVED,Female,24.0,FALSE
920,2022-03-22 02:22:18,19,en,1119714754,2022-03-22 02:19:04,2022-03-22 02:22:18,Y,Y,A1,,,6,,,,,,,,,,,,,,,,,,,,,,,,,,,,,,,,,12,,,,,,,,,,,,,,,,,,,,,,,,,,,,,,,,,3,,,,,,,,,,,,,,,,,,,,,,,,,,,,,,,,,5,,,,,,,,,,,,,,,,,,,,,,,,,,,,,,,,,2,4.0,4.0,4.0,4.0,4.0,4.0,4.0,4.0,4.0,4.0,4.0,4.0,4.0,3.0,5.0,4.0,3.0,4.0,4.0,4.0,3.0,4.0,4.0,4.0,4.0,4.0,3.0,4.0,4.0,3.0,4.0,5.0,1,3.0,3.0,4.0,4.0,3.0,3.0,4.0,4.0,4.0,4.0,3.0,3.0,3.0,4.0,3.0,3.0,4.0,4.0,3.0,3.0,3.0,3.0,3.0,3.0,3.0,3.0,4.0,3.0,4.0,3.0,3.0,6.0,8,,,,,,,,,,,,,,,,,,,,,,,,,,,,,,,,,14,,,,,,,,,,,,,,,,,,,,,,,,,,,,,,,,,9,,,,,,,,,,,,,,,,,,,,,,,,,,,,,,,,,7,,,,,,,,,,,,,,,,,,,,,,,,,,,,,,,,,4,,,,,,,,,,,,,,,,,,,,,,,,,,,,,,,,,11,,,,,,,,,,,,,,,,,,,,,,,,,,,,,,,,,10,,,,,,,,,,,,,,,,,,,,,,,,,,,,,,,,,13,,,,,,,,,,,,,,,,,,,,,,,,,,,,,,,,,0,4.0,5.0,3.0,5.0,5.0,5.0,4.0,3.0,5.0,4.0,5.0,6.0,5.0,4.0,5.0,3.0,5.0,4.0,3.0,4.0,4.0,4.0,3.0,4.0,4.0,4.0,4.0,4.0,5.0,4.0,6.0,1.0,,197.03,17.42,,,,6.29,,30.51,,,,,,,,,,,,,,35.52,,,39.98,,,,,,,,,,,,,,,,,,,,,,,,,,,63.81,,,3.5,,APPROVED,Male,31.0,FALSE
921,2022-03-22 02:26:36,19,en,252237085,2022-03-22 02:19:05,2022-03-22 02:26:36,Y,Y,-oth-,secondary school,,8,,,,,,,,,,,,,,,,,,,,,,,,,,,,,,,,,0,5.0,4.0,5.0,5.0,4.0,4.0,4.0,6.0,3.0,2.0,4.0,5.0,4.0,3.0,4.0,5.0,5.0,4.0,5.0,4.0,4.0,5.0,5.0,5.0,4.0,3.0,4.0,4.0,2.0,5.0,5.0,2.0,11,,,,,,,,,,,,,,,,,,,,,,,,,,,,,,,,,2,4.0,5.0,4.0,3.0,3.0,2.0,6.0,2.0,6.0,2.0,5.0,4.0,3.0,4.0,5.0,3.0,5.0,2.0,4.0,3.0,2.0,4.0,2.0,4.0,5.0,5.0,5.0,2.0,5.0,4.0,4.0,4.0,14,,,,,,,,,,,,,,,,,,,,,,,,,,,,,,,,,5,,,,,,,,,,,,,,,,,,,,,,,,,,,,,,,,,1,6.0,7.0,6.0,6.0,6.0,4.0,5.0,7.0,7.0,5.0,7.0,7.0,6.0,6.0,6.0,7.0,7.0,5.0,6.0,6.0,5.0,6.0,5.0,6.0,6.0,6.0,7.0,6.0,7.0,7.0,6.0,7.0,6,,,,,,,,,,,,,,,,,,,,,,,,,,,,,,,,,10,,,,,,,,,,,,,,,,,,,,,,,,,,,,,,,,,12,,,,,,,,,,,,,,,,,,,,,,,,,,,,,,,,,7,,,,,,,,,,,,,,,,,,,,,,,,,,,,,,,,,9,,,,,,,,,,,,,,,,,,,,,,,,,,,,,,,,,4,,,,,,,,,,,,,,,,,,,,,,,,,,,,,,,,,3,,,,,,,,,,,,,,,,,,,,,,,,,,,,,,,,,13,,,,,,,,,,,,,,,,,,,,,,,,,,,,,,,,,,454.59,27.96,,,,17.97,,22.91,,,,,124.0,,,,,,142.23,,,,,,,,,116.33,,,,,,,,,,,,,,,,,,,,,,,,,,,3.19,,APPROVED,Male,56.0,FALSE
922,2022-03-22 02:21:16,19,en,15881785,2022-03-22 02:19:06,2022-03-22 02:21:16,Y,Y,A1,,,4,,,,,,,,,,,,,,,,,,,,,,,,,,,,,,,,,6,,,,,,,,,,,,,,,,,,,,,,,,,,,,,,,,,14,,,,,,,,,,,,,,,,,,,,,,,,,,,,,,,,,2,4.0,4.0,4.0,4.0,5.0,4.0,5.0,3.0,4.0,5.0,5.0,5.0,5.0,4.0,3.0,3.0,4.0,5.0,5.0,5.0,3.0,5.0,3.0,3.0,4.0,3.0,3.0,6.0,3.0,3.0,3.0,4.0,8,,,,,,,,,,,,,,,,,,,,,,,,,,,,,,,,,1,3.0,3.0,5.0,3.0,4.0,4.0,5.0,4.0,5.0,3.0,3.0,4.0,4.0,4.0,3.0,5.0,5.0,5.0,5.0,3.0,3.0,3.0,3.0,4.0,4.0,3.0,4.0,6.0,6.0,5.0,5.0,6.0,3,,,,,,,,,,,,,,,,,,,,,,,,,,,,,,,,,9,,,,,,,,,,,,,,,,,,,,,,,,,,,,,,,,,5,,,,,,,,,,,,,,,,,,,,,,,,,,,,,,,,,11,,,,,,,,,,,,,,,,,,,,,,,,,,,,,,,,,12,,,,,,,,,,,,,,,,,,,,,,,,,,,,,,,,,7,,,,,,,,,,,,,,,,,,,,,,,,,,,,,,,,,10,,,,,,,,,,,,,,,,,,,,,,,,,,,,,,,,,0,2.0,4.0,2.0,4.0,2.0,4.0,3.0,5.0,3.0,3.0,3.0,5.0,3.0,4.0,4.0,3.0,5.0,3.0,3.0,3.0,3.0,6.0,6.0,2.0,2.0,6.0,5.0,3.0,3.0,2.0,7.0,7.0,13,,,,,,,,,,,,,,,,,,,,,,,,,,,,,,,,,,132.52,13.14,,,,4.22,,6.18,,,,,,,,,,,24.65,,,,,,26.74,,,,,,,,,,,,,,,,,,,,,,,,54.43,,,,,,3.16,,APPROVED,Male,19.0,FALSE
923,2022-03-22 02:23:38,19,en,878178119,2022-03-22 02:19:06,2022-03-22 02:23:38,Y,Y,A2,,,10,,,,,,,,,,,,,,,,,,,,,,,,,,,,,,,,,5,,,,,,,,,,,,,,,,,,,,,,,,,,,,,,,,,2,7.0,6.0,6.0,5.0,6.0,6.0,2.0,6.0,6.0,6.0,6.0,6.0,6.0,6.0,6.0,6.0,6.0,6.0,6.0,6.0,5.0,6.0,6.0,5.0,6.0,6.0,5.0,6.0,6.0,6.0,6.0,3.0,14,,,,,,,,,,,,,,,,,,,,,,,,,,,,,,,,,6,,,,,,,,,,,,,,,,,,,,,,,,,,,,,,,,,0,6.0,6.0,7.0,5.0,7.0,5.0,3.0,6.0,6.0,5.0,5.0,6.0,6.0,5.0,6.0,6.0,6.0,6.0,6.0,6.0,6.0,6.0,5.0,6.0,6.0,6.0,6.0,6.0,5.0,6.0,6.0,6.0,1,5.0,5.0,3.0,5.0,5.0,3.0,5.0,5.0,5.0,5.0,2.0,3.0,4.0,5.0,3.0,5.0,5.0,5.0,3.0,2.0,5.0,5.0,6.0,5.0,5.0,5.0,5.0,5.0,5.0,5.0,3.0,7.0,12,,,,,,,,,,,,,,,,,,,,,,,,,,,,,,,,,7,,,,,,,,,,,,,,,,,,,,,,,,,,,,,,,,,11,,,,,,,,,,,,,,,,,,,,,,,,,,,,,,,,,9,,,,,,,,,,,,,,,,,,,,,,,,,,,,,,,,,3,,,,,,,,,,,,,,,,,,,,,,,,,,,,,,,,,13,,,,,,,,,,,,,,,,,,,,,,,,,,,,,,,,,8,,,,,,,,,,,,,,,,,,,,,,,,,,,,,,,,,4,,,,,,,,,,,,,,,,,,,,,,,,,,,,,,,,,none,274.6,25.53,,,,9.43,,33.82,,,,,,,,50.35,,,,,,,,,74.3,,,72.42,,,,,,,,,,,,,,,,,,,,,,,,,,,8.75,,APPROVED,Female,40.0,FALSE
924,2022-03-22 02:22:57,19,en,2090669685,2022-03-22 02:19:07,2022-03-22 02:22:57,Y,Y,A1,,,10,,,,,,,,,,,,,,,,,,,,,,,,,,,,,,,,,9,,,,,,,,,,,,,,,,,,,,,,,,,,,,,,,,,13,,,,,,,,,,,,,,,,,,,,,,,,,,,,,,,,,14,,,,,,,,,,,,,,,,,,,,,,,,,,,,,,,,,5,,,,,,,,,,,,,,,,,,,,,,,,,,,,,,,,,2,5.0,6.0,4.0,3.0,3.0,2.0,5.0,5.0,6.0,3.0,3.0,5.0,5.0,5.0,6.0,3.0,5.0,3.0,3.0,3.0,2.0,5.0,2.0,5.0,3.0,2.0,5.0,4.0,3.0,3.0,3.0,6.0,8,,,,,,,,,,,,,,,,,,,,,,,,,,,,,,,,,6,,,,,,,,,,,,,,,,,,,,,,,,,,,,,,,,,12,,,,,,,,,,,,,,,,,,,,,,,,,,,,,,,,,3,,,,,,,,,,,,,,,,,,,,,,,,,,,,,,,,,0,2.0,2.0,3.0,2.0,3.0,2.0,6.0,2.0,5.0,2.0,2.0,2.0,2.0,2.0,3.0,2.0,3.0,2.0,3.0,2.0,2.0,2.0,1.0,2.0,2.0,1.0,5.0,2.0,2.0,2.0,3.0,4.0,1,2.0,2.0,2.0,2.0,2.0,2.0,5.0,2.0,2.0,2.0,2.0,2.0,1.0,2.0,2.0,3.0,2.0,2.0,2.0,2.0,2.0,2.0,2.0,2.0,2.0,2.0,3.0,1.0,1.0,2.0,2.0,5.0,11,,,,,,,,,,,,,,,,,,,,,,,,,,,,,,,,,7,,,,,,,,,,,,,,,,,,,,,,,,,,,,,,,,,4,,,,,,,,,,,,,,,,,,,,,,,,,,,,,,,,,,232.14,14.3,,,,6.29,,35.12,,,,,,,,,,,,,,,,,60.08,,,,,,,,,,,,,,,59.93,,,53.61,,,,,,,,,,,,2.81,,APPROVED,Female,23.0,FALSE
925,2022-03-22 02:32:51,19,en,1150302860,2022-03-22 02:19:07,2022-03-22 02:32:51,Y,Y,A2,,,2,6.0,5.0,6.0,4.0,4.0,4.0,5.0,5.0,5.0,4.0,5.0,5.0,5.0,5.0,5.0,5.0,5.0,5.0,5.0,5.0,4.0,5.0,5.0,5.0,5.0,5.0,5.0,5.0,5.0,4.0,5.0,1.0,13,,,,,,,,,,,,,,,,,,,,,,,,,,,,,,,,,8,,,,,,,,,,,,,,,,,,,,,,,,,,,,,,,,,10,,,,,,,,,,,,,,,,,,,,,,,,,,,,,,,,,5,,,,,,,,,,,,,,,,,,,,,,,,,,,,,,,,,12,,,,,,,,,,,,,,,,,,,,,,,,,,,,,,,,,6,,,,,,,,,,,,,,,,,,,,,,,,,,,,,,,,,4,,,,,,,,,,,,,,,,,,,,,,,,,,,,,,,,,11,,,,,,,,,,,,,,,,,,,,,,,,,,,,,,,,,3,,,,,,,,,,,,,,,,,,,,,,,,,,,,,,,,,14,,,,,,,,,,,,,,,,,,,,,,,,,,,,,,,,,0,5.0,5.0,6.0,4.0,6.0,4.0,3.0,5.0,5.0,5.0,5.0,5.0,5.0,4.0,5.0,4.0,5.0,4.0,5.0,5.0,4.0,7.0,4.0,4.0,6.0,4.0,4.0,4.0,6.0,4.0,6.0,5.0,9,,,,,,,,,,,,,,,,,,,,,,,,,,,,,,,,,1,4.0,5.0,3.0,4.0,4.0,4.0,4.0,5.0,5.0,4.0,4.0,4.0,4.0,4.0,5.0,4.0,5.0,4.0,4.0,4.0,4.0,4.0,4.0,4.0,4.0,5.0,4.0,4.0,4.0,3.0,4.0,7.0,7,,,,,,,,,,,,,,,,,,,,,,,,,,,,,,,,,,827.63,56.65,,,,7.0,,131.67,,253.65,,,,,,,,,,,,,,,,,,,,,,,,,,,,,,,,,145.89,,,,,,228.9,,,,,,3.87,,APPROVED,Female,33.0,FALSE
926,2022-03-22 02:30:33,19,en,850830331,2022-03-22 02:19:08,2022-03-22 02:30:33,Y,Y,A1,,,11,,,,,,,,,,,,,,,,,,,,,,,,,,,,,,,,,8,,,,,,,,,,,,,,,,,,,,,,,,,,,,,,,,,5,,,,,,,,,,,,,,,,,,,,,,,,,,,,,,,,,12,,,,,,,,,,,,,,,,,,,,,,,,,,,,,,,,,9,,,,,,,,,,,,,,,,,,,,,,,,,,,,,,,,,1,2.0,5.0,5.0,5.0,5.0,3.0,6.0,5.0,6.0,3.0,6.0,3.0,5.0,5.0,5.0,4.0,7.0,2.0,5.0,2.0,3.0,2.0,2.0,3.0,4.0,4.0,5.0,3.0,4.0,3.0,3.0,6.0,6,,,,,,,,,,,,,,,,,,,,,,,,,,,,,,,,,2,7.0,7.0,7.0,6.0,7.0,7.0,3.0,6.0,7.0,6.0,7.0,7.0,6.0,7.0,7.0,6.0,7.0,6.0,6.0,6.0,5.0,7.0,7.0,6.0,6.0,5.0,7.0,6.0,7.0,6.0,7.0,1.0,4,,,,,,,,,,,,,,,,,,,,,,,,,,,,,,,,,10,,,,,,,,,,,,,,,,,,,,,,,,,,,,,,,,,0,5.0,6.0,6.0,5.0,5.0,3.0,3.0,7.0,6.0,5.0,5.0,6.0,5.0,6.0,6.0,5.0,6.0,5.0,6.0,5.0,2.0,5.0,3.0,4.0,6.0,4.0,3.0,4.0,5.0,5.0,4.0,4.0,13,,,,,,,,,,,,,,,,,,,,,,,,,,,,,,,,,3,,,,,,,,,,,,,,,,,,,,,,,,,,,,,,,,,14,,,,,,,,,,,,,,,,,,,,,,,,,,,,,,,,,7,,,,,,,,,,,,,,,,,,,,,,,,,,,,,,,,,,689.36,51.82,,,,11.63,,25.63,,,,,,,,,,,,,,,,,247.44,,,,,,114.75,,,,,,,,,234.86,,,,,,,,,,,,,,,3.23,,APPROVED,Male,39.0,FALSE
927,2022-03-22 02:28:30,19,en,1793097138,2022-03-22 02:19:08,2022-03-22 02:28:30,Y,Y,-oth-,Dogwood,,8,,,,,,,,,,,,,,,,,,,,,,,,,,,,,,,,,14,,,,,,,,,,,,,,,,,,,,,,,,,,,,,,,,,1,7.0,6.0,6.0,6.0,6.0,6.0,2.0,6.0,6.0,7.0,6.0,6.0,6.0,6.0,6.0,6.0,6.0,7.0,6.0,6.0,6.0,6.0,6.0,6.0,6.0,4.0,4.0,6.0,6.0,6.0,6.0,3.0,0,2.0,6.0,2.0,4.0,2.0,1.0,6.0,6.0,6.0,3.0,2.0,4.0,2.0,4.0,4.0,5.0,4.0,2.0,2.0,2.0,3.0,3.0,1.0,3.0,2.0,2.0,4.0,2.0,2.0,2.0,6.0,4.0,11,,,,,,,,,,,,,,,,,,,,,,,,,,,,,,,,,7,,,,,,,,,,,,,,,,,,,,,,,,,,,,,,,,,10,,,,,,,,,,,,,,,,,,,,,,,,,,,,,,,,,4,,,,,,,,,,,,,,,,,,,,,,,,,,,,,,,,,9,,,,,,,,,,,,,,,,,,,,,,,,,,,,,,,,,5,,,,,,,,,,,,,,,,,,,,,,,,,,,,,,,,,12,,,,,,,,,,,,,,,,,,,,,,,,,,,,,,,,,13,,,,,,,,,,,,,,,,,,,,,,,,,,,,,,,,,6,,,,,,,,,,,,,,,,,,,,,,,,,,,,,,,,,2,5.0,4.0,4.0,4.0,3.0,6.0,4.0,2.0,2.0,5.0,2.0,5.0,4.0,4.0,6.0,2.0,7.0,6.0,3.0,4.0,4.0,4.0,6.0,4.0,2.0,6.0,6.0,6.0,2.0,4.0,6.0,7.0,3,,,,,,,,,,,,,,,,,,,,,,,,,,,,,,,,,,565.11,64.94,,,,16.72,,30.2,,,,,,,,124.92,,,210.96,,,,,,,,,,,,,,,,,,,,,,,,,,,,,,112.15,,,,,,5.22,,APPROVED,Female,26.0,FALSE
928,2022-03-22 02:37:16,19,en,1712412741,2022-03-22 02:19:09,2022-03-22 02:37:15,Y,Y,A2,,,9,,,,,,,,,,,,,,,,,,,,,,,,,,,,,,,,,7,,,,,,,,,,,,,,,,,,,,,,,,,,,,,,,,,12,,,,,,,,,,,,,,,,,,,,,,,,,,,,,,,,,4,,,,,,,,,,,,,,,,,,,,,,,,,,,,,,,,,2,6.0,4.0,5.0,5.0,5.0,5.0,4.0,6.0,5.0,5.0,5.0,6.0,5.0,5.0,6.0,5.0,6.0,5.0,5.0,4.0,6.0,4.0,5.0,5.0,4.0,5.0,6.0,6.0,5.0,6.0,5.0,5.0,10,,,,,,,,,,,,,,,,,,,,,,,,,,,,,,,,,3,,,,,,,,,,,,,,,,,,,,,,,,,,,,,,,,,6,,,,,,,,,,,,,,,,,,,,,,,,,,,,,,,,,5,,,,,,,,,,,,,,,,,,,,,,,,,,,,,,,,,8,,,,,,,,,,,,,,,,,,,,,,,,,,,,,,,,,1,4.0,3.0,3.0,5.0,3.0,5.0,6.0,6.0,4.0,3.0,4.0,5.0,4.0,4.0,5.0,5.0,5.0,5.0,4.0,4.0,4.0,4.0,4.0,3.0,3.0,4.0,4.0,4.0,4.0,4.0,4.0,4.0,13,,,,,,,,,,,,,,,,,,,,,,,,,,,,,,,,,11,,,,,,,,,,,,,,,,,,,,,,,,,,,,,,,,,0,2.0,3.0,5.0,4.0,5.0,6.0,4.0,4.0,3.0,4.0,4.0,5.0,4.0,5.0,5.0,4.0,5.0,2.0,4.0,3.0,5.0,3.0,4.0,4.0,3.0,5.0,5.0,4.0,5.0,3.0,5.0,7.0,14,,,,,,,,,,,,,,,,,,,,,,,,,,,,,,,,,"The last network survey looked a lot better when I opened it in a new tab  where it was displayed much larger. I am not sure  if I should not have done that. I could not see it as it was. I have my display in portrait mode because A4 paper is generally used in that orientation, so it was rather cramped with the scales to the right of the image.  

I wonder whether it is more natural, and for whom, to have the most agreed option furtherest from the  item. When asking for response from Japanese people I usually used""reversed"" scales with the agree option nearest the  item (i.e. on the left) because I think that Japanese think more spatially and sometimes read in the opposite direction, but I have not researched it. 

I find the ""Inria"" (which looks like ""India"") a little distracting. 

If I were you I would use nonsense attention checks because some or many participants are good at spotting the standard type of ""Select X"" and respond correctly to those and at random to others. Perhaps you could use use adjectives that do not really apply to a picture such as smelly, pungent, super-conductive,  boiling, gaseous etc. 

Tim",1090.21,40.46,,,,17.63,,39.8,,,,,,,,,,,,,,225.33,,,,,,,,,,,,,,,,,,130.92,,,,,,,,,141.09,,,,,,494.98,,APPROVED,Male,56.0,FALSE
929,2022-03-22 02:21:42,19,en,1227357853,2022-03-22 02:19:09,2022-03-22 02:21:42,Y,Y,A1,,,14,,,,,,,,,,,,,,,,,,,,,,,,,,,,,,,,,11,,,,,,,,,,,,,,,,,,,,,,,,,,,,,,,,,4,,,,,,,,,,,,,,,,,,,,,,,,,,,,,,,,,9,,,,,,,,,,,,,,,,,,,,,,,,,,,,,,,,,7,,,,,,,,,,,,,,,,,,,,,,,,,,,,,,,,,8,,,,,,,,,,,,,,,,,,,,,,,,,,,,,,,,,2,6.0,6.0,6.0,6.0,6.0,6.0,3.0,6.0,6.0,6.0,6.0,6.0,6.0,6.0,6.0,6.0,6.0,6.0,6.0,6.0,6.0,6.0,6.0,6.0,6.0,6.0,6.0,6.0,6.0,6.0,6.0,7.0,5,,,,,,,,,,,,,,,,,,,,,,,,,,,,,,,,,0,2.0,2.0,2.0,2.0,2.0,2.0,6.0,2.0,2.0,2.0,2.0,2.0,2.0,2.0,2.0,2.0,2.0,2.0,2.0,2.0,2.0,2.0,2.0,2.0,2.0,2.0,2.0,2.0,2.0,2.0,2.0,2.0,10,,,,,,,,,,,,,,,,,,,,,,,,,,,,,,,,,1,5.0,5.0,5.0,6.0,5.0,5.0,5.0,6.0,6.0,6.0,6.0,6.0,5.0,5.0,6.0,5.0,6.0,6.0,6.0,5.0,5.0,6.0,4.0,6.0,5.0,5.0,5.0,6.0,6.0,5.0,5.0,4.0,6,,,,,,,,,,,,,,,,,,,,,,,,,,,,,,,,,3,,,,,,,,,,,,,,,,,,,,,,,,,,,,,,,,,12,,,,,,,,,,,,,,,,,,,,,,,,,,,,,,,,,13,,,,,,,,,,,,,,,,,,,,,,,,,,,,,,,,,,156.05,13.2,,,,4.41,,22.27,,,,,,,,,,,,,,,,,,,,31.22,,,,,,41.59,,,,,,40.7,,,,,,,,,,,,,,,2.66,,APPROVED,Male,36.0,FALSE
930,2022-03-22 02:23:03,19,en,1386608477,2022-03-22 02:19:10,2022-03-22 02:23:03,Y,Y,A3,,,8,,,,,,,,,,,,,,,,,,,,,,,,,,,,,,,,,7,,,,,,,,,,,,,,,,,,,,,,,,,,,,,,,,,4,,,,,,,,,,,,,,,,,,,,,,,,,,,,,,,,,0,6.0,7.0,5.0,4.0,4.0,3.0,5.0,5.0,7.0,4.0,2.0,2.0,5.0,5.0,5.0,4.0,6.0,2.0,6.0,2.0,4.0,4.0,5.0,4.0,3.0,6.0,6.0,5.0,6.0,5.0,6.0,4.0,1,6.0,3.0,3.0,4.0,3.0,3.0,6.0,6.0,5.0,5.0,3.0,3.0,5.0,4.0,3.0,4.0,5.0,3.0,5.0,3.0,4.0,5.0,2.0,4.0,4.0,6.0,3.0,6.0,6.0,2.0,5.0,5.0,9,,,,,,,,,,,,,,,,,,,,,,,,,,,,,,,,,2,6.0,7.0,5.0,5.0,6.0,6.0,3.0,7.0,7.0,5.0,5.0,3.0,6.0,6.0,5.0,7.0,7.0,6.0,5.0,6.0,5.0,7.0,7.0,6.0,6.0,6.0,5.0,6.0,6.0,5.0,5.0,7.0,12,,,,,,,,,,,,,,,,,,,,,,,,,,,,,,,,,6,,,,,,,,,,,,,,,,,,,,,,,,,,,,,,,,,13,,,,,,,,,,,,,,,,,,,,,,,,,,,,,,,,,3,,,,,,,,,,,,,,,,,,,,,,,,,,,,,,,,,5,,,,,,,,,,,,,,,,,,,,,,,,,,,,,,,,,11,,,,,,,,,,,,,,,,,,,,,,,,,,,,,,,,,14,,,,,,,,,,,,,,,,,,,,,,,,,,,,,,,,,10,,,,,,,,,,,,,,,,,,,,,,,,,,,,,,,,,,234.99,14.37,,,,6.35,,32.21,,,,,,,,,,,64.16,,,50.41,,,,,,62.22,,,,,,,,,,,,,,,,,,,,,,,,,,,5.27,,APPROVED,Male,35.0,FALSE
931,2022-03-22 02:24:24,19,en,1171189339,2022-03-22 02:20:07,2022-03-22 02:24:24,Y,Y,A2,,,6,,,,,,,,,,,,,,,,,,,,,,,,,,,,,,,,,12,,,,,,,,,,,,,,,,,,,,,,,,,,,,,,,,,9,,,,,,,,,,,,,,,,,,,,,,,,,,,,,,,,,10,,,,,,,,,,,,,,,,,,,,,,,,,,,,,,,,,14,,,,,,,,,,,,,,,,,,,,,,,,,,,,,,,,,0,6.0,7.0,7.0,6.0,6.0,4.0,5.0,7.0,7.0,6.0,7.0,6.0,6.0,6.0,6.0,4.0,7.0,5.0,6.0,6.0,4.0,6.0,3.0,5.0,7.0,6.0,6.0,6.0,6.0,5.0,6.0,6.0,8,,,,,,,,,,,,,,,,,,,,,,,,,,,,,,,,,4,,,,,,,,,,,,,,,,,,,,,,,,,,,,,,,,,3,,,,,,,,,,,,,,,,,,,,,,,,,,,,,,,,,13,,,,,,,,,,,,,,,,,,,,,,,,,,,,,,,,,7,,,,,,,,,,,,,,,,,,,,,,,,,,,,,,,,,2,6.0,7.0,7.0,6.0,7.0,6.0,5.0,6.0,7.0,6.0,7.0,6.0,7.0,6.0,7.0,6.0,7.0,6.0,6.0,5.0,5.0,6.0,5.0,6.0,7.0,6.0,6.0,6.0,7.0,6.0,6.0,5.0,1,5.0,5.0,5.0,5.0,4.0,5.0,7.0,5.0,5.0,4.0,6.0,5.0,5.0,5.0,6.0,4.0,6.0,4.0,5.0,4.0,4.0,5.0,6.0,5.0,5.0,7.0,6.0,4.0,7.0,5.0,5.0,6.0,11,,,,,,,,,,,,,,,,,,,,,,,,,,,,,,,,,5,,,,,,,,,,,,,,,,,,,,,,,,,,,,,,,,,,259.76,27.16,,,,5.9,,39.53,,,,,,,,,,,,,,,,,66.91,,,,,,,,,,,,,,,,,,46.19,,,69.98,,,,,,,,,4.09,,APPROVED,Male,38.0,FALSE
932,2022-03-22 02:25:21,19,en,341976265,2022-03-22 02:20:48,2022-03-22 02:25:21,Y,Y,A1,,,6,,,,,,,,,,,,,,,,,,,,,,,,,,,,,,,,,13,,,,,,,,,,,,,,,,,,,,,,,,,,,,,,,,,1,6.0,6.0,5.0,5.0,6.0,5.0,5.0,6.0,6.0,6.0,6.0,6.0,5.0,5.0,5.0,4.0,6.0,5.0,5.0,5.0,5.0,6.0,5.0,6.0,6.0,5.0,5.0,6.0,5.0,5.0,4.0,3.0,4,,,,,,,,,,,,,,,,,,,,,,,,,,,,,,,,,12,,,,,,,,,,,,,,,,,,,,,,,,,,,,,,,,,11,,,,,,,,,,,,,,,,,,,,,,,,,,,,,,,,,9,,,,,,,,,,,,,,,,,,,,,,,,,,,,,,,,,10,,,,,,,,,,,,,,,,,,,,,,,,,,,,,,,,,0,2.0,1.0,1.0,3.0,2.0,4.0,4.0,5.0,2.0,2.0,2.0,2.0,2.0,1.0,2.0,2.0,3.0,2.0,2.0,2.0,3.0,2.0,4.0,2.0,1.0,5.0,3.0,2.0,2.0,3.0,4.0,2.0,5,,,,,,,,,,,,,,,,,,,,,,,,,,,,,,,,,7,,,,,,,,,,,,,,,,,,,,,,,,,,,,,,,,,8,,,,,,,,,,,,,,,,,,,,,,,,,,,,,,,,,3,,,,,,,,,,,,,,,,,,,,,,,,,,,,,,,,,14,,,,,,,,,,,,,,,,,,,,,,,,,,,,,,,,,2,6.0,6.0,7.0,4.0,6.0,5.0,5.0,7.0,6.0,6.0,6.0,7.0,6.0,6.0,7.0,6.0,5.0,6.0,6.0,6.0,5.0,5.0,5.0,5.0,6.0,5.0,6.0,6.0,6.0,6.0,5.0,1.0,,276.11,11.65,,,,10.85,,46.89,,,,,,,,66.64,,,,,,,,,,,,,,,,,,79.97,,,,,,,,,,,,,,,,,,55.59,,,4.52,,APPROVED,Male,31.0,FALSE
934,2022-03-22 02:30:26,19,en,2055925110,2022-03-22 02:26:11,2022-03-22 02:30:26,Y,Y,A1,,,10,,,,,,,,,,,,,,,,,,,,,,,,,,,,,,,,,2,7.0,1.0,7.0,7.0,4.0,7.0,1.0,7.0,1.0,1.0,4.0,4.0,7.0,1.0,4.0,4.0,7.0,1.0,7.0,4.0,4.0,7.0,7.0,7.0,1.0,7.0,1.0,7.0,4.0,1.0,7.0,2.0,8,,,,,,,,,,,,,,,,,,,,,,,,,,,,,,,,,6,,,,,,,,,,,,,,,,,,,,,,,,,,,,,,,,,1,1.0,4.0,1.0,4.0,1.0,1.0,7.0,6.0,6.0,1.0,6.0,1.0,1.0,1.0,1.0,1.0,1.0,1.0,1.0,1.0,1.0,4.0,4.0,4.0,1.0,6.0,6.0,1.0,1.0,1.0,3.0,5.0,14,,,,,,,,,,,,,,,,,,,,,,,,,,,,,,,,,7,,,,,,,,,,,,,,,,,,,,,,,,,,,,,,,,,5,,,,,,,,,,,,,,,,,,,,,,,,,,,,,,,,,3,,,,,,,,,,,,,,,,,,,,,,,,,,,,,,,,,4,,,,,,,,,,,,,,,,,,,,,,,,,,,,,,,,,13,,,,,,,,,,,,,,,,,,,,,,,,,,,,,,,,,9,,,,,,,,,,,,,,,,,,,,,,,,,,,,,,,,,0,1.0,1.0,1.0,1.0,1.0,1.0,1.0,1.0,1.0,1.0,1.0,1.0,1.0,1.0,1.0,1.0,6.0,1.0,1.0,1.0,1.0,1.0,1.0,1.0,1.0,1.0,6.0,1.0,1.0,1.0,1.0,6.0,11,,,,,,,,,,,,,,,,,,,,,,,,,,,,,,,,,12,,,,,,,,,,,,,,,,,,,,,,,,,,,,,,,,,The first two you can't find a way to see it,258.42,26.46,,,,6.96,,10.59,,,,,60.59,,,,,,,,,80.93,,,,,,,,,,,,,,,,,,,,,,,,46.56,,,,,,,,,26.33,,APPROVED,Male,21.0,FALSE
935,2022-03-22 02:32:19,19,en,891537243,2022-03-22 02:27:36,2022-03-22 02:32:19,Y,Y,A2,,,3,,,,,,,,,,,,,,,,,,,,,,,,,,,,,,,,,2,5.0,6.0,5.0,6.0,6.0,5.0,1.0,6.0,6.0,6.0,5.0,5.0,6.0,6.0,6.0,5.0,7.0,6.0,5.0,5.0,5.0,6.0,5.0,4.0,5.0,5.0,6.0,5.0,5.0,4.0,6.0,2.0,8,,,,,,,,,,,,,,,,,,,,,,,,,,,,,,,,,4,,,,,,,,,,,,,,,,,,,,,,,,,,,,,,,,,12,,,,,,,,,,,,,,,,,,,,,,,,,,,,,,,,,10,,,,,,,,,,,,,,,,,,,,,,,,,,,,,,,,,13,,,,,,,,,,,,,,,,,,,,,,,,,,,,,,,,,1,4.0,5.0,5.0,5.0,5.0,6.0,2.0,5.0,5.0,6.0,6.0,6.0,5.0,6.0,5.0,6.0,4.0,5.0,6.0,5.0,4.0,4.0,4.0,5.0,4.0,5.0,6.0,6.0,5.0,6.0,5.0,1.0,6,,,,,,,,,,,,,,,,,,,,,,,,,,,,,,,,,9,,,,,,,,,,,,,,,,,,,,,,,,,,,,,,,,,0,6.0,6.0,5.0,5.0,5.0,5.0,2.0,4.0,6.0,5.0,5.0,6.0,5.0,5.0,4.0,6.0,6.0,5.0,6.0,6.0,4.0,4.0,6.0,5.0,4.0,5.0,4.0,5.0,5.0,6.0,5.0,4.0,5,,,,,,,,,,,,,,,,,,,,,,,,,,,,,,,,,14,,,,,,,,,,,,,,,,,,,,,,,,,,,,,,,,,7,,,,,,,,,,,,,,,,,,,,,,,,,,,,,,,,,11,,,,,,,,,,,,,,,,,,,,,,,,,,,,,,,,,,286.09,31.13,,,,10.22,,85.66,,,,,53.22,,,,,,,,,,,,,,,,,,42.03,,,,,,,,,61.26,,,,,,,,,,,,,,,2.57,,APPROVED,Male,31.0,FALSE
936,2022-03-22 02:33:09,19,en,964426607,2022-03-22 02:27:49,2022-03-22 02:33:09,Y,Y,A1,,,3,,,,,,,,,,,,,,,,,,,,,,,,,,,,,,,,,5,,,,,,,,,,,,,,,,,,,,,,,,,,,,,,,,,13,,,,,,,,,,,,,,,,,,,,,,,,,,,,,,,,,7,,,,,,,,,,,,,,,,,,,,,,,,,,,,,,,,,0,4.0,2.0,4.0,3.0,2.0,5.0,7.0,4.0,5.0,2.0,4.0,1.0,1.0,1.0,2.0,4.0,1.0,1.0,2.0,2.0,2.0,5.0,5.0,3.0,2.0,6.0,1.0,1.0,5.0,3.0,3.0,5.0,14,,,,,,,,,,,,,,,,,,,,,,,,,,,,,,,,,9,,,,,,,,,,,,,,,,,,,,,,,,,,,,,,,,,6,,,,,,,,,,,,,,,,,,,,,,,,,,,,,,,,,8,,,,,,,,,,,,,,,,,,,,,,,,,,,,,,,,,2,1.0,1.0,1.0,1.0,1.0,3.0,7.0,1.0,1.0,1.0,4.0,1.0,1.0,1.0,1.0,1.0,5.0,1.0,1.0,1.0,1.0,1.0,4.0,1.0,1.0,5.0,1.0,1.0,4.0,1.0,1.0,3.0,11,,,,,,,,,,,,,,,,,,,,,,,,,,,,,,,,,10,,,,,,,,,,,,,,,,,,,,,,,,,,,,,,,,,12,,,,,,,,,,,,,,,,,,,,,,,,,,,,,,,,,4,,,,,,,,,,,,,,,,,,,,,,,,,,,,,,,,,1,5.0,6.0,6.0,4.0,5.0,6.0,1.0,5.0,6.0,5.0,6.0,4.0,5.0,5.0,5.0,4.0,5.0,4.0,5.0,4.0,1.0,6.0,2.0,6.0,6.0,3.0,4.0,6.0,7.0,5.0,6.0,1.0,,321.22,19.56,,,,9.93,,33.26,,,,,,,,,,,,,,101.96,,,,,,,,,,,,,,,60.47,,,,,,,,,,,,,,,91.92,,,4.12,,APPROVED,Female,21.0,FALSE
937,2022-03-22 02:31:39,19,en,1395346660,2022-03-22 02:27:49,2022-03-22 02:31:39,Y,Y,A1,,,12,,,,,,,,,,,,,,,,,,,,,,,,,,,,,,,,,9,,,,,,,,,,,,,,,,,,,,,,,,,,,,,,,,,14,,,,,,,,,,,,,,,,,,,,,,,,,,,,,,,,,3,,,,,,,,,,,,,,,,,,,,,,,,,,,,,,,,,7,,,,,,,,,,,,,,,,,,,,,,,,,,,,,,,,,4,,,,,,,,,,,,,,,,,,,,,,,,,,,,,,,,,1,2.0,2.0,3.0,2.0,4.0,2.0,5.0,2.0,2.0,1.0,2.0,1.0,3.0,4.0,2.0,2.0,1.0,2.0,3.0,2.0,4.0,1.0,3.0,2.0,2.0,2.0,2.0,2.0,2.0,2.0,2.0,7.0,5,,,,,,,,,,,,,,,,,,,,,,,,,,,,,,,,,8,,,,,,,,,,,,,,,,,,,,,,,,,,,,,,,,,0,2.0,2.0,2.0,2.0,4.0,4.0,2.0,2.0,2.0,2.0,4.0,4.0,4.0,4.0,3.0,1.0,2.0,4.0,4.0,2.0,2.0,4.0,3.0,4.0,2.0,3.0,4.0,2.0,3.0,2.0,4.0,3.0,11,,,,,,,,,,,,,,,,,,,,,,,,,,,,,,,,,10,,,,,,,,,,,,,,,,,,,,,,,,,,,,,,,,,6,,,,,,,,,,,,,,,,,,,,,,,,,,,,,,,,,2,7.0,7.0,7.0,6.0,7.0,6.0,2.0,6.0,6.0,7.0,7.0,7.0,6.0,7.0,7.0,6.0,6.0,7.0,5.0,6.0,6.0,7.0,6.0,7.0,6.0,5.0,5.0,5.0,5.0,7.0,6.0,7.0,13,,,,,,,,,,,,,,,,,,,,,,,,,,,,,,,,,,233.8,15.74,,,,41.56,,7.72,,,,,,,,,,,,,,,,,,,,27.1,,,,,,,,,59.55,,,,,,,,,,,,57.65,,,,,,24.48,,APPROVED,Male,36.0,FALSE
938,2022-03-22 02:33:48,19,en,305383779,2022-03-22 02:27:52,2022-03-22 02:33:48,Y,Y,-oth-,High School,,13,,,,,,,,,,,,,,,,,,,,,,,,,,,,,,,,,14,,,,,,,,,,,,,,,,,,,,,,,,,,,,,,,,,12,,,,,,,,,,,,,,,,,,,,,,,,,,,,,,,,,10,,,,,,,,,,,,,,,,,,,,,,,,,,,,,,,,,0,4.0,6.0,3.0,2.0,5.0,2.0,4.0,6.0,5.0,4.0,3.0,2.0,4.0,3.0,4.0,2.0,5.0,2.0,3.0,4.0,3.0,4.0,4.0,3.0,5.0,5.0,2.0,5.0,3.0,4.0,3.0,5.0,9,,,,,,,,,,,,,,,,,,,,,,,,,,,,,,,,,3,,,,,,,,,,,,,,,,,,,,,,,,,,,,,,,,,6,,,,,,,,,,,,,,,,,,,,,,,,,,,,,,,,,4,,,,,,,,,,,,,,,,,,,,,,,,,,,,,,,,,7,,,,,,,,,,,,,,,,,,,,,,,,,,,,,,,,,1,3.0,5.0,4.0,2.0,4.0,2.0,4.0,3.0,5.0,4.0,3.0,3.0,5.0,4.0,4.0,2.0,4.0,2.0,4.0,4.0,3.0,4.0,2.0,4.0,3.0,4.0,3.0,4.0,3.0,4.0,3.0,4.0,2,4.0,5.0,5.0,5.0,4.0,4.0,3.0,6.0,4.0,4.0,3.0,5.0,4.0,3.0,5.0,4.0,6.0,5.0,4.0,4.0,3.0,5.0,5.0,3.0,4.0,4.0,3.0,3.0,4.0,3.0,4.0,5.0,11,,,,,,,,,,,,,,,,,,,,,,,,,,,,,,,,,8,,,,,,,,,,,,,,,,,,,,,,,,,,,,,,,,,5,,,,,,,,,,,,,,,,,,,,,,,,,,,,,,,,,,358.36,15.67,,,,68.15,,65.49,,,,,,,,,,,,,,75.79,,,,,,,,,,,,,,,,,,68.29,,,60.89,,,,,,,,,,,,4.08,,APPROVED,Male,20.0,FALSE
939,2022-03-22 02:34:53,19,en,171666301,2022-03-22 02:27:55,2022-03-22 02:34:53,Y,Y,A1,,,4,,,,,,,,,,,,,,,,,,,,,,,,,,,,,,,,,10,,,,,,,,,,,,,,,,,,,,,,,,,,,,,,,,,12,,,,,,,,,,,,,,,,,,,,,,,,,,,,,,,,,1,7.0,7.0,7.0,6.0,7.0,6.0,3.0,5.0,7.0,6.0,6.0,6.0,6.0,7.0,7.0,6.0,7.0,7.0,7.0,6.0,5.0,6.0,6.0,6.0,7.0,7.0,6.0,6.0,7.0,7.0,7.0,4.0,0,6.0,5.0,6.0,5.0,5.0,5.0,5.0,5.0,5.0,5.0,4.0,4.0,5.0,5.0,4.0,4.0,5.0,4.0,5.0,5.0,3.0,5.0,4.0,5.0,5.0,5.0,4.0,4.0,5.0,5.0,5.0,5.0,6,,,,,,,,,,,,,,,,,,,,,,,,,,,,,,,,,14,,,,,,,,,,,,,,,,,,,,,,,,,,,,,,,,,3,,,,,,,,,,,,,,,,,,,,,,,,,,,,,,,,,7,,,,,,,,,,,,,,,,,,,,,,,,,,,,,,,,,8,,,,,,,,,,,,,,,,,,,,,,,,,,,,,,,,,5,,,,,,,,,,,,,,,,,,,,,,,,,,,,,,,,,2,7.0,5.0,7.0,5.0,7.0,7.0,1.0,7.0,5.0,6.0,6.0,5.0,6.0,4.0,5.0,6.0,6.0,7.0,6.0,6.0,5.0,5.0,5.0,6.0,6.0,6.0,5.0,6.0,6.0,6.0,5.0,5.0,13,,,,,,,,,,,,,,,,,,,,,,,,,,,,,,,,,9,,,,,,,,,,,,,,,,,,,,,,,,,,,,,,,,,11,,,,,,,,,,,,,,,,,,,,,,,,,,,,,,,,,,421.32,41.34,,,,12.7,,30.5,,,,,,,,,,,106.18,,,130.03,,,,,,,,,,,,,,,,,,,,,96.49,,,,,,,,,,,,4.08,,APPROVED,Male,54.0,FALSE
940,2022-03-22 02:35:06,19,en,690790161,2022-03-22 02:27:57,2022-03-22 02:35:06,Y,Y,-oth-,Diploma,,14,,,,,,,,,,,,,,,,,,,,,,,,,,,,,,,,,10,,,,,,,,,,,,,,,,,,,,,,,,,,,,,,,,,7,,,,,,,,,,,,,,,,,,,,,,,,,,,,,,,,,13,,,,,,,,,,,,,,,,,,,,,,,,,,,,,,,,,5,,,,,,,,,,,,,,,,,,,,,,,,,,,,,,,,,0,5.0,7.0,5.0,3.0,6.0,3.0,6.0,5.0,6.0,5.0,5.0,4.0,6.0,5.0,5.0,4.0,6.0,2.0,4.0,4.0,3.0,4.0,2.0,4.0,6.0,3.0,3.0,4.0,4.0,5.0,3.0,6.0,2,4.0,5.0,4.0,6.0,4.0,4.0,6.0,3.0,6.0,3.0,4.0,4.0,4.0,4.0,5.0,5.0,7.0,2.0,4.0,3.0,3.0,2.0,4.0,5.0,4.0,2.0,7.0,5.0,3.0,5.0,5.0,7.0,8,,,,,,,,,,,,,,,,,,,,,,,,,,,,,,,,,1,3.0,4.0,1.0,4.0,3.0,2.0,5.0,1.0,6.0,1.0,2.0,3.0,2.0,2.0,4.0,4.0,6.0,1.0,1.0,2.0,2.0,3.0,3.0,3.0,1.0,2.0,5.0,3.0,4.0,2.0,2.0,2.0,3,,,,,,,,,,,,,,,,,,,,,,,,,,,,,,,,,12,,,,,,,,,,,,,,,,,,,,,,,,,,,,,,,,,4,,,,,,,,,,,,,,,,,,,,,,,,,,,,,,,,,11,,,,,,,,,,,,,,,,,,,,,,,,,,,,,,,,,9,,,,,,,,,,,,,,,,,,,,,,,,,,,,,,,,,6,,,,,,,,,,,,,,,,,,,,,,,,,,,,,,,,,"Visualizations took a bit long to load, around 10 seconds average",431.41,45.82,,,,12.06,,26.85,,,,,,,,,,,,,,,,,112.09,,,99.13,,,,,,91.96,,,,,,,,,,,,,,,,,,,,,43.5,,APPROVED,Male,22.0,FALSE
941,2022-03-22 02:32:34,19,en,1426808170,2022-03-22 02:27:58,2022-03-22 02:32:34,Y,Y,A1,,,3,,,,,,,,,,,,,,,,,,,,,,,,,,,,,,,,,9,,,,,,,,,,,,,,,,,,,,,,,,,,,,,,,,,10,,,,,,,,,,,,,,,,,,,,,,,,,,,,,,,,,1,5.0,6.0,6.0,5.0,5.0,5.0,3.0,4.0,6.0,4.0,5.0,5.0,6.0,5.0,6.0,3.0,6.0,3.0,5.0,4.0,3.0,6.0,5.0,5.0,5.0,5.0,5.0,5.0,5.0,4.0,5.0,4.0,8,,,,,,,,,,,,,,,,,,,,,,,,,,,,,,,,,6,,,,,,,,,,,,,,,,,,,,,,,,,,,,,,,,,2,3.0,5.0,5.0,2.0,4.0,2.0,6.0,5.0,5.0,4.0,5.0,3.0,5.0,3.0,5.0,3.0,6.0,3.0,5.0,4.0,3.0,4.0,3.0,3.0,4.0,4.0,5.0,3.0,5.0,4.0,3.0,7.0,4,,,,,,,,,,,,,,,,,,,,,,,,,,,,,,,,,0,3.0,5.0,3.0,2.0,4.0,2.0,6.0,4.0,5.0,2.0,3.0,3.0,2.0,3.0,5.0,2.0,5.0,3.0,4.0,4.0,3.0,3.0,2.0,3.0,4.0,2.0,3.0,2.0,5.0,4.0,2.0,2.0,14,,,,,,,,,,,,,,,,,,,,,,,,,,,,,,,,,7,,,,,,,,,,,,,,,,,,,,,,,,,,,,,,,,,5,,,,,,,,,,,,,,,,,,,,,,,,,,,,,,,,,11,,,,,,,,,,,,,,,,,,,,,,,,,,,,,,,,,13,,,,,,,,,,,,,,,,,,,,,,,,,,,,,,,,,12,,,,,,,,,,,,,,,,,,,,,,,,,,,,,,,,,,278.22,13.13,,,,12.42,,30.29,,,,,,,,,,,74.17,,,,,,,,,74.48,,,,,,69.42,,,,,,,,,,,,,,,,,,,,,4.31,,APPROVED,Male,30.0,FALSE
942,2022-03-22 02:35:51,19,en,124642734,2022-03-22 02:28:00,2022-03-22 02:35:51,Y,Y,A1,,,4,,,,,,,,,,,,,,,,,,,,,,,,,,,,,,,,,11,,,,,,,,,,,,,,,,,,,,,,,,,,,,,,,,,10,,,,,,,,,,,,,,,,,,,,,,,,,,,,,,,,,13,,,,,,,,,,,,,,,,,,,,,,,,,,,,,,,,,6,,,,,,,,,,,,,,,,,,,,,,,,,,,,,,,,,14,,,,,,,,,,,,,,,,,,,,,,,,,,,,,,,,,8,,,,,,,,,,,,,,,,,,,,,,,,,,,,,,,,,12,,,,,,,,,,,,,,,,,,,,,,,,,,,,,,,,,9,,,,,,,,,,,,,,,,,,,,,,,,,,,,,,,,,0,3.0,5.0,2.0,3.0,1.0,3.0,7.0,1.0,5.0,2.0,1.0,5.0,3.0,4.0,5.0,2.0,5.0,2.0,3.0,3.0,2.0,3.0,1.0,2.0,2.0,3.0,6.0,2.0,4.0,3.0,3.0,3.0,3,,,,,,,,,,,,,,,,,,,,,,,,,,,,,,,,,7,,,,,,,,,,,,,,,,,,,,,,,,,,,,,,,,,1,6.0,5.0,5.0,6.0,5.0,5.0,3.0,4.0,6.0,6.0,4.0,6.0,6.0,6.0,6.0,5.0,6.0,5.0,6.0,5.0,4.0,5.0,5.0,5.0,5.0,4.0,3.0,5.0,5.0,5.0,4.0,6.0,5,,,,,,,,,,,,,,,,,,,,,,,,,,,,,,,,,2,3.0,6.0,3.0,3.0,3.0,3.0,4.0,5.0,6.0,2.0,3.0,4.0,3.0,5.0,4.0,3.0,6.0,2.0,4.0,2.0,2.0,3.0,3.0,3.0,4.0,2.0,6.0,3.0,2.0,5.0,3.0,1.0,,474.07,41.73,,,,6.5,,34.6,,,,,,,,,,,,,,,,,,,,,,,,,,,,,160.49,,,,,,,,,122.09,,,,,,104.39,,,4.27,,APPROVED,Male,34.0,FALSE
943,2022-03-22 02:30:59,19,en,2078711717,2022-03-22 02:28:00,2022-03-22 02:30:59,Y,Y,A1,,,4,,,,,,,,,,,,,,,,,,,,,,,,,,,,,,,,,9,,,,,,,,,,,,,,,,,,,,,,,,,,,,,,,,,10,,,,,,,,,,,,,,,,,,,,,,,,,,,,,,,,,5,,,,,,,,,,,,,,,,,,,,,,,,,,,,,,,,,14,,,,,,,,,,,,,,,,,,,,,,,,,,,,,,,,,12,,,,,,,,,,,,,,,,,,,,,,,,,,,,,,,,,13,,,,,,,,,,,,,,,,,,,,,,,,,,,,,,,,,3,,,,,,,,,,,,,,,,,,,,,,,,,,,,,,,,,2,1.0,1.0,1.0,1.0,1.0,1.0,1.0,1.0,1.0,2.0,1.0,2.0,2.0,1.0,2.0,3.0,2.0,3.0,1.0,1.0,1.0,1.0,1.0,1.0,1.0,2.0,1.0,2.0,2.0,1.0,1.0,2.0,6,,,,,,,,,,,,,,,,,,,,,,,,,,,,,,,,,1,6.0,5.0,5.0,6.0,5.0,5.0,5.0,5.0,6.0,5.0,4.0,5.0,6.0,5.0,5.0,4.0,4.0,4.0,5.0,4.0,5.0,5.0,5.0,4.0,4.0,4.0,4.0,3.0,5.0,5.0,5.0,6.0,8,,,,,,,,,,,,,,,,,,,,,,,,,,,,,,,,,7,,,,,,,,,,,,,,,,,,,,,,,,,,,,,,,,,11,,,,,,,,,,,,,,,,,,,,,,,,,,,,,,,,,0,6.0,5.0,6.0,6.0,5.0,5.0,5.0,6.0,6.0,6.0,6.0,6.0,6.0,5.0,5.0,6.0,6.0,5.0,6.0,6.0,6.0,6.0,6.0,5.0,5.0,5.0,5.0,5.0,5.0,6.0,6.0,1.0,,181.43,13.1,,,,10.23,,13.36,,,,,,,,,,,,,,,,,,,,,,,,,,37.29,,,,,,31.74,,,,,,,,,,,,70.27,,,5.44,,APPROVED,Male,22.0,FALSE
944,2022-03-22 02:33:57,19,en,299888607,2022-03-22 02:28:01,2022-03-22 02:33:57,Y,Y,A1,,,8,,,,,,,,,,,,,,,,,,,,,,,,,,,,,,,,,5,,,,,,,,,,,,,,,,,,,,,,,,,,,,,,,,,9,,,,,,,,,,,,,,,,,,,,,,,,,,,,,,,,,11,,,,,,,,,,,,,,,,,,,,,,,,,,,,,,,,,3,,,,,,,,,,,,,,,,,,,,,,,,,,,,,,,,,12,,,,,,,,,,,,,,,,,,,,,,,,,,,,,,,,,6,,,,,,,,,,,,,,,,,,,,,,,,,,,,,,,,,7,,,,,,,,,,,,,,,,,,,,,,,,,,,,,,,,,1,6.0,5.0,6.0,5.0,6.0,4.0,5.0,5.0,6.0,5.0,5.0,5.0,5.0,6.0,6.0,5.0,5.0,5.0,5.0,5.0,5.0,6.0,6.0,4.0,6.0,6.0,1.0,6.0,5.0,5.0,6.0,2.0,10,,,,,,,,,,,,,,,,,,,,,,,,,,,,,,,,,14,,,,,,,,,,,,,,,,,,,,,,,,,,,,,,,,,4,,,,,,,,,,,,,,,,,,,,,,,,,,,,,,,,,0,4.0,5.0,4.0,4.0,4.0,3.0,4.0,5.0,5.0,5.0,5.0,4.0,4.0,3.0,4.0,4.0,5.0,4.0,4.0,3.0,4.0,5.0,4.0,4.0,4.0,6.0,1.0,4.0,4.0,1.0,4.0,6.0,13,,,,,,,,,,,,,,,,,,,,,,,,,,,,,,,,,2,6.0,7.0,6.0,6.0,6.0,5.0,6.0,7.0,6.0,6.0,6.0,6.0,6.0,6.0,6.0,5.0,6.0,5.0,6.0,6.0,6.0,6.0,6.0,6.0,6.0,5.0,1.0,6.0,6.0,5.0,6.0,1.0,,359.43,22.62,,,,17.84,,38.13,,,,,,,,,,,,,,,,,,,,,,,,,,85.77,,,,,,,,,,,,109.16,,,,,,83.18,,,2.73,,APPROVED,Male,19.0,FALSE
945,2022-03-22 02:36:32,19,en,1165274544,2022-03-22 02:28:01,2022-03-22 02:36:32,Y,Y,-oth-,High School,,9,,,,,,,,,,,,,,,,,,,,,,,,,,,,,,,,,14,,,,,,,,,,,,,,,,,,,,,,,,,,,,,,,,,1,6.0,7.0,6.0,7.0,6.0,6.0,3.0,7.0,5.0,6.0,5.0,5.0,5.0,6.0,4.0,6.0,5.0,6.0,6.0,7.0,4.0,6.0,5.0,6.0,7.0,4.0,5.0,6.0,5.0,6.0,6.0,3.0,0,6.0,7.0,6.0,5.0,6.0,4.0,4.0,6.0,5.0,6.0,5.0,5.0,6.0,4.0,6.0,5.0,6.0,5.0,6.0,6.0,6.0,6.0,4.0,6.0,6.0,4.0,4.0,7.0,5.0,5.0,5.0,4.0,10,,,,,,,,,,,,,,,,,,,,,,,,,,,,,,,,,2,4.0,5.0,4.0,5.0,4.0,4.0,4.0,4.0,5.0,5.0,4.0,4.0,5.0,4.0,5.0,5.0,4.0,5.0,4.0,3.0,4.0,5.0,6.0,4.0,5.0,6.0,4.0,4.0,5.0,5.0,5.0,6.0,11,,,,,,,,,,,,,,,,,,,,,,,,,,,,,,,,,7,,,,,,,,,,,,,,,,,,,,,,,,,,,,,,,,,5,,,,,,,,,,,,,,,,,,,,,,,,,,,,,,,,,8,,,,,,,,,,,,,,,,,,,,,,,,,,,,,,,,,12,,,,,,,,,,,,,,,,,,,,,,,,,,,,,,,,,4,,,,,,,,,,,,,,,,,,,,,,,,,,,,,,,,,13,,,,,,,,,,,,,,,,,,,,,,,,,,,,,,,,,6,,,,,,,,,,,,,,,,,,,,,,,,,,,,,,,,,3,,,,,,,,,,,,,,,,,,,,,,,,,,,,,,,,,,513.67,20.38,,,,75.97,,63.52,,,,,,,,117.85,,,138.96,,,,,,94.06,,,,,,,,,,,,,,,,,,,,,,,,,,,,,,2.93,,APPROVED,Female,21.0,FALSE
946,2022-03-22 02:33:20,19,en,20460265,2022-03-22 02:28:02,2022-03-22 02:33:20,Y,Y,A2,,,8,,,,,,,,,,,,,,,,,,,,,,,,,,,,,,,,,11,,,,,,,,,,,,,,,,,,,,,,,,,,,,,,,,,4,,,,,,,,,,,,,,,,,,,,,,,,,,,,,,,,,10,,,,,,,,,,,,,,,,,,,,,,,,,,,,,,,,,14,,,,,,,,,,,,,,,,,,,,,,,,,,,,,,,,,6,,,,,,,,,,,,,,,,,,,,,,,,,,,,,,,,,0,1.0,2.0,2.0,2.0,2.0,5.0,4.0,4.0,2.0,2.0,2.0,2.0,2.0,2.0,2.0,2.0,1.0,2.0,3.0,2.0,2.0,4.0,2.0,2.0,2.0,5.0,2.0,2.0,2.0,2.0,4.0,7.0,5,,,,,,,,,,,,,,,,,,,,,,,,,,,,,,,,,7,,,,,,,,,,,,,,,,,,,,,,,,,,,,,,,,,2,3.0,5.0,3.0,4.0,3.0,3.0,6.0,4.0,6.0,3.0,4.0,5.0,4.0,4.0,5.0,4.0,5.0,3.0,4.0,3.0,4.0,4.0,5.0,3.0,3.0,5.0,5.0,4.0,6.0,3.0,2.0,3.0,3,,,,,,,,,,,,,,,,,,,,,,,,,,,,,,,,,12,,,,,,,,,,,,,,,,,,,,,,,,,,,,,,,,,9,,,,,,,,,,,,,,,,,,,,,,,,,,,,,,,,,13,,,,,,,,,,,,,,,,,,,,,,,,,,,,,,,,,1,2.0,2.0,4.0,2.0,4.0,2.0,6.0,2.0,2.0,2.0,2.0,1.0,2.0,2.0,2.0,4.0,2.0,2.0,2.0,2.0,2.0,2.0,2.0,3.0,2.0,2.0,2.0,2.0,1.0,2.0,1.0,1.0,,319.14,22.87,,,,7.92,,55.9,,,,,,,,,,,,,,,,,,,,79.74,,,,,,,,,75.05,,,,,,,,,,,,,,,73.97,,,3.69,,APPROVED,Male,33.0,FALSE
948,2022-03-22 02:36:12,19,en,1724326288,2022-03-22 02:28:03,2022-03-22 02:36:12,Y,Y,A1,,,14,,,,,,,,,,,,,,,,,,,,,,,,,,,,,,,,,10,,,,,,,,,,,,,,,,,,,,,,,,,,,,,,,,,12,,,,,,,,,,,,,,,,,,,,,,,,,,,,,,,,,13,,,,,,,,,,,,,,,,,,,,,,,,,,,,,,,,,9,,,,,,,,,,,,,,,,,,,,,,,,,,,,,,,,,0,6.0,3.0,6.0,5.0,4.0,4.0,2.0,6.0,4.0,3.0,5.0,6.0,5.0,4.0,4.0,6.0,7.0,6.0,5.0,3.0,4.0,6.0,4.0,5.0,5.0,6.0,3.0,5.0,4.0,6.0,6.0,6.0,8,,,,,,,,,,,,,,,,,,,,,,,,,,,,,,,,,4,,,,,,,,,,,,,,,,,,,,,,,,,,,,,,,,,3,,,,,,,,,,,,,,,,,,,,,,,,,,,,,,,,,11,,,,,,,,,,,,,,,,,,,,,,,,,,,,,,,,,7,,,,,,,,,,,,,,,,,,,,,,,,,,,,,,,,,1,3.0,2.0,3.0,3.0,2.0,3.0,5.0,2.0,2.0,3.0,3.0,4.0,3.0,3.0,3.0,3.0,3.0,2.0,3.0,2.0,3.0,3.0,3.0,2.0,2.0,4.0,3.0,3.0,3.0,4.0,3.0,5.0,5,,,,,,,,,,,,,,,,,,,,,,,,,,,,,,,,,2,1.0,2.0,2.0,3.0,1.0,2.0,4.0,3.0,4.0,1.0,3.0,2.0,1.0,2.0,3.0,2.0,3.0,1.0,1.0,1.0,2.0,2.0,4.0,1.0,1.0,5.0,3.0,1.0,4.0,4.0,4.0,7.0,6,,,,,,,,,,,,,,,,,,,,,,,,,,,,,,,,,,492.25,74.01,,,,13.64,,42.4,,,,,,,,,,,,,,,,,111.67,,,,,,,,,,,,,,,,,,145.89,,,,,,99.61,,,,,,5.03,,APPROVED,Male,32.0,FALSE
949,2022-03-22 02:33:35,19,en,58772863,2022-03-22 02:28:05,2022-03-22 02:33:34,Y,Y,-oth-,,,3,,,,,,,,,,,,,,,,,,,,,,,,,,,,,,,,,0,6.0,6.0,6.0,6.0,6.0,6.0,3.0,6.0,6.0,6.0,6.0,6.0,6.0,6.0,6.0,6.0,6.0,6.0,6.0,6.0,6.0,6.0,6.0,6.0,6.0,6.0,4.0,6.0,6.0,6.0,6.0,2.0,5,,,,,,,,,,,,,,,,,,,,,,,,,,,,,,,,,14,,,,,,,,,,,,,,,,,,,,,,,,,,,,,,,,,2,3.0,4.0,2.0,2.0,2.0,3.0,6.0,2.0,3.0,2.0,2.0,3.0,3.0,2.0,2.0,2.0,2.0,2.0,2.0,2.0,2.0,2.0,3.0,2.0,2.0,3.0,4.0,3.0,2.0,2.0,2.0,3.0,6,,,,,,,,,,,,,,,,,,,,,,,,,,,,,,,,,4,,,,,,,,,,,,,,,,,,,,,,,,,,,,,,,,,11,,,,,,,,,,,,,,,,,,,,,,,,,,,,,,,,,10,,,,,,,,,,,,,,,,,,,,,,,,,,,,,,,,,12,,,,,,,,,,,,,,,,,,,,,,,,,,,,,,,,,8,,,,,,,,,,,,,,,,,,,,,,,,,,,,,,,,,13,,,,,,,,,,,,,,,,,,,,,,,,,,,,,,,,,9,,,,,,,,,,,,,,,,,,,,,,,,,,,,,,,,,7,,,,,,,,,,,,,,,,,,,,,,,,,,,,,,,,,1,5.0,5.0,4.0,2.0,5.0,3.0,5.0,4.0,5.0,3.0,4.0,3.0,3.0,4.0,5.0,2.0,5.0,4.0,4.0,3.0,3.0,3.0,2.0,4.0,5.0,3.0,5.0,3.0,4.0,3.0,3.0,1.0,,331.88,20.89,,,,14.89,,33.33,,,,,100.56,,,,,,,,,73.8,,,,,,,,,,,,,,,,,,,,,,,,,,,,,,82.41,,,6.0,,APPROVED,Male,55.0,FALSE
950,2022-03-22 02:53:04,19,en,24410500,2022-03-22 02:28:05,2022-03-22 02:53:04,Y,Y,A2,,,1,5.0,5.0,6.0,5.0,6.0,4.0,5.0,5.0,5.0,5.0,5.0,4.0,5.0,5.0,5.0,4.0,5.0,5.0,5.0,5.0,5.0,5.0,4.0,5.0,5.0,4.0,3.0,5.0,6.0,5.0,6.0,1.0,13,,,,,,,,,,,,,,,,,,,,,,,,,,,,,,,,,3,,,,,,,,,,,,,,,,,,,,,,,,,,,,,,,,,9,,,,,,,,,,,,,,,,,,,,,,,,,,,,,,,,,8,,,,,,,,,,,,,,,,,,,,,,,,,,,,,,,,,2,5.0,5.0,5.0,5.0,4.0,4.0,5.0,5.0,5.0,5.0,4.0,5.0,5.0,5.0,5.0,5.0,5.0,5.0,5.0,5.0,5.0,5.0,4.0,5.0,5.0,5.0,5.0,5.0,5.0,5.0,5.0,6.0,4,,,,,,,,,,,,,,,,,,,,,,,,,,,,,,,,,12,,,,,,,,,,,,,,,,,,,,,,,,,,,,,,,,,14,,,,,,,,,,,,,,,,,,,,,,,,,,,,,,,,,11,,,,,,,,,,,,,,,,,,,,,,,,,,,,,,,,,6,,,,,,,,,,,,,,,,,,,,,,,,,,,,,,,,,0,3.0,4.0,3.0,3.0,4.0,4.0,4.0,4.0,5.0,2.0,4.0,2.0,3.0,3.0,3.0,4.0,5.0,4.0,3.0,3.0,3.0,3.0,4.0,3.0,2.0,4.0,4.0,3.0,6.0,3.0,3.0,5.0,7,,,,,,,,,,,,,,,,,,,,,,,,,,,,,,,,,5,,,,,,,,,,,,,,,,,,,,,,,,,,,,,,,,,10,,,,,,,,,,,,,,,,,,,,,,,,,,,,,,,,,,1499.93,28.68,,,,365.07,,234.46,,662.31,,,,,,,,,,,,,,,109.51,,,,,,,,,,,,,,,,,,93.65,,,,,,,,,,,,6.25,,APPROVED,DATA EXPIRED,36.0,FALSE
951,2022-03-22 02:37:54,19,en,22723540,2022-03-22 02:28:06,2022-03-22 02:37:54,Y,Y,A1,,,3,,,,,,,,,,,,,,,,,,,,,,,,,,,,,,,,,11,,,,,,,,,,,,,,,,,,,,,,,,,,,,,,,,,14,,,,,,,,,,,,,,,,,,,,,,,,,,,,,,,,,2,6.0,6.0,6.0,5.0,6.0,5.0,5.0,6.0,6.0,6.0,6.0,7.0,7.0,7.0,6.0,5.0,6.0,5.0,6.0,5.0,5.0,6.0,5.0,7.0,5.0,6.0,3.0,7.0,7.0,2.0,7.0,4.0,1,3.0,5.0,4.0,5.0,4.0,3.0,3.0,6.0,6.0,5.0,3.0,6.0,5.0,3.0,5.0,3.0,6.0,2.0,5.0,2.0,2.0,5.0,6.0,5.0,3.0,5.0,2.0,5.0,5.0,1.0,6.0,5.0,5,,,,,,,,,,,,,,,,,,,,,,,,,,,,,,,,,0,5.0,7.0,2.0,2.0,2.0,2.0,6.0,2.0,6.0,3.0,2.0,6.0,2.0,4.0,6.0,3.0,7.0,3.0,5.0,2.0,2.0,5.0,1.0,1.0,1.0,6.0,2.0,3.0,2.0,1.0,6.0,1.0,8,,,,,,,,,,,,,,,,,,,,,,,,,,,,,,,,,4,,,,,,,,,,,,,,,,,,,,,,,,,,,,,,,,,9,,,,,,,,,,,,,,,,,,,,,,,,,,,,,,,,,12,,,,,,,,,,,,,,,,,,,,,,,,,,,,,,,,,13,,,,,,,,,,,,,,,,,,,,,,,,,,,,,,,,,10,,,,,,,,,,,,,,,,,,,,,,,,,,,,,,,,,7,,,,,,,,,,,,,,,,,,,,,,,,,,,,,,,,,6,,,,,,,,,,,,,,,,,,,,,,,,,,,,,,,,,,590.65,15.44,,,,11.94,,60.27,,,,,,,,,,,141.19,,,173.93,,,,,,182.68,,,,,,,,,,,,,,,,,,,,,,,,,,,5.2,,APPROVED,Male,21.0,FALSE
952,2022-03-22 02:32:14,19,en,704255328,2022-03-22 02:28:06,2022-03-22 02:32:14,Y,Y,A2,,,13,,,,,,,,,,,,,,,,,,,,,,,,,,,,,,,,,9,,,,,,,,,,,,,,,,,,,,,,,,,,,,,,,,,10,,,,,,,,,,,,,,,,,,,,,,,,,,,,,,,,,0,4.0,5.0,3.0,4.0,4.0,2.0,7.0,6.0,5.0,3.0,4.0,6.0,2.0,6.0,6.0,3.0,5.0,4.0,3.0,2.0,1.0,2.0,1.0,3.0,3.0,2.0,5.0,2.0,7.0,2.0,3.0,4.0,1,2.0,2.0,3.0,3.0,2.0,2.0,7.0,6.0,3.0,3.0,2.0,3.0,3.0,4.0,5.0,2.0,5.0,3.0,3.0,2.0,2.0,3.0,1.0,4.0,3.0,2.0,2.0,4.0,6.0,3.0,2.0,5.0,5,,,,,,,,,,,,,,,,,,,,,,,,,,,,,,,,,7,,,,,,,,,,,,,,,,,,,,,,,,,,,,,,,,,8,,,,,,,,,,,,,,,,,,,,,,,,,,,,,,,,,12,,,,,,,,,,,,,,,,,,,,,,,,,,,,,,,,,3,,,,,,,,,,,,,,,,,,,,,,,,,,,,,,,,,2,2.0,1.0,2.0,1.0,1.0,2.0,5.0,2.0,1.0,1.0,2.0,1.0,1.0,2.0,3.0,2.0,2.0,2.0,2.0,1.0,2.0,2.0,1.0,1.0,1.0,1.0,2.0,2.0,3.0,2.0,1.0,4.0,4,,,,,,,,,,,,,,,,,,,,,,,,,,,,,,,,,6,,,,,,,,,,,,,,,,,,,,,,,,,,,,,,,,,14,,,,,,,,,,,,,,,,,,,,,,,,,,,,,,,,,11,,,,,,,,,,,,,,,,,,,,,,,,,,,,,,,,,No additional comments.,251.04,39.08,,,,4.86,,19.71,,,,,,,,,,,60.5,,,57.7,,,,,,,,,,,,,,,,,,62.09,,,,,,,,,,,,,,,7.1,,APPROVED,Male,27.0,FALSE
953,2022-03-22 02:34:38,19,en,96832726,2022-03-22 02:28:07,2022-03-22 02:34:38,Y,Y,-oth-,High school,,2,6.0,7.0,5.0,4.0,5.0,6.0,3.0,6.0,6.0,6.0,5.0,5.0,6.0,4.0,3.0,5.0,5.0,3.0,5.0,5.0,3.0,5.0,4.0,6.0,5.0,3.0,6.0,5.0,4.0,5.0,5.0,1.0,13,,,,,,,,,,,,,,,,,,,,,,,,,,,,,,,,,3,,,,,,,,,,,,,,,,,,,,,,,,,,,,,,,,,6,,,,,,,,,,,,,,,,,,,,,,,,,,,,,,,,,1,3.0,2.0,3.0,5.0,3.0,6.0,6.0,6.0,2.0,3.0,4.0,4.0,3.0,1.0,2.0,5.0,2.0,5.0,3.0,2.0,1.0,4.0,4.0,3.0,3.0,5.0,3.0,4.0,5.0,5.0,4.0,5.0,5,,,,,,,,,,,,,,,,,,,,,,,,,,,,,,,,,0,3.0,6.0,2.0,2.0,3.0,2.0,6.0,6.0,6.0,3.0,2.0,5.0,4.0,4.0,5.0,3.0,5.0,2.0,2.0,3.0,1.0,3.0,2.0,3.0,3.0,2.0,5.0,3.0,3.0,3.0,4.0,7.0,4,,,,,,,,,,,,,,,,,,,,,,,,,,,,,,,,,8,,,,,,,,,,,,,,,,,,,,,,,,,,,,,,,,,11,,,,,,,,,,,,,,,,,,,,,,,,,,,,,,,,,9,,,,,,,,,,,,,,,,,,,,,,,,,,,,,,,,,12,,,,,,,,,,,,,,,,,,,,,,,,,,,,,,,,,7,,,,,,,,,,,,,,,,,,,,,,,,,,,,,,,,,10,,,,,,,,,,,,,,,,,,,,,,,,,,,,,,,,,14,,,,,,,,,,,,,,,,,,,,,,,,,,,,,,,,,,392.38,31.14,,,,32.28,,49.82,,95.33,,,,,,,,,,,,86.36,,,,,,91.06,,,,,,,,,,,,,,,,,,,,,,,,,,,6.39,,APPROVED,Male,32.0,FALSE
954,2022-03-22 02:34:18,19,en,848820245,2022-03-22 02:28:07,2022-03-22 02:34:18,Y,Y,A1,,,5,,,,,,,,,,,,,,,,,,,,,,,,,,,,,,,,,7,,,,,,,,,,,,,,,,,,,,,,,,,,,,,,,,,4,,,,,,,,,,,,,,,,,,,,,,,,,,,,,,,,,11,,,,,,,,,,,,,,,,,,,,,,,,,,,,,,,,,6,,,,,,,,,,,,,,,,,,,,,,,,,,,,,,,,,0,5.0,6.0,5.0,5.0,4.0,4.0,6.0,5.0,5.0,4.0,3.0,6.0,4.0,6.0,6.0,5.0,6.0,4.0,5.0,4.0,5.0,4.0,3.0,5.0,5.0,4.0,6.0,5.0,3.0,3.0,4.0,6.0,9,,,,,,,,,,,,,,,,,,,,,,,,,,,,,,,,,1,3.0,2.0,4.0,4.0,3.0,2.0,6.0,6.0,2.0,3.0,4.0,4.0,2.0,3.0,4.0,4.0,2.0,2.0,3.0,4.0,4.0,3.0,5.0,3.0,3.0,5.0,3.0,2.0,4.0,4.0,4.0,1.0,14,,,,,,,,,,,,,,,,,,,,,,,,,,,,,,,,,13,,,,,,,,,,,,,,,,,,,,,,,,,,,,,,,,,8,,,,,,,,,,,,,,,,,,,,,,,,,,,,,,,,,3,,,,,,,,,,,,,,,,,,,,,,,,,,,,,,,,,10,,,,,,,,,,,,,,,,,,,,,,,,,,,,,,,,,2,5.0,3.0,3.0,4.0,2.0,5.0,5.0,3.0,4.0,4.0,2.0,5.0,3.0,5.0,5.0,4.0,5.0,5.0,3.0,4.0,4.0,5.0,6.0,3.0,2.0,6.0,5.0,5.0,3.0,5.0,5.0,7.0,12,,,,,,,,,,,,,,,,,,,,,,,,,,,,,,,,,,374.18,59.25,,,,17.87,,64.31,,,,,,,,,,,,,,,,,87.71,,,,,,68.82,,,,,,,,,,,,,,,,,,71.81,,,,,,4.41,,APPROVED,Female,23.0,FALSE
955,2022-03-22 02:35:01,19,en,270894959,2022-03-22 02:28:08,2022-03-22 02:35:01,Y,Y,-oth-,Bachelor (current),,10,,,,,,,,,,,,,,,,,,,,,,,,,,,,,,,,,7,,,,,,,,,,,,,,,,,,,,,,,,,,,,,,,,,5,,,,,,,,,,,,,,,,,,,,,,,,,,,,,,,,,2,7.0,7.0,7.0,6.0,7.0,3.0,6.0,7.0,7.0,5.0,5.0,6.0,7.0,7.0,6.0,4.0,7.0,7.0,6.0,5.0,4.0,6.0,3.0,7.0,7.0,2.0,6.0,6.0,5.0,5.0,6.0,4.0,4,,,,,,,,,,,,,,,,,,,,,,,,,,,,,,,,,1,7.0,7.0,7.0,3.0,7.0,4.0,7.0,7.0,7.0,3.0,4.0,7.0,7.0,7.0,7.0,4.0,7.0,7.0,5.0,6.0,4.0,5.0,3.0,6.0,7.0,3.0,5.0,5.0,2.0,3.0,3.0,6.0,12,,,,,,,,,,,,,,,,,,,,,,,,,,,,,,,,,13,,,,,,,,,,,,,,,,,,,,,,,,,,,,,,,,,0,1.0,1.0,1.0,1.0,1.0,1.0,6.0,1.0,2.0,1.0,1.0,1.0,1.0,1.0,1.0,1.0,1.0,1.0,2.0,1.0,1.0,1.0,1.0,1.0,1.0,2.0,2.0,1.0,1.0,2.0,1.0,2.0,3,,,,,,,,,,,,,,,,,,,,,,,,,,,,,,,,,8,,,,,,,,,,,,,,,,,,,,,,,,,,,,,,,,,6,,,,,,,,,,,,,,,,,,,,,,,,,,,,,,,,,14,,,,,,,,,,,,,,,,,,,,,,,,,,,,,,,,,11,,,,,,,,,,,,,,,,,,,,,,,,,,,,,,,,,9,,,,,,,,,,,,,,,,,,,,,,,,,,,,,,,,,,416.53,42.9,,,,35.16,,34.08,,,,,,,,,,,120.68,,,,,,98.41,,,,,,,,,77.31,,,,,,,,,,,,,,,,,,,,,7.99,,APPROVED,Female,23.0,FALSE
956,2022-03-22 02:33:39,19,en,2071572904,2022-03-22 02:28:10,2022-03-22 02:33:39,Y,Y,A2,,,4,,,,,,,,,,,,,,,,,,,,,,,,,,,,,,,,,10,,,,,,,,,,,,,,,,,,,,,,,,,,,,,,,,,6,,,,,,,,,,,,,,,,,,,,,,,,,,,,,,,,,13,,,,,,,,,,,,,,,,,,,,,,,,,,,,,,,,,12,,,,,,,,,,,,,,,,,,,,,,,,,,,,,,,,,7,,,,,,,,,,,,,,,,,,,,,,,,,,,,,,,,,2,4.0,4.0,5.0,4.0,3.0,4.0,2.0,4.0,5.0,3.0,4.0,2.0,3.0,4.0,4.0,4.0,5.0,4.0,4.0,3.0,3.0,3.0,5.0,5.0,4.0,5.0,3.0,3.0,4.0,4.0,5.0,7.0,8,,,,,,,,,,,,,,,,,,,,,,,,,,,,,,,,,1,2.0,4.0,2.0,3.0,2.0,2.0,5.0,2.0,4.0,2.0,2.0,3.0,2.0,2.0,2.0,2.0,4.0,2.0,2.0,2.0,2.0,2.0,2.0,2.0,2.0,2.0,5.0,2.0,2.0,2.0,2.0,2.0,3,,,,,,,,,,,,,,,,,,,,,,,,,,,,,,,,,0,4.0,5.0,4.0,5.0,4.0,5.0,4.0,5.0,5.0,4.0,4.0,4.0,4.0,4.0,3.0,3.0,5.0,4.0,3.0,3.0,4.0,4.0,4.0,3.0,3.0,4.0,3.0,4.0,5.0,4.0,5.0,4.0,11,,,,,,,,,,,,,,,,,,,,,,,,,,,,,,,,,5,,,,,,,,,,,,,,,,,,,,,,,,,,,,,,,,,14,,,,,,,,,,,,,,,,,,,,,,,,,,,,,,,,,9,,,,,,,,,,,,,,,,,,,,,,,,,,,,,,,,,,331.94,20.24,,,,10.84,,39.24,,,,,,,,,,,,,,,,,,,,73.89,,,,,,83.09,,,,,,100.31,,,,,,,,,,,,,,,4.33,,APPROVED,Male,34.0,FALSE
957,2022-03-22 02:34:38,19,en,1393363006,2022-03-22 02:28:10,2022-03-22 02:34:38,Y,Y,-oth-,vocational,,4,,,,,,,,,,,,,,,,,,,,,,,,,,,,,,,,,0,2.0,2.0,2.0,2.0,2.0,4.0,4.0,2.0,2.0,2.0,2.0,2.0,2.0,2.0,2.0,2.0,2.0,2.0,2.0,2.0,2.0,2.0,2.0,2.0,2.0,2.0,2.0,2.0,2.0,2.0,2.0,2.0,13,,,,,,,,,,,,,,,,,,,,,,,,,,,,,,,,,5,,,,,,,,,,,,,,,,,,,,,,,,,,,,,,,,,2,1.0,1.0,1.0,1.0,1.0,1.0,6.0,1.0,1.0,1.0,1.0,1.0,1.0,1.0,1.0,1.0,1.0,1.0,1.0,1.0,1.0,1.0,1.0,1.0,1.0,1.0,1.0,1.0,1.0,1.0,1.0,5.0,10,,,,,,,,,,,,,,,,,,,,,,,,,,,,,,,,,8,,,,,,,,,,,,,,,,,,,,,,,,,,,,,,,,,1,2.0,2.0,2.0,2.0,2.0,2.0,6.0,2.0,2.0,2.0,2.0,2.0,2.0,2.0,2.0,2.0,2.0,2.0,2.0,2.0,2.0,2.0,2.0,2.0,2.0,2.0,2.0,2.0,2.0,2.0,2.0,1.0,3,,,,,,,,,,,,,,,,,,,,,,,,,,,,,,,,,11,,,,,,,,,,,,,,,,,,,,,,,,,,,,,,,,,6,,,,,,,,,,,,,,,,,,,,,,,,,,,,,,,,,12,,,,,,,,,,,,,,,,,,,,,,,,,,,,,,,,,9,,,,,,,,,,,,,,,,,,,,,,,,,,,,,,,,,7,,,,,,,,,,,,,,,,,,,,,,,,,,,,,,,,,14,,,,,,,,,,,,,,,,,,,,,,,,,,,,,,,,,"none at this time, thank you.",390.75,37.46,,,,23.81,,25.33,,,,,112.1,,,,,,,,,84.71,,,,,,,,,84.3,,,,,,,,,,,,,,,,,,,,,,,,23.04,,APPROVED,Female,57.0,FALSE
958,2022-03-22 02:34:45,19,en,1757749357,2022-03-22 02:28:10,2022-03-22 02:34:45,Y,Y,A1,,,13,,,,,,,,,,,,,,,,,,,,,,,,,,,,,,,,,2,4.0,1.0,3.0,4.0,3.0,5.0,3.0,2.0,4.0,4.0,3.0,4.0,3.0,4.0,3.0,3.0,4.0,3.0,3.0,4.0,3.0,4.0,5.0,3.0,3.0,5.0,2.0,4.0,3.0,3.0,2.0,2.0,6,,,,,,,,,,,,,,,,,,,,,,,,,,,,,,,,,7,,,,,,,,,,,,,,,,,,,,,,,,,,,,,,,,,9,,,,,,,,,,,,,,,,,,,,,,,,,,,,,,,,,12,,,,,,,,,,,,,,,,,,,,,,,,,,,,,,,,,1,5.0,6.0,5.0,3.0,5.0,5.0,2.0,6.0,5.0,4.0,5.0,5.0,5.0,5.0,4.0,5.0,5.0,5.0,5.0,3.0,5.0,5.0,5.0,5.0,5.0,5.0,5.0,5.0,5.0,2.0,5.0,7.0,8,,,,,,,,,,,,,,,,,,,,,,,,,,,,,,,,,4,,,,,,,,,,,,,,,,,,,,,,,,,,,,,,,,,3,,,,,,,,,,,,,,,,,,,,,,,,,,,,,,,,,5,,,,,,,,,,,,,,,,,,,,,,,,,,,,,,,,,14,,,,,,,,,,,,,,,,,,,,,,,,,,,,,,,,,10,,,,,,,,,,,,,,,,,,,,,,,,,,,,,,,,,0,3.0,4.0,4.0,3.0,3.0,4.0,2.0,3.0,5.0,4.0,4.0,3.0,3.0,3.0,4.0,3.0,5.0,3.0,4.0,3.0,4.0,4.0,5.0,4.0,3.0,6.0,3.0,4.0,5.0,3.0,4.0,7.0,11,,,,,,,,,,,,,,,,,,,,,,,,,,,,,,,,,None,397.81,51.4,,,,6.37,,23.35,,,,,111.61,,,,,,,,,,,,,,,89.49,,,,,,,,,,,,,,,,,,,,,101.91,,,,,,13.68,,APPROVED,Male,27.0,FALSE
959,2022-03-22 02:34:17,19,en,472723086,2022-03-22 02:28:12,2022-03-22 02:34:17,Y,Y,A1,,,10,,,,,,,,,,,,,,,,,,,,,,,,,,,,,,,,,11,,,,,,,,,,,,,,,,,,,,,,,,,,,,,,,,,0,6.0,7.0,7.0,6.0,7.0,7.0,3.0,6.0,6.0,6.0,7.0,6.0,6.0,6.0,6.0,6.0,6.0,6.0,6.0,7.0,6.0,6.0,6.0,6.0,7.0,6.0,7.0,6.0,7.0,7.0,7.0,3.0,6,,,,,,,,,,,,,,,,,,,,,,,,,,,,,,,,,2,2.0,3.0,2.0,4.0,3.0,2.0,6.0,3.0,5.0,3.0,3.0,2.0,3.0,3.0,3.0,2.0,5.0,3.0,3.0,2.0,3.0,3.0,5.0,4.0,3.0,6.0,3.0,3.0,3.0,5.0,3.0,5.0,12,,,,,,,,,,,,,,,,,,,,,,,,,,,,,,,,,14,,,,,,,,,,,,,,,,,,,,,,,,,,,,,,,,,5,,,,,,,,,,,,,,,,,,,,,,,,,,,,,,,,,3,,,,,,,,,,,,,,,,,,,,,,,,,,,,,,,,,1,6.0,6.0,3.0,5.0,5.0,2.0,7.0,5.0,6.0,3.0,5.0,5.0,5.0,4.0,6.0,3.0,6.0,3.0,5.0,3.0,6.0,3.0,3.0,5.0,7.0,5.0,6.0,5.0,6.0,6.0,2.0,3.0,4,,,,,,,,,,,,,,,,,,,,,,,,,,,,,,,,,13,,,,,,,,,,,,,,,,,,,,,,,,,,,,,,,,,7,,,,,,,,,,,,,,,,,,,,,,,,,,,,,,,,,9,,,,,,,,,,,,,,,,,,,,,,,,,,,,,,,,,8,,,,,,,,,,,,,,,,,,,,,,,,,,,,,,,,,,367.37,24.89,,,,8.57,,90.22,,,,,,,,58.78,,,,,,70.74,,,,,,,,,,,,,,,110.07,,,,,,,,,,,,,,,,,,4.1,,APPROVED,Male,46.0,FALSE
960,2022-03-22 02:41:25,19,en,1998277225,2022-03-22 02:28:12,2022-03-22 02:41:25,Y,Y,-oth-,High School,,10,,,,,,,,,,,,,,,,,,,,,,,,,,,,,,,,,3,,,,,,,,,,,,,,,,,,,,,,,,,,,,,,,,,6,,,,,,,,,,,,,,,,,,,,,,,,,,,,,,,,,5,,,,,,,,,,,,,,,,,,,,,,,,,,,,,,,,,0,5.0,5.0,5.0,5.0,5.0,3.0,7.0,6.0,5.0,3.0,6.0,5.0,5.0,4.0,6.0,3.0,6.0,3.0,4.0,4.0,3.0,6.0,4.0,4.0,5.0,7.0,5.0,4.0,7.0,5.0,5.0,5.0,11,,,,,,,,,,,,,,,,,,,,,,,,,,,,,,,,,2,6.0,7.0,5.0,5.0,6.0,5.0,5.0,6.0,6.0,4.0,5.0,6.0,7.0,6.0,6.0,7.0,7.0,6.0,5.0,3.0,5.0,5.0,6.0,5.0,5.0,6.0,6.0,6.0,5.0,6.0,5.0,1.0,12,,,,,,,,,,,,,,,,,,,,,,,,,,,,,,,,,4,,,,,,,,,,,,,,,,,,,,,,,,,,,,,,,,,1,3.0,5.0,2.0,2.0,2.0,6.0,5.0,7.0,4.0,2.0,2.0,2.0,2.0,5.0,6.0,2.0,6.0,1.0,2.0,1.0,1.0,3.0,4.0,2.0,1.0,6.0,5.0,5.0,6.0,1.0,3.0,3.0,7,,,,,,,,,,,,,,,,,,,,,,,,,,,,,,,,,8,,,,,,,,,,,,,,,,,,,,,,,,,,,,,,,,,14,,,,,,,,,,,,,,,,,,,,,,,,,,,,,,,,,13,,,,,,,,,,,,,,,,,,,,,,,,,,,,,,,,,9,,,,,,,,,,,,,,,,,,,,,,,,,,,,,,,,,<none>,796.23,45.48,,,,15.14,,168.75,,,,,,,,,,,,,,288.6,,,,,,157.12,,,,,,,,,113.4,,,,,,,,,,,,,,,,,,7.74,,APPROVED,Male,45.0,FALSE
961,2022-03-22 02:33:25,19,en,628628380,2022-03-22 02:28:14,2022-03-22 02:33:25,Y,Y,A1,,,13,,,,,,,,,,,,,,,,,,,,,,,,,,,,,,,,,12,,,,,,,,,,,,,,,,,,,,,,,,,,,,,,,,,8,,,,,,,,,,,,,,,,,,,,,,,,,,,,,,,,,10,,,,,,,,,,,,,,,,,,,,,,,,,,,,,,,,,6,,,,,,,,,,,,,,,,,,,,,,,,,,,,,,,,,9,,,,,,,,,,,,,,,,,,,,,,,,,,,,,,,,,4,,,,,,,,,,,,,,,,,,,,,,,,,,,,,,,,,2,5.0,6.0,5.0,2.0,5.0,3.0,6.0,5.0,6.0,4.0,3.0,5.0,6.0,5.0,2.0,3.0,6.0,6.0,6.0,5.0,4.0,5.0,3.0,5.0,6.0,1.0,5.0,6.0,2.0,6.0,3.0,1.0,3,,,,,,,,,,,,,,,,,,,,,,,,,,,,,,,,,7,,,,,,,,,,,,,,,,,,,,,,,,,,,,,,,,,5,,,,,,,,,,,,,,,,,,,,,,,,,,,,,,,,,11,,,,,,,,,,,,,,,,,,,,,,,,,,,,,,,,,0,3.0,5.0,5.0,2.0,3.0,1.0,5.0,6.0,7.0,2.0,2.0,5.0,3.0,5.0,5.0,3.0,6.0,1.0,5.0,4.0,4.0,4.0,2.0,3.0,2.0,6.0,5.0,2.0,5.0,6.0,3.0,6.0,1,2.0,4.0,2.0,6.0,1.0,6.0,2.0,5.0,2.0,2.0,2.0,3.0,2.0,2.0,3.0,6.0,6.0,5.0,2.0,2.0,2.0,3.0,7.0,2.0,2.0,6.0,5.0,4.0,3.0,6.0,6.0,7.0,14,,,,,,,,,,,,,,,,,,,,,,,,,,,,,,,,,,312.16,19.71,,,,4.9,,47.4,,,,,,,,,,,,,,,,,,,,,,,75.92,,,,,,,,,,,,,,,89.26,,,71.45,,,,,,3.52,,APPROVED,Female,27.0,FALSE
962,2022-03-22 02:34:47,19,en,922980005,2022-03-22 02:28:14,2022-03-22 02:34:47,Y,Y,-oth-,,,10,,,,,,,,,,,,,,,,,,,,,,,,,,,,,,,,,14,,,,,,,,,,,,,,,,,,,,,,,,,,,,,,,,,4,,,,,,,,,,,,,,,,,,,,,,,,,,,,,,,,,3,,,,,,,,,,,,,,,,,,,,,,,,,,,,,,,,,1,6.0,5.0,5.0,4.0,5.0,5.0,3.0,6.0,5.0,6.0,5.0,6.0,5.0,5.0,6.0,5.0,6.0,5.0,5.0,5.0,5.0,6.0,5.0,6.0,5.0,4.0,5.0,5.0,5.0,5.0,5.0,5.0,6,,,,,,,,,,,,,,,,,,,,,,,,,,,,,,,,,5,,,,,,,,,,,,,,,,,,,,,,,,,,,,,,,,,13,,,,,,,,,,,,,,,,,,,,,,,,,,,,,,,,,11,,,,,,,,,,,,,,,,,,,,,,,,,,,,,,,,,0,2.0,3.0,3.0,3.0,2.0,3.0,7.0,5.0,3.0,2.0,2.0,3.0,2.0,4.0,5.0,2.0,5.0,2.0,3.0,3.0,4.0,3.0,4.0,2.0,2.0,4.0,5.0,3.0,6.0,3.0,2.0,3.0,12,,,,,,,,,,,,,,,,,,,,,,,,,,,,,,,,,7,,,,,,,,,,,,,,,,,,,,,,,,,,,,,,,,,2,4.0,3.0,4.0,4.0,4.0,5.0,4.0,5.0,4.0,5.0,5.0,5.0,5.0,5.0,6.0,4.0,5.0,4.0,5.0,4.0,5.0,5.0,4.0,5.0,4.0,5.0,6.0,5.0,4.0,4.0,5.0,6.0,8,,,,,,,,,,,,,,,,,,,,,,,,,,,,,,,,,9,,,,,,,,,,,,,,,,,,,,,,,,,,,,,,,,,,394.07,69.19,,,,19.0,,49.71,,,,,,,,,,,,,,86.64,,,,,,,,,,,,,,,93.28,,,,,,,,,73.19,,,,,,,,,3.06,,APPROVED,Male,24.0,FALSE
963,2022-03-22 02:34:30,19,en,625240397,2022-03-22 02:28:14,2022-03-22 02:34:30,Y,Y,A1,,,10,,,,,,,,,,,,,,,,,,,,,,,,,,,,,,,,,2,6.0,3.0,6.0,5.0,6.0,7.0,2.0,7.0,3.0,6.0,6.0,7.0,6.0,5.0,5.0,5.0,6.0,6.0,6.0,6.0,4.0,6.0,6.0,6.0,6.0,7.0,5.0,6.0,6.0,6.0,6.0,2.0,5,,,,,,,,,,,,,,,,,,,,,,,,,,,,,,,,,0,5.0,7.0,6.0,2.0,5.0,2.0,7.0,6.0,6.0,5.0,2.0,5.0,6.0,6.0,6.0,6.0,5.0,6.0,5.0,5.0,3.0,5.0,1.0,5.0,5.0,2.0,5.0,3.0,6.0,3.0,3.0,4.0,9,,,,,,,,,,,,,,,,,,,,,,,,,,,,,,,,,4,,,,,,,,,,,,,,,,,,,,,,,,,,,,,,,,,8,,,,,,,,,,,,,,,,,,,,,,,,,,,,,,,,,12,,,,,,,,,,,,,,,,,,,,,,,,,,,,,,,,,1,1.0,1.0,1.0,2.0,1.0,5.0,2.0,1.0,1.0,1.0,1.0,2.0,1.0,2.0,5.0,6.0,5.0,3.0,1.0,1.0,1.0,2.0,6.0,1.0,1.0,5.0,5.0,2.0,1.0,2.0,1.0,2.0,13,,,,,,,,,,,,,,,,,,,,,,,,,,,,,,,,,3,,,,,,,,,,,,,,,,,,,,,,,,,,,,,,,,,14,,,,,,,,,,,,,,,,,,,,,,,,,,,,,,,,,6,,,,,,,,,,,,,,,,,,,,,,,,,,,,,,,,,11,,,,,,,,,,,,,,,,,,,,,,,,,,,,,,,,,7,,,,,,,,,,,,,,,,,,,,,,,,,,,,,,,,,,378.68,35.16,,,,24.94,,29.62,,,,,89.43,,,,,,112.06,,,,,,,,,,,,,,,84.92,,,,,,,,,,,,,,,,,,,,,2.55,,APPROVED,Female,19.0,FALSE
964,2022-03-22 02:33:40,19,en,724196111,2022-03-22 02:28:14,2022-03-22 02:33:40,Y,Y,A1,,,3,,,,,,,,,,,,,,,,,,,,,,,,,,,,,,,,,13,,,,,,,,,,,,,,,,,,,,,,,,,,,,,,,,,11,,,,,,,,,,,,,,,,,,,,,,,,,,,,,,,,,6,,,,,,,,,,,,,,,,,,,,,,,,,,,,,,,,,2,4.0,2.0,5.0,5.0,4.0,6.0,1.0,6.0,3.0,4.0,4.0,5.0,5.0,4.0,4.0,4.0,4.0,6.0,5.0,4.0,4.0,5.0,7.0,5.0,2.0,6.0,5.0,6.0,5.0,6.0,6.0,5.0,9,,,,,,,,,,,,,,,,,,,,,,,,,,,,,,,,,14,,,,,,,,,,,,,,,,,,,,,,,,,,,,,,,,,7,,,,,,,,,,,,,,,,,,,,,,,,,,,,,,,,,5,,,,,,,,,,,,,,,,,,,,,,,,,,,,,,,,,1,1.0,6.0,4.0,4.0,4.0,3.0,7.0,4.0,5.0,2.0,3.0,3.0,3.0,4.0,5.0,4.0,5.0,1.0,2.0,3.0,4.0,4.0,5.0,2.0,2.0,3.0,7.0,4.0,3.0,2.0,4.0,3.0,0,5.0,7.0,6.0,4.0,5.0,3.0,5.0,7.0,7.0,5.0,3.0,6.0,5.0,6.0,6.0,4.0,6.0,5.0,6.0,4.0,4.0,4.0,6.0,4.0,5.0,2.0,7.0,6.0,2.0,5.0,5.0,4.0,4,,,,,,,,,,,,,,,,,,,,,,,,,,,,,,,,,10,,,,,,,,,,,,,,,,,,,,,,,,,,,,,,,,,12,,,,,,,,,,,,,,,,,,,,,,,,,,,,,,,,,8,,,,,,,,,,,,,,,,,,,,,,,,,,,,,,,,,No comments other than I have never seen a graph like the first one before. Really interesting way of displaying information!  Best of luck in your research!,327.81,23.16,,,,4.83,,32.76,,,,,,,,,,,,,,80.56,,,,,,,,,,,,,,,71.47,,,73.35,,,,,,,,,,,,,,,41.68,,APPROVED,Female,41.0,FALSE
965,2022-03-22 02:35:31,19,en,1196569068,2022-03-22 02:28:18,2022-03-22 02:35:31,Y,Y,A1,,,2,5.0,6.0,5.0,4.0,4.0,4.0,2.0,6.0,6.0,4.0,5.0,5.0,5.0,2.0,5.0,5.0,6.0,4.0,5.0,3.0,5.0,5.0,4.0,5.0,5.0,4.0,4.0,4.0,5.0,6.0,4.0,1.0,10,,,,,,,,,,,,,,,,,,,,,,,,,,,,,,,,,5,,,,,,,,,,,,,,,,,,,,,,,,,,,,,,,,,12,,,,,,,,,,,,,,,,,,,,,,,,,,,,,,,,,0,5.0,5.0,5.0,5.0,5.0,4.0,6.0,6.0,6.0,4.0,4.0,5.0,5.0,3.0,5.0,5.0,6.0,4.0,5.0,3.0,5.0,6.0,6.0,5.0,6.0,5.0,4.0,5.0,4.0,6.0,5.0,5.0,6,,,,,,,,,,,,,,,,,,,,,,,,,,,,,,,,,7,,,,,,,,,,,,,,,,,,,,,,,,,,,,,,,,,3,,,,,,,,,,,,,,,,,,,,,,,,,,,,,,,,,8,,,,,,,,,,,,,,,,,,,,,,,,,,,,,,,,,9,,,,,,,,,,,,,,,,,,,,,,,,,,,,,,,,,11,,,,,,,,,,,,,,,,,,,,,,,,,,,,,,,,,13,,,,,,,,,,,,,,,,,,,,,,,,,,,,,,,,,1,5.0,5.0,5.0,4.0,4.0,5.0,3.0,6.0,6.0,3.0,4.0,5.0,4.0,2.0,5.0,5.0,5.0,4.0,5.0,4.0,5.0,5.0,6.0,5.0,5.0,5.0,2.0,4.0,5.0,6.0,6.0,6.0,14,,,,,,,,,,,,,,,,,,,,,,,,,,,,,,,,,4,,,,,,,,,,,,,,,,,,,,,,,,,,,,,,,,,,435.11,20.98,,,,6.06,,76.36,,119.53,,,,,,,,,,,,102.54,,,,,,,,,,,,,,,,,,,,,,,,105.26,,,,,,,,,4.38,,APPROVED,Female,46.0,FALSE
966,2022-03-22 02:40:06,19,en,1907676141,2022-03-22 02:28:18,2022-03-22 02:40:06,Y,Y,A1,,,6,,,,,,,,,,,,,,,,,,,,,,,,,,,,,,,,,8,,,,,,,,,,,,,,,,,,,,,,,,,,,,,,,,,1,5.0,4.0,5.0,5.0,5.0,5.0,3.0,3.0,6.0,5.0,6.0,5.0,4.0,5.0,5.0,2.0,5.0,6.0,5.0,4.0,5.0,5.0,5.0,4.0,4.0,5.0,5.0,5.0,5.0,5.0,5.0,3.0,9,,,,,,,,,,,,,,,,,,,,,,,,,,,,,,,,,10,,,,,,,,,,,,,,,,,,,,,,,,,,,,,,,,,3,,,,,,,,,,,,,,,,,,,,,,,,,,,,,,,,,2,1.0,4.0,1.0,1.0,1.0,4.0,3.0,1.0,4.0,1.0,2.0,1.0,1.0,1.0,4.0,1.0,1.0,1.0,1.0,1.0,1.0,1.0,1.0,1.0,1.0,4.0,1.0,1.0,1.0,1.0,5.0,7.0,12,,,,,,,,,,,,,,,,,,,,,,,,,,,,,,,,,14,,,,,,,,,,,,,,,,,,,,,,,,,,,,,,,,,0,3.0,5.0,4.0,3.0,3.0,1.0,5.0,1.0,4.0,3.0,4.0,4.0,3.0,1.0,4.0,2.0,3.0,2.0,4.0,1.0,1.0,4.0,2.0,2.0,3.0,4.0,1.0,1.0,3.0,4.0,5.0,3.0,7,,,,,,,,,,,,,,,,,,,,,,,,,,,,,,,,,5,,,,,,,,,,,,,,,,,,,,,,,,,,,,,,,,,13,,,,,,,,,,,,,,,,,,,,,,,,,,,,,,,,,11,,,,,,,,,,,,,,,,,,,,,,,,,,,,,,,,,4,,,,,,,,,,,,,,,,,,,,,,,,,,,,,,,,,All good.,712.57,31.52,,,,8.16,,169.89,,,,,,,,109.82,,,,,,,,,,,,258.56,,,,,,,,,122.83,,,,,,,,,,,,,,,,,,11.79,,APPROVED,Female,46.0,FALSE
967,2022-03-22 02:47:03,19,en,86994700,2022-03-22 02:28:18,2022-03-22 02:47:03,Y,Y,-oth-,No degree,,11,,,,,,,,,,,,,,,,,,,,,,,,,,,,,,,,,7,,,,,,,,,,,,,,,,,,,,,,,,,,,,,,,,,9,,,,,,,,,,,,,,,,,,,,,,,,,,,,,,,,,10,,,,,,,,,,,,,,,,,,,,,,,,,,,,,,,,,4,,,,,,,,,,,,,,,,,,,,,,,,,,,,,,,,,13,,,,,,,,,,,,,,,,,,,,,,,,,,,,,,,,,3,,,,,,,,,,,,,,,,,,,,,,,,,,,,,,,,,14,,,,,,,,,,,,,,,,,,,,,,,,,,,,,,,,,8,,,,,,,,,,,,,,,,,,,,,,,,,,,,,,,,,5,,,,,,,,,,,,,,,,,,,,,,,,,,,,,,,,,2,4.0,5.0,3.0,3.0,4.0,4.0,5.0,5.0,6.0,2.0,3.0,5.0,4.0,3.0,3.0,4.0,5.0,2.0,2.0,2.0,2.0,2.0,4.0,4.0,1.0,4.0,6.0,2.0,5.0,2.0,5.0,4.0,12,,,,,,,,,,,,,,,,,,,,,,,,,,,,,,,,,1,3.0,4.0,4.0,5.0,4.0,4.0,4.0,5.0,5.0,3.0,5.0,4.0,4.0,3.0,5.0,5.0,5.0,3.0,4.0,4.0,3.0,4.0,5.0,5.0,3.0,4.0,4.0,3.0,4.0,4.0,4.0,6.0,0,5.0,6.0,5.0,5.0,4.0,5.0,2.0,5.0,7.0,3.0,5.0,6.0,6.0,5.0,5.0,5.0,6.0,5.0,5.0,4.0,5.0,4.0,6.0,6.0,5.0,6.0,2.0,5.0,5.0,4.0,6.0,7.0,6,,,,,,,,,,,,,,,,,,,,,,,,,,,,,,,,,,1129.1,58.33,,,,44.29,,51.78,,,,,,,,,,,,,,,,,,,,,,,,,,,,,,,,365.98,,,,,,267.1,,,335.01,,,,,,6.61,,APPROVED,Female,87.0,FALSE
968,2022-03-22 02:46:26,19,en,2006617191,2022-03-22 02:28:19,2022-03-22 02:46:26,Y,Y,A3,,,12,,,,,,,,,,,,,,,,,,,,,,,,,,,,,,,,,14,,,,,,,,,,,,,,,,,,,,,,,,,,,,,,,,,8,,,,,,,,,,,,,,,,,,,,,,,,,,,,,,,,,5,,,,,,,,,,,,,,,,,,,,,,,,,,,,,,,,,10,,,,,,,,,,,,,,,,,,,,,,,,,,,,,,,,,2,6.0,6.0,4.0,5.0,4.0,5.0,5.0,5.0,5.0,4.0,3.0,6.0,5.0,3.0,6.0,2.0,7.0,4.0,5.0,4.0,1.0,4.0,6.0,4.0,5.0,5.0,3.0,5.0,3.0,5.0,4.0,6.0,7,,,,,,,,,,,,,,,,,,,,,,,,,,,,,,,,,1,6.0,5.0,4.0,3.0,3.0,2.0,6.0,4.0,5.0,1.0,1.0,4.0,4.0,1.0,5.0,5.0,5.0,4.0,5.0,2.0,1.0,3.0,3.0,4.0,3.0,5.0,1.0,4.0,1.0,4.0,4.0,1.0,0,6.0,6.0,5.0,5.0,6.0,4.0,1.0,7.0,6.0,5.0,5.0,5.0,6.0,1.0,6.0,5.0,6.0,5.0,6.0,5.0,6.0,5.0,5.0,6.0,4.0,5.0,2.0,6.0,6.0,5.0,5.0,2.0,9,,,,,,,,,,,,,,,,,,,,,,,,,,,,,,,,,3,,,,,,,,,,,,,,,,,,,,,,,,,,,,,,,,,6,,,,,,,,,,,,,,,,,,,,,,,,,,,,,,,,,13,,,,,,,,,,,,,,,,,,,,,,,,,,,,,,,,,11,,,,,,,,,,,,,,,,,,,,,,,,,,,,,,,,,4,,,,,,,,,,,,,,,,,,,,,,,,,,,,,,,,,"After the last task I got the error - Internal Server Error
CDbConnection failed to open the DB connection.
An internal error occurred while the Web server was processing your request. Please contact the webmaster to report this problem.

Thank you.

2022-03-22 02:45:00",1089.38,346.7,,,,8.61,,62.07,,,,,,,,,,,,,,,,,277.18,,,,,,196.21,,,163.77,,,,,,,,,,,,,,,,,,,,,34.84,,APPROVED,Female,39.0,FALSE
969,2022-03-22 02:35:49,19,en,134722477,2022-03-22 02:28:22,2022-03-22 02:35:49,Y,Y,A1,,,8,,,,,,,,,,,,,,,,,,,,,,,,,,,,,,,,,11,,,,,,,,,,,,,,,,,,,,,,,,,,,,,,,,,12,,,,,,,,,,,,,,,,,,,,,,,,,,,,,,,,,1,3.0,3.0,4.0,3.0,3.0,3.0,5.0,3.0,5.0,4.0,4.0,4.0,4.0,3.0,3.0,4.0,4.0,3.0,4.0,4.0,3.0,4.0,4.0,4.0,3.0,4.0,3.0,4.0,5.0,3.0,4.0,4.0,6,,,,,,,,,,,,,,,,,,,,,,,,,,,,,,,,,3,,,,,,,,,,,,,,,,,,,,,,,,,,,,,,,,,2,2.0,4.0,3.0,3.0,3.0,3.0,4.0,5.0,4.0,3.0,3.0,3.0,3.0,3.0,3.0,4.0,4.0,3.0,3.0,3.0,3.0,3.0,3.0,3.0,3.0,2.0,3.0,3.0,3.0,3.0,4.0,7.0,5,,,,,,,,,,,,,,,,,,,,,,,,,,,,,,,,,10,,,,,,,,,,,,,,,,,,,,,,,,,,,,,,,,,14,,,,,,,,,,,,,,,,,,,,,,,,,,,,,,,,,0,4.0,6.0,4.0,3.0,4.0,3.0,5.0,5.0,5.0,4.0,5.0,5.0,4.0,3.0,4.0,4.0,5.0,4.0,4.0,4.0,3.0,5.0,3.0,4.0,5.0,2.0,4.0,5.0,4.0,4.0,5.0,4.0,4,,,,,,,,,,,,,,,,,,,,,,,,,,,,,,,,,13,,,,,,,,,,,,,,,,,,,,,,,,,,,,,,,,,7,,,,,,,,,,,,,,,,,,,,,,,,,,,,,,,,,9,,,,,,,,,,,,,,,,,,,,,,,,,,,,,,,,,,450.41,30.48,,,,18.56,,47.61,,,,,,,,,,,110.06,,,,,,,,,109.72,,,,,,,,,,,,129.37,,,,,,,,,,,,,,,4.61,,APPROVED,Male,26.0,FALSE
970,2022-03-22 02:32:36,19,en,1198813194,2022-03-22 02:28:23,2022-03-22 02:32:36,Y,Y,-oth-,A-Levels,,4,,,,,,,,,,,,,,,,,,,,,,,,,,,,,,,,,1,3.0,4.0,5.0,5.0,4.0,2.0,3.0,5.0,3.0,4.0,2.0,5.0,5.0,3.0,2.0,2.0,5.0,5.0,3.0,5.0,2.0,5.0,5.0,3.0,2.0,6.0,5.0,3.0,2.0,4.0,5.0,2.0,9,,,,,,,,,,,,,,,,,,,,,,,,,,,,,,,,,0,5.0,6.0,2.0,3.0,6.0,5.0,5.0,5.0,5.0,4.0,6.0,5.0,4.0,6.0,5.0,5.0,3.0,2.0,4.0,4.0,4.0,5.0,5.0,5.0,3.0,6.0,5.0,4.0,6.0,3.0,5.0,4.0,7,,,,,,,,,,,,,,,,,,,,,,,,,,,,,,,,,12,,,,,,,,,,,,,,,,,,,,,,,,,,,,,,,,,5,,,,,,,,,,,,,,,,,,,,,,,,,,,,,,,,,14,,,,,,,,,,,,,,,,,,,,,,,,,,,,,,,,,11,,,,,,,,,,,,,,,,,,,,,,,,,,,,,,,,,2,1.0,1.0,1.0,1.0,1.0,1.0,6.0,1.0,1.0,1.0,1.0,1.0,1.0,2.0,1.0,1.0,1.0,1.0,1.0,1.0,1.0,1.0,2.0,1.0,1.0,3.0,2.0,1.0,1.0,1.0,2.0,3.0,3,,,,,,,,,,,,,,,,,,,,,,,,,,,,,,,,,13,,,,,,,,,,,,,,,,,,,,,,,,,,,,,,,,,8,,,,,,,,,,,,,,,,,,,,,,,,,,,,,,,,,10,,,,,,,,,,,,,,,,,,,,,,,,,,,,,,,,,6,,,,,,,,,,,,,,,,,,,,,,,,,,,,,,,,,/,252.31,11.68,,,,9.67,,33.48,,,,,79.92,,,,,,71.2,,,,,,,,,,,,,,,,,,43.26,,,,,,,,,,,,,,,,,,3.1,,APPROVED,Male,21.0,FALSE
971,2022-03-22 02:31:17,19,en,1884475981,2022-03-22 02:28:25,2022-03-22 02:31:17,Y,Y,A1,,,2,4.0,4.0,6.0,5.0,6.0,6.0,6.0,5.0,3.0,3.0,4.0,3.0,5.0,4.0,6.0,4.0,3.0,5.0,5.0,5.0,5.0,3.0,3.0,5.0,4.0,3.0,4.0,6.0,5.0,5.0,4.0,1.0,12,,,,,,,,,,,,,,,,,,,,,,,,,,,,,,,,,6,,,,,,,,,,,,,,,,,,,,,,,,,,,,,,,,,8,,,,,,,,,,,,,,,,,,,,,,,,,,,,,,,,,14,,,,,,,,,,,,,,,,,,,,,,,,,,,,,,,,,4,,,,,,,,,,,,,,,,,,,,,,,,,,,,,,,,,1,1.0,4.0,3.0,4.0,3.0,3.0,4.0,5.0,3.0,3.0,4.0,2.0,5.0,3.0,3.0,5.0,3.0,4.0,4.0,3.0,3.0,5.0,4.0,3.0,4.0,5.0,3.0,3.0,3.0,3.0,4.0,7.0,0,3.0,2.0,4.0,4.0,4.0,5.0,7.0,5.0,5.0,5.0,4.0,3.0,4.0,3.0,3.0,3.0,3.0,4.0,4.0,4.0,2.0,3.0,2.0,3.0,3.0,5.0,3.0,3.0,4.0,4.0,3.0,1.0,10,,,,,,,,,,,,,,,,,,,,,,,,,,,,,,,,,7,,,,,,,,,,,,,,,,,,,,,,,,,,,,,,,,,13,,,,,,,,,,,,,,,,,,,,,,,,,,,,,,,,,3,,,,,,,,,,,,,,,,,,,,,,,,,,,,,,,,,11,,,,,,,,,,,,,,,,,,,,,,,,,,,,,,,,,9,,,,,,,,,,,,,,,,,,,,,,,,,,,,,,,,,5,,,,,,,,,,,,,,,,,,,,,,,,,,,,,,,,,,175.32,22.49,,,,5.91,,27.24,,26.14,,,,,,,,,,,,,,,,,,56.27,,,34.39,,,,,,,,,,,,,,,,,,,,,,,,2.88,,APPROVED,Male,41.0,FALSE
972,2022-03-22 02:32:21,19,en,36585459,2022-03-22 02:28:26,2022-03-22 02:32:21,Y,Y,A2,,,11,,,,,,,,,,,,,,,,,,,,,,,,,,,,,,,,,9,,,,,,,,,,,,,,,,,,,,,,,,,,,,,,,,,12,,,,,,,,,,,,,,,,,,,,,,,,,,,,,,,,,8,,,,,,,,,,,,,,,,,,,,,,,,,,,,,,,,,10,,,,,,,,,,,,,,,,,,,,,,,,,,,,,,,,,4,,,,,,,,,,,,,,,,,,,,,,,,,,,,,,,,,6,,,,,,,,,,,,,,,,,,,,,,,,,,,,,,,,,13,,,,,,,,,,,,,,,,,,,,,,,,,,,,,,,,,3,,,,,,,,,,,,,,,,,,,,,,,,,,,,,,,,,1,1.0,1.0,1.0,1.0,1.0,1.0,7.0,1.0,1.0,1.0,1.0,1.0,1.0,1.0,1.0,1.0,6.0,1.0,1.0,1.0,1.0,1.0,1.0,1.0,1.0,1.0,1.0,1.0,1.0,1.0,1.0,3.0,0,1.0,1.0,1.0,1.0,1.0,1.0,7.0,1.0,3.0,1.0,1.0,1.0,1.0,1.0,1.0,1.0,1.0,1.0,1.0,1.0,1.0,1.0,1.0,1.0,1.0,1.0,1.0,1.0,1.0,1.0,1.0,4.0,5,,,,,,,,,,,,,,,,,,,,,,,,,,,,,,,,,14,,,,,,,,,,,,,,,,,,,,,,,,,,,,,,,,,7,,,,,,,,,,,,,,,,,,,,,,,,,,,,,,,,,2,1.0,1.0,1.0,1.0,1.0,1.0,7.0,1.0,1.0,1.0,1.0,1.0,1.0,1.0,1.0,1.0,1.0,1.0,1.0,1.0,1.0,1.0,1.0,1.0,1.0,1.0,1.0,1.0,1.0,1.0,1.0,1.0,Never seen these visualizations before ,237.52,35.49,,,,5.99,,21.33,,,,,,,,,,,,,,,,,,,,,,,,,,,,,32.21,,,37.77,,,,,,,,,,,,25.59,,,79.14,,APPROVED,Female,24.0,FALSE
973,2022-03-22 02:36:44,19,en,1049233670,2022-03-22 02:28:27,2022-03-22 02:36:44,Y,Y,-oth-,HND,,4,,,,,,,,,,,,,,,,,,,,,,,,,,,,,,,,,8,,,,,,,,,,,,,,,,,,,,,,,,,,,,,,,,,5,,,,,,,,,,,,,,,,,,,,,,,,,,,,,,,,,14,,,,,,,,,,,,,,,,,,,,,,,,,,,,,,,,,13,,,,,,,,,,,,,,,,,,,,,,,,,,,,,,,,,7,,,,,,,,,,,,,,,,,,,,,,,,,,,,,,,,,2,7.0,7.0,7.0,6.0,7.0,5.0,3.0,7.0,7.0,5.0,6.0,7.0,6.0,5.0,6.0,7.0,7.0,6.0,7.0,7.0,5.0,6.0,4.0,7.0,4.0,6.0,4.0,5.0,6.0,6.0,7.0,7.0,3,,,,,,,,,,,,,,,,,,,,,,,,,,,,,,,,,12,,,,,,,,,,,,,,,,,,,,,,,,,,,,,,,,,6,,,,,,,,,,,,,,,,,,,,,,,,,,,,,,,,,9,,,,,,,,,,,,,,,,,,,,,,,,,,,,,,,,,0,7.0,7.0,7.0,7.0,7.0,5.0,1.0,7.0,7.0,7.0,6.0,7.0,7.0,6.0,7.0,6.0,7.0,7.0,7.0,7.0,7.0,7.0,4.0,7.0,7.0,6.0,6.0,7.0,6.0,6.0,7.0,5.0,11,,,,,,,,,,,,,,,,,,,,,,,,,,,,,,,,,1,2.0,5.0,2.0,6.0,2.0,3.0,6.0,7.0,5.0,2.0,1.0,6.0,3.0,6.0,5.0,1.0,7.0,2.0,2.0,1.0,5.0,2.0,4.0,1.0,2.0,4.0,7.0,4.0,4.0,3.0,6.0,7.0,10,,,,,,,,,,,,,,,,,,,,,,,,,,,,,,,,,,502.55,75.65,,,,20.1,,22.32,,,,,,,,,,,,,,,,,,,,85.72,,,,,,,,,,,,,,,180.54,,,,,,109.85,,,,,,8.37,,APPROVED,Female,51.0,FALSE
974,2022-03-22 02:33:38,19,en,718906816,2022-03-22 02:28:27,2022-03-22 02:33:38,Y,Y,A1,,,8,,,,,,,,,,,,,,,,,,,,,,,,,,,,,,,,,4,,,,,,,,,,,,,,,,,,,,,,,,,,,,,,,,,13,,,,,,,,,,,,,,,,,,,,,,,,,,,,,,,,,5,,,,,,,,,,,,,,,,,,,,,,,,,,,,,,,,,12,,,,,,,,,,,,,,,,,,,,,,,,,,,,,,,,,0,2.0,5.0,2.0,2.0,2.0,2.0,2.0,3.0,6.0,2.0,2.0,2.0,2.0,2.0,6.0,2.0,6.0,2.0,2.0,2.0,2.0,3.0,2.0,2.0,2.0,3.0,2.0,3.0,3.0,3.0,2.0,6.0,11,,,,,,,,,,,,,,,,,,,,,,,,,,,,,,,,,1,2.0,2.0,2.0,2.0,2.0,2.0,6.0,1.0,2.0,2.0,2.0,5.0,2.0,2.0,2.0,2.0,5.0,2.0,2.0,2.0,2.0,2.0,3.0,2.0,3.0,5.0,3.0,2.0,2.0,2.0,3.0,1.0,10,,,,,,,,,,,,,,,,,,,,,,,,,,,,,,,,,14,,,,,,,,,,,,,,,,,,,,,,,,,,,,,,,,,9,,,,,,,,,,,,,,,,,,,,,,,,,,,,,,,,,3,,,,,,,,,,,,,,,,,,,,,,,,,,,,,,,,,2,2.0,5.0,3.0,5.0,1.0,2.0,5.0,1.0,6.0,2.0,2.0,2.0,2.0,2.0,2.0,1.0,5.0,2.0,2.0,2.0,2.0,2.0,2.0,2.0,2.0,4.0,2.0,2.0,3.0,2.0,2.0,6.0,6,,,,,,,,,,,,,,,,,,,,,,,,,,,,,,,,,7,,,,,,,,,,,,,,,,,,,,,,,,,,,,,,,,,,313.19,9.33,,,,11.5,,27.76,,,,,,,,,,,,,,,,,65.36,,,,,,75.63,,,,,,,,,,,,,,,121.04,,,,,,,,,2.57,,APPROVED,Male,26.0,FALSE
975,2022-03-22 02:35:19,19,en,1220732577,2022-03-22 02:28:28,2022-03-22 02:35:19,Y,Y,A1,,,3,,,,,,,,,,,,,,,,,,,,,,,,,,,,,,,,,2,7.0,3.0,7.0,6.0,5.0,7.0,2.0,7.0,2.0,7.0,7.0,7.0,7.0,7.0,7.0,7.0,7.0,7.0,7.0,7.0,7.0,7.0,7.0,7.0,7.0,7.0,7.0,7.0,7.0,7.0,7.0,2.0,9,,,,,,,,,,,,,,,,,,,,,,,,,,,,,,,,,13,,,,,,,,,,,,,,,,,,,,,,,,,,,,,,,,,4,,,,,,,,,,,,,,,,,,,,,,,,,,,,,,,,,10,,,,,,,,,,,,,,,,,,,,,,,,,,,,,,,,,5,,,,,,,,,,,,,,,,,,,,,,,,,,,,,,,,,12,,,,,,,,,,,,,,,,,,,,,,,,,,,,,,,,,2,2.0,1.0,2.0,5.0,3.0,3.0,5.0,4.0,2.0,2.0,2.0,6.0,2.0,1.0,2.0,5.0,5.0,2.0,1.0,4.0,4.0,5.0,4.0,4.0,2.0,4.0,5.0,3.0,5.0,4.0,3.0,2.0,0,5.0,6.0,5.0,2.0,4.0,1.0,6.0,6.0,4.0,2.0,4.0,6.0,4.0,2.0,4.0,2.0,7.0,1.0,4.0,3.0,5.0,3.0,1.0,3.0,3.0,2.0,6.0,4.0,1.0,3.0,2.0,3.0,14,,,,,,,,,,,,,,,,,,,,,,,,,,,,,,,,,7,,,,,,,,,,,,,,,,,,,,,,,,,,,,,,,,,8,,,,,,,,,,,,,,,,,,,,,,,,,,,,,,,,,11,,,,,,,,,,,,,,,,,,,,,,,,,,,,,,,,,6,,,,,,,,,,,,,,,,,,,,,,,,,,,,,,,,,,416.37,27.69,,,,20.23,,10.53,,,,,73.04,,,,,,,,,,,,,,,,,,,,,178.47,,,102.82,,,,,,,,,,,,,,,,,,3.59,,APPROVED,Male,25.0,FALSE
976,2022-03-22 02:34:31,19,en,1480969731,2022-03-22 02:28:30,2022-03-22 02:34:31,Y,Y,-oth-,certHE,,8,,,,,,,,,,,,,,,,,,,,,,,,,,,,,,,,,6,,,,,,,,,,,,,,,,,,,,,,,,,,,,,,,,,4,,,,,,,,,,,,,,,,,,,,,,,,,,,,,,,,,14,,,,,,,,,,,,,,,,,,,,,,,,,,,,,,,,,9,,,,,,,,,,,,,,,,,,,,,,,,,,,,,,,,,0,2.0,3.0,2.0,2.0,3.0,3.0,7.0,2.0,3.0,2.0,1.0,2.0,2.0,3.0,4.0,2.0,3.0,2.0,3.0,2.0,2.0,2.0,1.0,3.0,3.0,2.0,4.0,1.0,3.0,2.0,2.0,6.0,13,,,,,,,,,,,,,,,,,,,,,,,,,,,,,,,,,11,,,,,,,,,,,,,,,,,,,,,,,,,,,,,,,,,5,,,,,,,,,,,,,,,,,,,,,,,,,,,,,,,,,10,,,,,,,,,,,,,,,,,,,,,,,,,,,,,,,,,3,,,,,,,,,,,,,,,,,,,,,,,,,,,,,,,,,7,,,,,,,,,,,,,,,,,,,,,,,,,,,,,,,,,2,5.0,2.0,5.0,5.0,2.0,5.0,2.0,4.0,2.0,2.0,5.0,4.0,3.0,3.0,5.0,3.0,5.0,5.0,5.0,2.0,3.0,4.0,5.0,4.0,2.0,6.0,5.0,5.0,5.0,5.0,5.0,6.0,12,,,,,,,,,,,,,,,,,,,,,,,,,,,,,,,,,1,4.0,4.0,3.0,2.0,2.0,1.0,5.0,4.0,3.0,2.0,1.0,2.0,3.0,3.0,4.0,2.0,2.0,2.0,2.0,2.0,3.0,3.0,2.0,3.0,4.0,2.0,3.0,2.0,3.0,2.0,2.0,1.0,,364.06,16.47,,,,19.46,,23.24,,,,,,,,,,,,,,,,,172.48,,,,,,,,,,,,,,,,,,,,,63.22,,,,,,64.21,,,4.98,,APPROVED,Male,42.0,FALSE
977,2022-03-22 02:33:44,19,en,1848486118,2022-03-22 02:28:31,2022-03-22 02:33:44,Y,Y,A2,,,0,3.0,4.0,4.0,5.0,4.0,2.0,6.0,5.0,4.0,3.0,4.0,5.0,4.0,5.0,3.0,5.0,5.0,3.0,3.0,3.0,4.0,3.0,3.0,4.0,4.0,4.0,5.0,3.0,6.0,4.0,5.0,1.0,1,5.0,6.0,6.0,6.0,6.0,5.0,6.0,6.0,6.0,6.0,7.0,5.0,5.0,6.0,5.0,6.0,6.0,6.0,5.0,5.0,4.0,6.0,7.0,6.0,6.0,6.0,6.0,6.0,5.0,6.0,6.0,2.0,13,,,,,,,,,,,,,,,,,,,,,,,,,,,,,,,,,8,,,,,,,,,,,,,,,,,,,,,,,,,,,,,,,,,2,6.0,6.0,6.0,4.0,5.0,5.0,6.0,5.0,5.0,5.0,4.0,6.0,6.0,5.0,5.0,4.0,5.0,4.0,6.0,5.0,6.0,5.0,7.0,6.0,5.0,6.0,5.0,5.0,6.0,5.0,5.0,5.0,6,,,,,,,,,,,,,,,,,,,,,,,,,,,,,,,,,7,,,,,,,,,,,,,,,,,,,,,,,,,,,,,,,,,11,,,,,,,,,,,,,,,,,,,,,,,,,,,,,,,,,12,,,,,,,,,,,,,,,,,,,,,,,,,,,,,,,,,10,,,,,,,,,,,,,,,,,,,,,,,,,,,,,,,,,4,,,,,,,,,,,,,,,,,,,,,,,,,,,,,,,,,5,,,,,,,,,,,,,,,,,,,,,,,,,,,,,,,,,14,,,,,,,,,,,,,,,,,,,,,,,,,,,,,,,,,9,,,,,,,,,,,,,,,,,,,,,,,,,,,,,,,,,3,,,,,,,,,,,,,,,,,,,,,,,,,,,,,,,,,,315.37,18.27,,,,5.14,,13.41,,212.12,,,32.33,,,,,,,,,31.68,,,,,,,,,,,,,,,,,,,,,,,,,,,,,,,,,2.42,,APPROVED,Female,22.0,FALSE
978,2022-03-22 02:32:26,19,en,685757772,2022-03-22 02:28:31,2022-03-22 02:32:26,Y,Y,A1,,,13,,,,,,,,,,,,,,,,,,,,,,,,,,,,,,,,,14,,,,,,,,,,,,,,,,,,,,,,,,,,,,,,,,,2,4.0,7.0,2.0,5.0,1.0,4.0,3.0,6.0,5.0,1.0,1.0,1.0,1.0,1.0,4.0,5.0,5.0,1.0,1.0,1.0,1.0,1.0,5.0,5.0,1.0,6.0,1.0,5.0,4.0,1.0,5.0,3.0,10,,,,,,,,,,,,,,,,,,,,,,,,,,,,,,,,,7,,,,,,,,,,,,,,,,,,,,,,,,,,,,,,,,,3,,,,,,,,,,,,,,,,,,,,,,,,,,,,,,,,,8,,,,,,,,,,,,,,,,,,,,,,,,,,,,,,,,,1,1.0,5.0,1.0,5.0,1.0,5.0,5.0,5.0,4.0,1.0,1.0,1.0,1.0,1.0,5.0,1.0,6.0,1.0,1.0,1.0,1.0,1.0,6.0,1.0,1.0,6.0,1.0,1.0,5.0,1.0,6.0,1.0,5,,,,,,,,,,,,,,,,,,,,,,,,,,,,,,,,,9,,,,,,,,,,,,,,,,,,,,,,,,,,,,,,,,,6,,,,,,,,,,,,,,,,,,,,,,,,,,,,,,,,,11,,,,,,,,,,,,,,,,,,,,,,,,,,,,,,,,,12,,,,,,,,,,,,,,,,,,,,,,,,,,,,,,,,,0,1.0,1.0,1.0,1.0,1.0,2.0,5.0,6.0,4.0,1.0,1.0,1.0,1.0,1.0,5.0,1.0,6.0,1.0,1.0,1.0,1.0,1.0,5.0,1.0,1.0,6.0,1.0,1.0,4.0,1.0,5.0,7.0,4,,,,,,,,,,,,,,,,,,,,,,,,,,,,,,,,,,237.62,28.32,,,,5.71,,26.41,,,,,,,,54.08,,,,,,,,,,,,,,,51.17,,,,,,,,,,,,,,,,,,69.1,,,,,,2.83,,APPROVED,Female,22.0,FALSE
979,2022-03-22 02:34:28,19,en,1921921245,2022-03-22 02:28:34,2022-03-22 02:34:28,Y,Y,A1,,,7,,,,,,,,,,,,,,,,,,,,,,,,,,,,,,,,,11,,,,,,,,,,,,,,,,,,,,,,,,,,,,,,,,,14,,,,,,,,,,,,,,,,,,,,,,,,,,,,,,,,,8,,,,,,,,,,,,,,,,,,,,,,,,,,,,,,,,,3,,,,,,,,,,,,,,,,,,,,,,,,,,,,,,,,,9,,,,,,,,,,,,,,,,,,,,,,,,,,,,,,,,,4,,,,,,,,,,,,,,,,,,,,,,,,,,,,,,,,,12,,,,,,,,,,,,,,,,,,,,,,,,,,,,,,,,,10,,,,,,,,,,,,,,,,,,,,,,,,,,,,,,,,,5,,,,,,,,,,,,,,,,,,,,,,,,,,,,,,,,,2,3.0,7.0,6.0,2.0,4.0,2.0,6.0,2.0,6.0,4.0,5.0,6.0,3.0,6.0,6.0,2.0,7.0,2.0,5.0,2.0,4.0,5.0,1.0,4.0,6.0,1.0,4.0,5.0,5.0,4.0,2.0,4.0,6,,,,,,,,,,,,,,,,,,,,,,,,,,,,,,,,,13,,,,,,,,,,,,,,,,,,,,,,,,,,,,,,,,,1,4.0,6.0,6.0,5.0,3.0,5.0,6.0,6.0,4.0,4.0,2.0,5.0,6.0,4.0,7.0,2.0,6.0,5.0,6.0,4.0,4.0,6.0,5.0,5.0,2.0,5.0,5.0,6.0,4.0,2.0,6.0,7.0,0,3.0,6.0,1.0,1.0,5.0,2.0,7.0,5.0,6.0,1.0,2.0,3.0,1.0,5.0,6.0,1.0,6.0,2.0,1.0,2.0,1.0,2.0,1.0,1.0,2.0,2.0,2.0,3.0,2.0,2.0,2.0,1.0,,348.87,20.74,,,,9.06,,32.72,,,,,,,,,,,,,,,,,,,,,,,,,,,,,,,,79.78,,,,,,,,,99.38,,,99.57,,,7.62,,APPROVED,Male,24.0,FALSE
980,2022-03-22 02:36:03,19,en,979216744,2022-03-22 02:28:37,2022-03-22 02:36:03,Y,Y,-oth-,A Level,,14,,,,,,,,,,,,,,,,,,,,,,,,,,,,,,,,,13,,,,,,,,,,,,,,,,,,,,,,,,,,,,,,,,,10,,,,,,,,,,,,,,,,,,,,,,,,,,,,,,,,,0,5.0,6.0,3.0,5.0,5.0,6.0,2.0,5.0,5.0,3.0,3.0,5.0,5.0,2.0,7.0,5.0,7.0,3.0,3.0,3.0,2.0,5.0,3.0,3.0,2.0,2.0,2.0,3.0,3.0,5.0,5.0,4.0,2,1.0,1.0,1.0,5.0,2.0,2.0,6.0,3.0,1.0,1.0,1.0,1.0,1.0,1.0,2.0,1.0,1.0,1.0,2.0,1.0,1.0,2.0,3.0,1.0,1.0,6.0,2.0,2.0,1.0,1.0,2.0,5.0,1,5.0,3.0,6.0,4.0,6.0,5.0,2.0,6.0,5.0,5.0,3.0,5.0,5.0,3.0,5.0,5.0,5.0,3.0,6.0,5.0,3.0,6.0,6.0,6.0,6.0,3.0,3.0,5.0,2.0,6.0,5.0,6.0,9,,,,,,,,,,,,,,,,,,,,,,,,,,,,,,,,,5,,,,,,,,,,,,,,,,,,,,,,,,,,,,,,,,,7,,,,,,,,,,,,,,,,,,,,,,,,,,,,,,,,,6,,,,,,,,,,,,,,,,,,,,,,,,,,,,,,,,,4,,,,,,,,,,,,,,,,,,,,,,,,,,,,,,,,,12,,,,,,,,,,,,,,,,,,,,,,,,,,,,,,,,,8,,,,,,,,,,,,,,,,,,,,,,,,,,,,,,,,,11,,,,,,,,,,,,,,,,,,,,,,,,,,,,,,,,,3,,,,,,,,,,,,,,,,,,,,,,,,,,,,,,,,,,448.65,44.22,,,,44.18,,34.18,,,,,,,,,,,109.46,,,67.84,,,144.15,,,,,,,,,,,,,,,,,,,,,,,,,,,,,,4.62,,APPROVED,Male,22.0,FALSE
981,2022-03-22 02:36:35,19,en,1209328413,2022-03-22 02:29:06,2022-03-22 02:36:35,Y,Y,A2,,,14,,,,,,,,,,,,,,,,,,,,,,,,,,,,,,,,,5,,,,,,,,,,,,,,,,,,,,,,,,,,,,,,,,,1,4.0,4.0,5.0,5.0,5.0,3.0,4.0,5.0,3.0,5.0,4.0,5.0,4.0,5.0,3.0,5.0,3.0,5.0,5.0,5.0,3.0,5.0,5.0,5.0,4.0,5.0,5.0,5.0,4.0,4.0,5.0,3.0,4,,,,,,,,,,,,,,,,,,,,,,,,,,,,,,,,,13,,,,,,,,,,,,,,,,,,,,,,,,,,,,,,,,,0,6.0,6.0,5.0,5.0,6.0,3.0,5.0,6.0,6.0,3.0,6.0,6.0,4.0,6.0,6.0,3.0,6.0,5.0,6.0,6.0,4.0,6.0,3.0,5.0,5.0,5.0,4.0,6.0,5.0,4.0,6.0,6.0,6,,,,,,,,,,,,,,,,,,,,,,,,,,,,,,,,,11,,,,,,,,,,,,,,,,,,,,,,,,,,,,,,,,,10,,,,,,,,,,,,,,,,,,,,,,,,,,,,,,,,,9,,,,,,,,,,,,,,,,,,,,,,,,,,,,,,,,,7,,,,,,,,,,,,,,,,,,,,,,,,,,,,,,,,,8,,,,,,,,,,,,,,,,,,,,,,,,,,,,,,,,,2,3.0,3.0,3.0,5.0,3.0,3.0,5.0,1.0,3.0,3.0,4.0,5.0,4.0,3.0,5.0,3.0,5.0,4.0,5.0,4.0,3.0,5.0,2.0,3.0,4.0,6.0,4.0,4.0,3.0,3.0,5.0,6.0,12,,,,,,,,,,,,,,,,,,,,,,,,,,,,,,,,,3,,,,,,,,,,,,,,,,,,,,,,,,,,,,,,,,,,452.99,18.59,,,,8.77,,76.85,,,,,,,,123.13,,,,,,,,,107.19,,,,,,,,,,,,,,,,,,,,,113.52,,,,,,,,,4.94,,APPROVED,Male,26.0,FALSE
982,2022-03-22 02:43:57,19,en,777034299,2022-03-22 02:29:06,2022-03-22 02:43:57,Y,Y,A1,,,8,,,,,,,,,,,,,,,,,,,,,,,,,,,,,,,,,4,,,,,,,,,,,,,,,,,,,,,,,,,,,,,,,,,0,5.0,6.0,6.0,4.0,6.0,3.0,6.0,5.0,6.0,4.0,5.0,4.0,6.0,6.0,6.0,4.0,6.0,3.0,3.0,4.0,3.0,4.0,3.0,5.0,6.0,3.0,5.0,5.0,3.0,4.0,4.0,5.0,13,,,,,,,,,,,,,,,,,,,,,,,,,,,,,,,,,3,,,,,,,,,,,,,,,,,,,,,,,,,,,,,,,,,9,,,,,,,,,,,,,,,,,,,,,,,,,,,,,,,,,1,2.0,2.0,2.0,2.0,3.0,3.0,6.0,4.0,6.0,2.0,3.0,3.0,2.0,3.0,5.0,2.0,6.0,2.0,2.0,2.0,2.0,2.0,2.0,3.0,3.0,2.0,6.0,2.0,2.0,2.0,4.0,7.0,14,,,,,,,,,,,,,,,,,,,,,,,,,,,,,,,,,11,,,,,,,,,,,,,,,,,,,,,,,,,,,,,,,,,12,,,,,,,,,,,,,,,,,,,,,,,,,,,,,,,,,6,,,,,,,,,,,,,,,,,,,,,,,,,,,,,,,,,5,,,,,,,,,,,,,,,,,,,,,,,,,,,,,,,,,10,,,,,,,,,,,,,,,,,,,,,,,,,,,,,,,,,7,,,,,,,,,,,,,,,,,,,,,,,,,,,,,,,,,2,2.0,2.0,1.0,2.0,1.0,2.0,6.0,5.0,4.0,1.0,1.0,2.0,2.0,2.0,5.0,1.0,2.0,1.0,2.0,1.0,2.0,1.0,1.0,1.0,1.0,1.0,6.0,2.0,1.0,1.0,1.0,1.0,,893.68,370.43,,,,4.64,,76.29,,,,,,,,84.58,,,,,,,,,,,,130.09,,,,,,,,,,,,,,,,,,,,,,,,224.53,,,3.12,,APPROVED,Male,29.0,FALSE
983,2022-03-22 02:35:50,19,en,1002975870,2022-03-22 02:29:38,2022-03-22 02:35:49,Y,Y,A1,,,9,,,,,,,,,,,,,,,,,,,,,,,,,,,,,,,,,6,,,,,,,,,,,,,,,,,,,,,,,,,,,,,,,,,10,,,,,,,,,,,,,,,,,,,,,,,,,,,,,,,,,2,7.0,7.0,6.0,6.0,6.0,5.0,3.0,7.0,7.0,6.0,7.0,6.0,6.0,6.0,7.0,6.0,7.0,7.0,6.0,7.0,6.0,7.0,6.0,7.0,7.0,7.0,2.0,5.0,6.0,5.0,7.0,4.0,5,,,,,,,,,,,,,,,,,,,,,,,,,,,,,,,,,8,,,,,,,,,,,,,,,,,,,,,,,,,,,,,,,,,3,,,,,,,,,,,,,,,,,,,,,,,,,,,,,,,,,7,,,,,,,,,,,,,,,,,,,,,,,,,,,,,,,,,0,5.0,5.0,2.0,3.0,3.0,1.0,4.0,1.0,5.0,2.0,2.0,5.0,4.0,2.0,5.0,1.0,6.0,3.0,3.0,4.0,5.0,3.0,4.0,4.0,3.0,6.0,5.0,3.0,6.0,4.0,5.0,2.0,4,,,,,,,,,,,,,,,,,,,,,,,,,,,,,,,,,13,,,,,,,,,,,,,,,,,,,,,,,,,,,,,,,,,1,5.0,7.0,6.0,4.0,6.0,4.0,3.0,6.0,7.0,6.0,6.0,4.0,5.0,5.0,7.0,5.0,7.0,6.0,7.0,6.0,4.0,7.0,4.0,6.0,6.0,5.0,2.0,5.0,6.0,4.0,7.0,5.0,14,,,,,,,,,,,,,,,,,,,,,,,,,,,,,,,,,12,,,,,,,,,,,,,,,,,,,,,,,,,,,,,,,,,11,,,,,,,,,,,,,,,,,,,,,,,,,,,,,,,,,,374.88,49.85,,,,7.19,,45.71,,,,,,,,,,,73.0,,,,,,,,,,,,,,,113.26,,,,,,,,,79.87,,,,,,,,,,,,6.0,,APPROVED,Female,28.0,FALSE
984,2022-03-22 02:37:33,19,en,729216172,2022-03-22 02:30:22,2022-03-22 02:37:33,Y,Y,A1,,,13,,,,,,,,,,,,,,,,,,,,,,,,,,,,,,,,,11,,,,,,,,,,,,,,,,,,,,,,,,,,,,,,,,,10,,,,,,,,,,,,,,,,,,,,,,,,,,,,,,,,,6,,,,,,,,,,,,,,,,,,,,,,,,,,,,,,,,,3,,,,,,,,,,,,,,,,,,,,,,,,,,,,,,,,,9,,,,,,,,,,,,,,,,,,,,,,,,,,,,,,,,,4,,,,,,,,,,,,,,,,,,,,,,,,,,,,,,,,,8,,,,,,,,,,,,,,,,,,,,,,,,,,,,,,,,,5,,,,,,,,,,,,,,,,,,,,,,,,,,,,,,,,,1,6.0,7.0,7.0,7.0,6.0,6.0,6.0,7.0,7.0,6.0,7.0,6.0,6.0,7.0,6.0,6.0,7.0,6.0,6.0,7.0,6.0,7.0,5.0,6.0,6.0,7.0,6.0,6.0,7.0,7.0,7.0,3.0,12,,,,,,,,,,,,,,,,,,,,,,,,,,,,,,,,,7,,,,,,,,,,,,,,,,,,,,,,,,,,,,,,,,,0,6.0,6.0,6.0,6.0,6.0,6.0,5.0,6.0,7.0,6.0,6.0,6.0,7.0,6.0,6.0,6.0,5.0,6.0,6.0,5.0,6.0,6.0,7.0,6.0,6.0,7.0,6.0,7.0,6.0,6.0,7.0,6.0,2,1.0,4.0,1.0,1.0,1.0,1.0,1.0,1.0,4.0,1.0,1.0,1.0,1.0,1.0,1.0,1.0,4.0,1.0,1.0,1.0,1.0,1.0,1.0,1.0,1.0,4.0,1.0,1.0,1.0,1.0,3.0,7.0,14,,,,,,,,,,,,,,,,,,,,,,,,,,,,,,,,,,433.47,17.28,,,,10.98,,117.47,,,,,,,,,,,,,,,,,,,,,,,,,,,,,75.54,,,,,,,,,122.65,,,64.83,,,,,,24.72,,APPROVED,Female,28.0,FALSE
985,2022-03-22 02:37:17,19,en,782762227,2022-03-22 02:30:48,2022-03-22 02:37:17,Y,Y,A1,,,14,,,,,,,,,,,,,,,,,,,,,,,,,,,,,,,,,5,,,,,,,,,,,,,,,,,,,,,,,,,,,,,,,,,7,,,,,,,,,,,,,,,,,,,,,,,,,,,,,,,,,10,,,,,,,,,,,,,,,,,,,,,,,,,,,,,,,,,13,,,,,,,,,,,,,,,,,,,,,,,,,,,,,,,,,3,,,,,,,,,,,,,,,,,,,,,,,,,,,,,,,,,4,,,,,,,,,,,,,,,,,,,,,,,,,,,,,,,,,11,,,,,,,,,,,,,,,,,,,,,,,,,,,,,,,,,9,,,,,,,,,,,,,,,,,,,,,,,,,,,,,,,,,8,,,,,,,,,,,,,,,,,,,,,,,,,,,,,,,,,1,5.0,5.0,4.0,4.0,4.0,3.0,6.0,5.0,7.0,5.0,3.0,7.0,7.0,6.0,7.0,4.0,7.0,5.0,5.0,4.0,4.0,5.0,6.0,4.0,3.0,3.0,7.0,5.0,3.0,5.0,4.0,4.0,0,7.0,7.0,7.0,5.0,7.0,7.0,3.0,6.0,5.0,6.0,6.0,7.0,7.0,7.0,7.0,5.0,7.0,6.0,6.0,7.0,5.0,7.0,7.0,6.0,6.0,5.0,5.0,6.0,7.0,7.0,5.0,5.0,6,,,,,,,,,,,,,,,,,,,,,,,,,,,,,,,,,12,,,,,,,,,,,,,,,,,,,,,,,,,,,,,,,,,2,5.0,6.0,5.0,3.0,5.0,3.0,5.0,5.0,6.0,4.0,4.0,6.0,4.0,4.0,7.0,3.0,7.0,4.0,5.0,4.0,4.0,5.0,3.0,5.0,5.0,3.0,7.0,4.0,4.0,4.0,4.0,1.0,None,341.14,12.81,,,,11.08,,40.06,,,,,,,,,,,,,,,,,,,,,,,,,,,,,,,,70.53,,,124.77,,,,,,,,,66.53,,,15.36,,APPROVED,Male,28.0,FALSE
986,2022-03-22 02:38:17,19,en,290218257,2022-03-22 02:30:59,2022-03-22 02:38:17,Y,Y,-oth-,highschool diploma ,,3,,,,,,,,,,,,,,,,,,,,,,,,,,,,,,,,,11,,,,,,,,,,,,,,,,,,,,,,,,,,,,,,,,,7,,,,,,,,,,,,,,,,,,,,,,,,,,,,,,,,,5,,,,,,,,,,,,,,,,,,,,,,,,,,,,,,,,,4,,,,,,,,,,,,,,,,,,,,,,,,,,,,,,,,,14,,,,,,,,,,,,,,,,,,,,,,,,,,,,,,,,,10,,,,,,,,,,,,,,,,,,,,,,,,,,,,,,,,,9,,,,,,,,,,,,,,,,,,,,,,,,,,,,,,,,,1,1.0,1.0,1.0,2.0,1.0,1.0,6.0,1.0,1.0,1.0,1.0,1.0,1.0,1.0,1.0,1.0,2.0,1.0,1.0,1.0,1.0,1.0,3.0,1.0,1.0,2.0,2.0,1.0,5.0,1.0,1.0,2.0,6,,,,,,,,,,,,,,,,,,,,,,,,,,,,,,,,,13,,,,,,,,,,,,,,,,,,,,,,,,,,,,,,,,,2,2.0,2.0,2.0,5.0,2.0,3.0,2.0,2.0,2.0,2.0,2.0,2.0,2.0,2.0,2.0,3.0,3.0,3.0,3.0,3.0,2.0,3.0,6.0,3.0,2.0,5.0,3.0,2.0,3.0,2.0,3.0,5.0,12,,,,,,,,,,,,,,,,,,,,,,,,,,,,,,,,,8,,,,,,,,,,,,,,,,,,,,,,,,,,,,,,,,,2,3.0,5.0,3.0,2.0,2.0,5.0,5.0,4.0,3.0,2.0,2.0,3.0,3.0,3.0,3.0,3.0,5.0,3.0,3.0,1.0,1.0,3.0,3.0,5.0,3.0,5.0,2.0,5.0,2.0,3.0,3.0,1.0,,443.67,45.46,,,,23.79,,49.89,,,,,,,,,,,,,,,,,,,,,,,,,,95.88,,,,,,,,,94.24,,,,,,,,,130.35,,,4.06,,APPROVED,Male,21.0,FALSE
987,2022-03-22 02:39:35,19,en,256175451,2022-03-22 02:31:03,2022-03-22 02:39:35,Y,Y,A1,,,13,,,,,,,,,,,,,,,,,,,,,,,,,,,,,,,,,3,,,,,,,,,,,,,,,,,,,,,,,,,,,,,,,,,2,6.0,5.0,6.0,5.0,5.0,5.0,3.0,7.0,6.0,5.0,6.0,6.0,5.0,4.0,5.0,6.0,5.0,5.0,5.0,5.0,5.0,5.0,6.0,6.0,5.0,6.0,5.0,5.0,6.0,5.0,6.0,3.0,11,,,,,,,,,,,,,,,,,,,,,,,,,,,,,,,,,9,,,,,,,,,,,,,,,,,,,,,,,,,,,,,,,,,0,6.0,5.0,5.0,4.0,5.0,4.0,3.0,6.0,6.0,5.0,6.0,6.0,5.0,4.0,5.0,5.0,5.0,5.0,5.0,5.0,5.0,5.0,5.0,5.0,5.0,6.0,5.0,5.0,6.0,4.0,6.0,6.0,8,,,,,,,,,,,,,,,,,,,,,,,,,,,,,,,,,14,,,,,,,,,,,,,,,,,,,,,,,,,,,,,,,,,10,,,,,,,,,,,,,,,,,,,,,,,,,,,,,,,,,1,5.0,5.0,5.0,4.0,4.0,5.0,5.0,4.0,5.0,4.0,5.0,5.0,4.0,4.0,4.0,5.0,5.0,4.0,5.0,4.0,4.0,4.0,6.0,5.0,4.0,6.0,4.0,5.0,6.0,5.0,6.0,3.0,6,,,,,,,,,,,,,,,,,,,,,,,,,,,,,,,,,7,,,,,,,,,,,,,,,,,,,,,,,,,,,,,,,,,4,,,,,,,,,,,,,,,,,,,,,,,,,,,,,,,,,12,,,,,,,,,,,,,,,,,,,,,,,,,,,,,,,,,5,,,,,,,,,,,,,,,,,,,,,,,,,,,,,,,,,,514.95,55.12,,,,15.71,,45.99,,,,,,,,126.72,,,,,,,,,135.52,,,,,,,,,,,,124.33,,,,,,,,,,,,,,,,,,11.56,,APPROVED,Male,57.0,FALSE
988,2022-03-22 02:36:19,19,en,838403169,2022-03-22 02:31:43,2022-03-22 02:36:19,Y,Y,A2,,,10,,,,,,,,,,,,,,,,,,,,,,,,,,,,,,,,,12,,,,,,,,,,,,,,,,,,,,,,,,,,,,,,,,,1,6.0,5.0,6.0,7.0,6.0,6.0,2.0,7.0,5.0,6.0,5.0,7.0,7.0,6.0,7.0,6.0,7.0,6.0,6.0,6.0,4.0,6.0,7.0,6.0,6.0,6.0,5.0,6.0,5.0,5.0,6.0,3.0,13,,,,,,,,,,,,,,,,,,,,,,,,,,,,,,,,,8,,,,,,,,,,,,,,,,,,,,,,,,,,,,,,,,,11,,,,,,,,,,,,,,,,,,,,,,,,,,,,,,,,,9,,,,,,,,,,,,,,,,,,,,,,,,,,,,,,,,,7,,,,,,,,,,,,,,,,,,,,,,,,,,,,,,,,,3,,,,,,,,,,,,,,,,,,,,,,,,,,,,,,,,,6,,,,,,,,,,,,,,,,,,,,,,,,,,,,,,,,,4,,,,,,,,,,,,,,,,,,,,,,,,,,,,,,,,,2,1.0,1.0,1.0,2.0,2.0,3.0,3.0,1.0,2.0,2.0,2.0,2.0,2.0,1.0,1.0,1.0,3.0,2.0,2.0,1.0,2.0,2.0,2.0,2.0,1.0,2.0,2.0,1.0,1.0,2.0,1.0,5.0,14,,,,,,,,,,,,,,,,,,,,,,,,,,,,,,,,,5,,,,,,,,,,,,,,,,,,,,,,,,,,,,,,,,,0,5.0,6.0,5.0,3.0,5.0,3.0,4.0,2.0,5.0,4.0,6.0,5.0,5.0,3.0,6.0,5.0,6.0,3.0,5.0,4.0,3.0,5.0,3.0,5.0,5.0,3.0,7.0,5.0,5.0,6.0,4.0,1.0,,280.02,15.43,,,,4.46,,19.59,,,,,,,,64.43,,,,,,,,,,,,,,,,,,,,,,,,,,,95.79,,,,,,,,,76.57,,,3.75,,APPROVED,Male,38.0,FALSE
989,2022-03-22 02:44:09,19,en,752094410,2022-03-22 02:31:59,2022-03-22 02:44:08,Y,Y,A1,,,14,,,,,,,,,,,,,,,,,,,,,,,,,,,,,,,,,7,,,,,,,,,,,,,,,,,,,,,,,,,,,,,,,,,2,5.0,5.0,5.0,6.0,4.0,6.0,3.0,6.0,4.0,3.0,5.0,4.0,5.0,4.0,4.0,5.0,5.0,5.0,5.0,4.0,5.0,5.0,5.0,5.0,4.0,5.0,3.0,5.0,4.0,5.0,5.0,3.0,4,,,,,,,,,,,,,,,,,,,,,,,,,,,,,,,,,8,,,,,,,,,,,,,,,,,,,,,,,,,,,,,,,,,13,,,,,,,,,,,,,,,,,,,,,,,,,,,,,,,,,1,4.0,6.0,1.0,2.0,2.0,2.0,1.0,4.0,6.0,2.0,2.0,1.0,1.0,2.0,1.0,2.0,4.0,1.0,2.0,2.0,2.0,1.0,2.0,2.0,2.0,4.0,2.0,1.0,4.0,2.0,4.0,7.0,10,,,,,,,,,,,,,,,,,,,,,,,,,,,,,,,,,3,,,,,,,,,,,,,,,,,,,,,,,,,,,,,,,,,11,,,,,,,,,,,,,,,,,,,,,,,,,,,,,,,,,9,,,,,,,,,,,,,,,,,,,,,,,,,,,,,,,,,12,,,,,,,,,,,,,,,,,,,,,,,,,,,,,,,,,0,3.0,6.0,5.0,6.0,4.0,3.0,4.0,4.0,6.0,4.0,3.0,2.0,3.0,2.0,4.0,4.0,6.0,4.0,4.0,2.0,2.0,4.0,3.0,2.0,2.0,5.0,2.0,3.0,5.0,4.0,6.0,6.0,5,,,,,,,,,,,,,,,,,,,,,,,,,,,,,,,,,6,,,,,,,,,,,,,,,,,,,,,,,,,,,,,,,,,,731.15,75.62,,,,10.09,,73.2,,,,,,,,223.89,,,,,,,,,,,,202.13,,,,,,,,,,,,,,,,,,137.28,,,,,,,,,8.94,,APPROVED,Female,21.0,FALSE
991,2022-03-22 02:41:31,19,en,1549501186,2022-03-22 02:35:00,2022-03-22 02:41:31,Y,Y,A1,,,10,,,,,,,,,,,,,,,,,,,,,,,,,,,,,,,,,12,,,,,,,,,,,,,,,,,,,,,,,,,,,,,,,,,8,,,,,,,,,,,,,,,,,,,,,,,,,,,,,,,,,1,5.0,5.0,6.0,5.0,6.0,4.0,5.0,4.0,6.0,4.0,5.0,6.0,5.0,4.0,5.0,5.0,6.0,5.0,4.0,5.0,4.0,6.0,4.0,6.0,4.0,4.0,3.0,4.0,6.0,5.0,5.0,4.0,13,,,,,,,,,,,,,,,,,,,,,,,,,,,,,,,,,4,,,,,,,,,,,,,,,,,,,,,,,,,,,,,,,,,7,,,,,,,,,,,,,,,,,,,,,,,,,,,,,,,,,2,3.0,1.0,2.0,3.0,1.0,2.0,6.0,4.0,4.0,2.0,3.0,2.0,3.0,2.0,3.0,3.0,3.0,1.0,3.0,1.0,2.0,2.0,3.0,2.0,1.0,3.0,2.0,2.0,2.0,4.0,2.0,1.0,14,,,,,,,,,,,,,,,,,,,,,,,,,,,,,,,,,5,,,,,,,,,,,,,,,,,,,,,,,,,,,,,,,,,11,,,,,,,,,,,,,,,,,,,,,,,,,,,,,,,,,6,,,,,,,,,,,,,,,,,,,,,,,,,,,,,,,,,3,,,,,,,,,,,,,,,,,,,,,,,,,,,,,,,,,0,3.0,5.0,4.0,6.0,3.0,5.0,4.0,5.0,6.0,2.0,5.0,6.0,4.0,6.0,7.0,6.0,6.0,4.0,4.0,2.0,5.0,4.0,6.0,5.0,4.0,7.0,6.0,6.0,6.0,3.0,6.0,7.0,9,,,,,,,,,,,,,,,,,,,,,,,,,,,,,,,,,,396.56,31.39,,,,9.47,,26.35,,,,,,,,,,,97.51,,,,,,,,,,,,81.74,,,,,,,,,,,,,,,,,,146.29,,,,,,3.81,,APPROVED,Male,31.0,FALSE
993,2022-03-22 02:53:02,19,en,918636287,2022-03-22 02:36:10,2022-03-22 02:53:02,Y,Y,A1,,,6,,,,,,,,,,,,,,,,,,,,,,,,,,,,,,,,,12,,,,,,,,,,,,,,,,,,,,,,,,,,,,,,,,,11,,,,,,,,,,,,,,,,,,,,,,,,,,,,,,,,,1,5.0,6.0,6.0,6.0,4.0,5.0,4.0,6.0,5.0,5.0,5.0,4.0,6.0,4.0,4.0,6.0,5.0,5.0,5.0,5.0,5.0,6.0,6.0,5.0,5.0,4.0,5.0,4.0,5.0,4.0,6.0,4.0,14,,,,,,,,,,,,,,,,,,,,,,,,,,,,,,,,,0,5.0,4.0,6.0,3.0,5.0,7.0,4.0,7.0,4.0,5.0,4.0,6.0,5.0,4.0,4.0,5.0,6.0,5.0,6.0,3.0,6.0,6.0,5.0,6.0,5.0,3.0,4.0,6.0,6.0,3.0,4.0,5.0,2,2.0,2.0,5.0,4.0,4.0,4.0,4.0,1.0,3.0,1.0,1.0,1.0,2.0,2.0,3.0,3.0,2.0,1.0,2.0,2.0,2.0,4.0,4.0,2.0,1.0,2.0,1.0,2.0,1.0,1.0,3.0,7.0,8,,,,,,,,,,,,,,,,,,,,,,,,,,,,,,,,,9,,,,,,,,,,,,,,,,,,,,,,,,,,,,,,,,,5,,,,,,,,,,,,,,,,,,,,,,,,,,,,,,,,,13,,,,,,,,,,,,,,,,,,,,,,,,,,,,,,,,,4,,,,,,,,,,,,,,,,,,,,,,,,,,,,,,,,,10,,,,,,,,,,,,,,,,,,,,,,,,,,,,,,,,,7,,,,,,,,,,,,,,,,,,,,,,,,,,,,,,,,,3,,,,,,,,,,,,,,,,,,,,,,,,,,,,,,,,,,469.04,95.74,,,,5.31,,47.22,,,,,,,,,,,84.24,,,,,,116.21,,,117.23,,,,,,,,,,,,,,,,,,,,,,,,,,,3.09,,APPROVED,Female,32.0,FALSE
994,2022-03-22 02:41:02,19,en,581150436,2022-03-22 02:36:11,2022-03-22 02:41:02,Y,Y,-oth-,Highschool,,9,,,,,,,,,,,,,,,,,,,,,,,,,,,,,,,,,12,,,,,,,,,,,,,,,,,,,,,,,,,,,,,,,,,13,,,,,,,,,,,,,,,,,,,,,,,,,,,,,,,,,6,,,,,,,,,,,,,,,,,,,,,,,,,,,,,,,,,1,3.0,4.0,5.0,6.0,1.0,4.0,3.0,7.0,5.0,3.0,3.0,4.0,5.0,2.0,3.0,4.0,3.0,4.0,6.0,3.0,4.0,6.0,7.0,3.0,3.0,7.0,4.0,4.0,3.0,4.0,4.0,5.0,5,,,,,,,,,,,,,,,,,,,,,,,,,,,,,,,,,11,,,,,,,,,,,,,,,,,,,,,,,,,,,,,,,,,10,,,,,,,,,,,,,,,,,,,,,,,,,,,,,,,,,8,,,,,,,,,,,,,,,,,,,,,,,,,,,,,,,,,7,,,,,,,,,,,,,,,,,,,,,,,,,,,,,,,,,3,,,,,,,,,,,,,,,,,,,,,,,,,,,,,,,,,0,3.0,5.0,4.0,3.0,4.0,5.0,2.0,2.0,5.0,4.0,4.0,3.0,4.0,5.0,4.0,2.0,6.0,3.0,5.0,3.0,4.0,5.0,4.0,3.0,4.0,5.0,3.0,3.0,5.0,4.0,5.0,5.0,14,,,,,,,,,,,,,,,,,,,,,,,,,,,,,,,,,4,,,,,,,,,,,,,,,,,,,,,,,,,,,,,,,,,2,2.0,3.0,3.0,2.0,4.0,3.0,6.0,3.0,3.0,3.0,4.0,2.0,2.0,3.0,3.0,5.0,3.0,2.0,3.0,3.0,4.0,3.0,3.0,3.0,4.0,4.0,3.0,3.0,2.0,4.0,3.0,3.0,,292.68,30.7,,,,69.01,,37.76,,,,,,,,,,,,,,54.22,,,,,,,,,,,,,,,,,,,,,60.99,,,,,,,,,36.51,,,3.49,,APPROVED,Male,19.0,FALSE
995,2022-03-22 02:40:14,19,en,293787713,2022-03-22 02:36:20,2022-03-22 02:40:14,Y,Y,A1,,,6,,,,,,,,,,,,,,,,,,,,,,,,,,,,,,,,,10,,,,,,,,,,,,,,,,,,,,,,,,,,,,,,,,,0,7.0,7.0,7.0,6.0,6.0,4.0,4.0,7.0,7.0,7.0,7.0,6.0,6.0,5.0,6.0,7.0,7.0,6.0,7.0,7.0,3.0,7.0,6.0,7.0,7.0,4.0,3.0,7.0,7.0,6.0,5.0,3.0,13,,,,,,,,,,,,,,,,,,,,,,,,,,,,,,,,,7,,,,,,,,,,,,,,,,,,,,,,,,,,,,,,,,,1,3.0,6.0,3.0,3.0,5.0,2.0,7.0,3.0,6.0,4.0,1.0,3.0,5.0,5.0,5.0,2.0,5.0,2.0,5.0,5.0,3.0,4.0,2.0,3.0,4.0,2.0,2.0,3.0,2.0,3.0,2.0,6.0,11,,,,,,,,,,,,,,,,,,,,,,,,,,,,,,,,,12,,,,,,,,,,,,,,,,,,,,,,,,,,,,,,,,,8,,,,,,,,,,,,,,,,,,,,,,,,,,,,,,,,,5,,,,,,,,,,,,,,,,,,,,,,,,,,,,,,,,,9,,,,,,,,,,,,,,,,,,,,,,,,,,,,,,,,,4,,,,,,,,,,,,,,,,,,,,,,,,,,,,,,,,,14,,,,,,,,,,,,,,,,,,,,,,,,,,,,,,,,,3,,,,,,,,,,,,,,,,,,,,,,,,,,,,,,,,,2,1.0,1.0,1.0,1.0,1.0,1.0,6.0,5.0,5.0,1.0,1.0,1.0,1.0,1.0,5.0,1.0,5.0,1.0,1.0,1.0,1.0,1.0,1.0,1.0,1.0,1.0,5.0,1.0,1.0,1.0,1.0,1.0,,236.26,33.94,,,,6.77,,21.19,,,,,,,,61.19,,,,,,,,,63.5,,,,,,,,,,,,,,,,,,,,,,,,,,,47.31,,,2.36,,APPROVED,Female,26.0,FALSE
996,2022-03-22 02:40:49,19,en,1270494325,2022-03-22 02:36:22,2022-03-22 02:40:49,Y,Y,-oth-,,,3,,,,,,,,,,,,,,,,,,,,,,,,,,,,,,,,,12,,,,,,,,,,,,,,,,,,,,,,,,,,,,,,,,,0,1.0,5.0,1.0,2.0,1.0,1.0,7.0,1.0,2.0,1.0,1.0,1.0,1.0,2.0,1.0,1.0,2.0,1.0,1.0,2.0,1.0,2.0,1.0,1.0,1.0,1.0,4.0,1.0,2.0,4.0,1.0,3.0,11,,,,,,,,,,,,,,,,,,,,,,,,,,,,,,,,,4,,,,,,,,,,,,,,,,,,,,,,,,,,,,,,,,,9,,,,,,,,,,,,,,,,,,,,,,,,,,,,,,,,,6,,,,,,,,,,,,,,,,,,,,,,,,,,,,,,,,,13,,,,,,,,,,,,,,,,,,,,,,,,,,,,,,,,,10,,,,,,,,,,,,,,,,,,,,,,,,,,,,,,,,,7,,,,,,,,,,,,,,,,,,,,,,,,,,,,,,,,,2,1.0,3.0,2.0,1.0,1.0,1.0,5.0,2.0,1.0,1.0,1.0,1.0,2.0,1.0,1.0,1.0,1.0,1.0,1.0,1.0,1.0,1.0,1.0,1.0,1.0,1.0,1.0,1.0,1.0,1.0,1.0,4.0,8,,,,,,,,,,,,,,,,,,,,,,,,,,,,,,,,,5,,,,,,,,,,,,,,,,,,,,,,,,,,,,,,,,,14,,,,,,,,,,,,,,,,,,,,,,,,,,,,,,,,,1,2.0,7.0,5.0,1.0,2.0,1.0,5.0,1.0,5.0,1.0,1.0,1.0,1.0,1.0,1.0,1.0,5.0,1.0,1.0,1.0,1.0,1.0,1.0,1.0,2.0,1.0,1.0,1.0,1.0,1.0,1.0,1.0,,270.17,29.53,,,,11.28,,37.88,,,,,,,,74.51,,,,,,,,,,,,,,,,,,,,,,,,54.51,,,,,,,,,,,,59.18,,,3.28,,APPROVED,Male,39.0,FALSE
997,2022-03-22 02:41:14,19,en,1121008823,2022-03-22 02:36:23,2022-03-22 02:41:14,Y,Y,-oth-,Associate's Degree,,3,,,,,,,,,,,,,,,,,,,,,,,,,,,,,,,,,14,,,,,,,,,,,,,,,,,,,,,,,,,,,,,,,,,4,,,,,,,,,,,,,,,,,,,,,,,,,,,,,,,,,1,4.0,4.0,4.0,4.0,4.0,4.0,4.0,4.0,4.0,4.0,4.0,4.0,4.0,4.0,4.0,4.0,4.0,4.0,4.0,4.0,4.0,4.0,4.0,4.0,4.0,4.0,4.0,4.0,4.0,4.0,4.0,4.0,0,4.0,5.0,4.0,5.0,4.0,5.0,6.0,4.0,4.0,4.0,5.0,5.0,5.0,4.0,4.0,4.0,4.0,4.0,5.0,4.0,5.0,5.0,5.0,4.0,4.0,5.0,4.0,5.0,5.0,4.0,4.0,5.0,2,4.0,5.0,5.0,5.0,4.0,4.0,4.0,4.0,5.0,5.0,5.0,4.0,6.0,4.0,4.0,5.0,6.0,4.0,4.0,5.0,4.0,4.0,4.0,4.0,5.0,5.0,4.0,4.0,4.0,4.0,4.0,6.0,13,,,,,,,,,,,,,,,,,,,,,,,,,,,,,,,,,12,,,,,,,,,,,,,,,,,,,,,,,,,,,,,,,,,5,,,,,,,,,,,,,,,,,,,,,,,,,,,,,,,,,7,,,,,,,,,,,,,,,,,,,,,,,,,,,,,,,,,9,,,,,,,,,,,,,,,,,,,,,,,,,,,,,,,,,8,,,,,,,,,,,,,,,,,,,,,,,,,,,,,,,,,10,,,,,,,,,,,,,,,,,,,,,,,,,,,,,,,,,11,,,,,,,,,,,,,,,,,,,,,,,,,,,,,,,,,6,,,,,,,,,,,,,,,,,,,,,,,,,,,,,,,,,"Interesting survey, haven't seen many surveys about looking at the visuals of a data, very unique ",294.58,50.47,,,,13.58,,44.52,,,,,,,,,,,42.77,,,61.54,,,46.62,,,,,,,,,,,,,,,,,,,,,,,,,,,,,,35.08,,APPROVED,Male,20.0,FALSE
998,2022-03-22 02:39:34,19,en,420524730,2022-03-22 02:36:26,2022-03-22 02:39:34,Y,Y,A1,,,14,,,,,,,,,,,,,,,,,,,,,,,,,,,,,,,,,1,7.0,6.0,6.0,6.0,7.0,7.0,2.0,7.0,1.0,7.0,7.0,6.0,6.0,6.0,7.0,7.0,7.0,6.0,6.0,7.0,6.0,6.0,6.0,6.0,7.0,6.0,4.0,7.0,4.0,6.0,7.0,2.0,7,,,,,,,,,,,,,,,,,,,,,,,,,,,,,,,,,3,,,,,,,,,,,,,,,,,,,,,,,,,,,,,,,,,8,,,,,,,,,,,,,,,,,,,,,,,,,,,,,,,,,2,2.0,5.0,4.0,2.0,6.0,1.0,6.0,5.0,5.0,2.0,3.0,5.0,1.0,3.0,6.0,1.0,2.0,2.0,4.0,5.0,2.0,3.0,1.0,3.0,6.0,1.0,3.0,2.0,3.0,2.0,3.0,6.0,0,2.0,2.0,2.0,2.0,2.0,1.0,6.0,2.0,2.0,2.0,2.0,2.0,2.0,2.0,2.0,2.0,2.0,2.0,2.0,2.0,2.0,2.0,2.0,2.0,1.0,2.0,2.0,2.0,2.0,2.0,2.0,7.0,11,,,,,,,,,,,,,,,,,,,,,,,,,,,,,,,,,4,,,,,,,,,,,,,,,,,,,,,,,,,,,,,,,,,6,,,,,,,,,,,,,,,,,,,,,,,,,,,,,,,,,13,,,,,,,,,,,,,,,,,,,,,,,,,,,,,,,,,10,,,,,,,,,,,,,,,,,,,,,,,,,,,,,,,,,12,,,,,,,,,,,,,,,,,,,,,,,,,,,,,,,,,9,,,,,,,,,,,,,,,,,,,,,,,,,,,,,,,,,5,,,,,,,,,,,,,,,,,,,,,,,,,,,,,,,,,None,218.39,19.43,,,,4.68,,57.77,,,,,33.66,,,,,,,,,,,,42.08,,,54.83,,,,,,,,,,,,,,,,,,,,,,,,,,,5.94,,APPROVED,Male,31.0,FALSE
999,2022-03-22 02:46:25,19,en,1426264878,2022-03-22 02:36:27,2022-03-22 02:46:25,Y,Y,A1,,,0,5.0,7.0,6.0,2.0,5.0,2.0,7.0,5.0,7.0,5.0,4.0,7.0,6.0,7.0,7.0,2.0,7.0,6.0,5.0,5.0,4.0,5.0,2.0,5.0,5.0,5.0,7.0,3.0,7.0,5.0,5.0,1.0,10,,,,,,,,,,,,,,,,,,,,,,,,,,,,,,,,,9,,,,,,,,,,,,,,,,,,,,,,,,,,,,,,,,,6,,,,,,,,,,,,,,,,,,,,,,,,,,,,,,,,,13,,,,,,,,,,,,,,,,,,,,,,,,,,,,,,,,,2,5.0,6.0,4.0,4.0,3.0,3.0,6.0,2.0,6.0,5.0,3.0,6.0,5.0,6.0,7.0,5.0,7.0,4.0,5.0,4.0,6.0,5.0,6.0,6.0,4.0,5.0,7.0,6.0,6.0,3.0,6.0,6.0,8,,,,,,,,,,,,,,,,,,,,,,,,,,,,,,,,,12,,,,,,,,,,,,,,,,,,,,,,,,,,,,,,,,,11,,,,,,,,,,,,,,,,,,,,,,,,,,,,,,,,,5,,,,,,,,,,,,,,,,,,,,,,,,,,,,,,,,,1,3.0,5.0,2.0,2.0,2.0,2.0,3.0,6.0,6.0,3.0,1.0,5.0,3.0,3.0,5.0,2.0,4.0,3.0,3.0,2.0,4.0,3.0,4.0,3.0,2.0,4.0,6.0,3.0,5.0,3.0,3.0,4.0,14,,,,,,,,,,,,,,,,,,,,,,,,,,,,,,,,,3,,,,,,,,,,,,,,,,,,,,,,,,,,,,,,,,,7,,,,,,,,,,,,,,,,,,,,,,,,,,,,,,,,,4,,,,,,,,,,,,,,,,,,,,,,,,,,,,,,,,,,598.48,32.89,,,,17.92,,50.02,,137.35,,,,,,,,,,,,,,,150.09,,,,,,,,,,,,,,,171.55,,,,,,,,,,,,,,,38.66,,APPROVED,Male,53.0,FALSE
1000,2022-03-22 02:42:22,19,en,1936726688,2022-03-22 02:36:30,2022-03-22 02:42:21,Y,Y,A1,,,4,,,,,,,,,,,,,,,,,,,,,,,,,,,,,,,,,9,,,,,,,,,,,,,,,,,,,,,,,,,,,,,,,,,5,,,,,,,,,,,,,,,,,,,,,,,,,,,,,,,,,8,,,,,,,,,,,,,,,,,,,,,,,,,,,,,,,,,10,,,,,,,,,,,,,,,,,,,,,,,,,,,,,,,,,11,,,,,,,,,,,,,,,,,,,,,,,,,,,,,,,,,13,,,,,,,,,,,,,,,,,,,,,,,,,,,,,,,,,6,,,,,,,,,,,,,,,,,,,,,,,,,,,,,,,,,12,,,,,,,,,,,,,,,,,,,,,,,,,,,,,,,,,0,1.0,3.0,1.0,1.0,1.0,1.0,7.0,1.0,1.0,1.0,1.0,1.0,1.0,1.0,1.0,1.0,1.0,1.0,1.0,1.0,1.0,1.0,2.0,1.0,1.0,1.0,1.0,1.0,1.0,1.0,1.0,1.0,3,,,,,,,,,,,,,,,,,,,,,,,,,,,,,,,,,7,,,,,,,,,,,,,,,,,,,,,,,,,,,,,,,,,2,4.0,2.0,2.0,2.0,2.0,5.0,3.0,1.0,1.0,1.0,1.0,1.0,3.0,1.0,1.0,3.0,1.0,2.0,1.0,1.0,1.0,1.0,6.0,3.0,1.0,4.0,1.0,1.0,4.0,1.0,1.0,6.0,14,,,,,,,,,,,,,,,,,,,,,,,,,,,,,,,,,1,1.0,3.0,3.0,1.0,1.0,2.0,7.0,1.0,4.0,1.0,1.0,4.0,1.0,1.0,1.0,1.0,6.0,2.0,3.0,1.0,1.0,1.0,2.0,2.0,1.0,1.0,2.0,1.0,5.0,1.0,3.0,1.0,,355.16,14.62,,,,11.18,,50.61,,,,,,,,,,,,,,,,,,,,,,,,,,,,,107.51,,,,,,,,,85.96,,,,,,80.26,,,5.02,,APPROVED,Female,22.0,FALSE
1001,2022-03-22 02:41:35,19,en,1919836333,2022-03-22 02:36:35,2022-03-22 02:41:35,Y,Y,A3,,,10,,,,,,,,,,,,,,,,,,,,,,,,,,,,,,,,,5,,,,,,,,,,,,,,,,,,,,,,,,,,,,,,,,,2,6.0,6.0,6.0,5.0,5.0,4.0,3.0,6.0,6.0,5.0,5.0,6.0,5.0,6.0,5.0,4.0,6.0,6.0,6.0,5.0,5.0,5.0,5.0,5.0,6.0,5.0,3.0,5.0,4.0,5.0,6.0,3.0,9,,,,,,,,,,,,,,,,,,,,,,,,,,,,,,,,,3,,,,,,,,,,,,,,,,,,,,,,,,,,,,,,,,,4,,,,,,,,,,,,,,,,,,,,,,,,,,,,,,,,,6,,,,,,,,,,,,,,,,,,,,,,,,,,,,,,,,,14,,,,,,,,,,,,,,,,,,,,,,,,,,,,,,,,,1,5.0,4.0,4.0,3.0,3.0,4.0,5.0,2.0,4.0,4.0,4.0,5.0,4.0,4.0,3.0,5.0,4.0,4.0,5.0,3.0,4.0,5.0,6.0,5.0,4.0,6.0,4.0,5.0,5.0,4.0,5.0,2.0,11,,,,,,,,,,,,,,,,,,,,,,,,,,,,,,,,,8,,,,,,,,,,,,,,,,,,,,,,,,,,,,,,,,,7,,,,,,,,,,,,,,,,,,,,,,,,,,,,,,,,,0,4.0,5.0,4.0,2.0,3.0,2.0,5.0,4.0,5.0,4.0,4.0,3.0,4.0,4.0,6.0,2.0,5.0,4.0,2.0,2.0,4.0,2.0,2.0,3.0,4.0,2.0,3.0,3.0,3.0,2.0,3.0,6.0,12,,,,,,,,,,,,,,,,,,,,,,,,,,,,,,,,,13,,,,,,,,,,,,,,,,,,,,,,,,,,,,,,,,,,303.13,15.27,,,,5.45,,42.07,,,,,,,,73.75,,,,,,,,,,,,,,,,,,72.4,,,,,,,,,,,,90.86,,,,,,,,,3.33,,APPROVED,Male,31.0,FALSE
1002,2022-03-22 02:40:48,19,en,330175562,2022-03-22 02:36:38,2022-03-22 02:40:48,Y,Y,A1,,,14,,,,,,,,,,,,,,,,,,,,,,,,,,,,,,,,,3,,,,,,,,,,,,,,,,,,,,,,,,,,,,,,,,,7,,,,,,,,,,,,,,,,,,,,,,,,,,,,,,,,,2,3.0,3.0,4.0,3.0,3.0,4.0,2.0,3.0,2.0,4.0,3.0,4.0,3.0,3.0,3.0,3.0,3.0,3.0,2.0,2.0,4.0,2.0,2.0,2.0,3.0,2.0,3.0,3.0,2.0,4.0,2.0,4.0,10,,,,,,,,,,,,,,,,,,,,,,,,,,,,,,,,,12,,,,,,,,,,,,,,,,,,,,,,,,,,,,,,,,,6,,,,,,,,,,,,,,,,,,,,,,,,,,,,,,,,,9,,,,,,,,,,,,,,,,,,,,,,,,,,,,,,,,,13,,,,,,,,,,,,,,,,,,,,,,,,,,,,,,,,,1,2.0,5.0,2.0,2.0,1.0,1.0,2.0,1.0,5.0,3.0,4.0,2.0,2.0,1.0,4.0,3.0,2.0,1.0,3.0,2.0,1.0,2.0,2.0,3.0,2.0,1.0,2.0,2.0,4.0,2.0,2.0,3.0,11,,,,,,,,,,,,,,,,,,,,,,,,,,,,,,,,,8,,,,,,,,,,,,,,,,,,,,,,,,,,,,,,,,,1,3.0,4.0,4.0,2.0,2.0,3.0,2.0,3.0,4.0,3.0,4.0,3.0,2.0,3.0,3.0,2.0,2.0,4.0,3.0,4.0,3.0,2.0,3.0,2.0,3.0,2.0,3.0,3.0,4.0,2.0,4.0,6.0,5,,,,,,,,,,,,,,,,,,,,,,,,,,,,,,,,,4,,,,,,,,,,,,,,,,,,,,,,,,,,,,,,,,,all the graphs are beautiful but the only black color,290.55,9.02,,,,43.62,,62.1,,,,,,,,,,,39.65,,,,,,,,,,,,,,,,,,93.44,,,,,,,,,27.44,,,,,,,,,15.28,,APPROVED,Male,24.0,FALSE
1004,2022-03-22 02:46:02,19,en,1628536550,2022-03-22 02:36:39,2022-03-22 02:46:02,Y,Y,A3,,,4,,,,,,,,,,,,,,,,,,,,,,,,,,,,,,,,,14,,,,,,,,,,,,,,,,,,,,,,,,,,,,,,,,,12,,,,,,,,,,,,,,,,,,,,,,,,,,,,,,,,,9,,,,,,,,,,,,,,,,,,,,,,,,,,,,,,,,,1,3.0,1.0,2.0,2.0,1.0,2.0,7.0,2.0,4.0,3.0,3.0,3.0,3.0,4.0,1.0,2.0,4.0,2.0,3.0,2.0,3.0,3.0,2.0,2.0,1.0,2.0,4.0,1.0,5.0,4.0,2.0,5.0,2,6.0,6.0,5.0,6.0,6.0,2.0,4.0,2.0,7.0,5.0,5.0,6.0,6.0,7.0,7.0,5.0,7.0,6.0,6.0,7.0,5.0,5.0,5.0,5.0,6.0,5.0,7.0,4.0,6.0,6.0,5.0,6.0,3,,,,,,,,,,,,,,,,,,,,,,,,,,,,,,,,,5,,,,,,,,,,,,,,,,,,,,,,,,,,,,,,,,,8,,,,,,,,,,,,,,,,,,,,,,,,,,,,,,,,,11,,,,,,,,,,,,,,,,,,,,,,,,,,,,,,,,,10,,,,,,,,,,,,,,,,,,,,,,,,,,,,,,,,,13,,,,,,,,,,,,,,,,,,,,,,,,,,,,,,,,,0,5.0,5.0,3.0,3.0,4.0,6.0,2.0,5.0,6.0,4.0,6.0,5.0,4.0,4.0,7.0,5.0,5.0,4.0,4.0,3.0,4.0,5.0,7.0,6.0,3.0,4.0,6.0,5.0,6.0,4.0,5.0,6.0,6,,,,,,,,,,,,,,,,,,,,,,,,,,,,,,,,,7,,,,,,,,,,,,,,,,,,,,,,,,,,,,,,,,,,463.15,34.54,,,,6.98,,46.44,,,,,,,,,,,,,,88.56,,,144.25,,,,,,,,,,,,,,,,,,,,,132.62,,,,,,,,,9.76,,APPROVED,Male,34.0,FALSE
1005,2022-03-22 02:41:48,19,en,1554836828,2022-03-22 02:36:40,2022-03-22 02:41:48,Y,Y,A1,,,4,,,,,,,,,,,,,,,,,,,,,,,,,,,,,,,,,10,,,,,,,,,,,,,,,,,,,,,,,,,,,,,,,,,6,,,,,,,,,,,,,,,,,,,,,,,,,,,,,,,,,5,,,,,,,,,,,,,,,,,,,,,,,,,,,,,,,,,2,5.0,4.0,4.0,4.0,4.0,4.0,4.0,4.0,4.0,4.0,4.0,4.0,4.0,5.0,4.0,4.0,4.0,7.0,4.0,4.0,4.0,4.0,7.0,4.0,4.0,4.0,7.0,4.0,4.0,4.0,4.0,5.0,8,,,,,,,,,,,,,,,,,,,,,,,,,,,,,,,,,14,,,,,,,,,,,,,,,,,,,,,,,,,,,,,,,,,3,,,,,,,,,,,,,,,,,,,,,,,,,,,,,,,,,9,,,,,,,,,,,,,,,,,,,,,,,,,,,,,,,,,13,,,,,,,,,,,,,,,,,,,,,,,,,,,,,,,,,1,7.0,7.0,7.0,7.0,7.0,7.0,3.0,7.0,7.0,7.0,7.0,7.0,7.0,7.0,7.0,7.0,7.0,6.0,7.0,7.0,7.0,7.0,7.0,7.0,7.0,7.0,6.0,7.0,7.0,7.0,7.0,4.0,7,,,,,,,,,,,,,,,,,,,,,,,,,,,,,,,,,0,6.0,7.0,6.0,7.0,5.0,7.0,1.0,7.0,7.0,5.0,7.0,7.0,6.0,7.0,6.0,7.0,6.0,6.0,7.0,6.0,7.0,6.0,7.0,6.0,6.0,7.0,7.0,7.0,7.0,7.0,6.0,6.0,11,,,,,,,,,,,,,,,,,,,,,,,,,,,,,,,,,12,,,,,,,,,,,,,,,,,,,,,,,,,,,,,,,,,,310.68,34.32,,,,19.58,,34.34,,,,,,,,,,,,,,79.38,,,,,,,,,,,,,,,,,,65.9,,,,,,72.97,,,,,,,,,4.19,,APPROVED,Male,58.0,FALSE
1006,2022-03-22 02:42:13,19,en,1926848613,2022-03-22 02:36:40,2022-03-22 02:42:13,Y,Y,A1,,,2,5.0,6.0,6.0,5.0,5.0,5.0,5.0,5.0,6.0,5.0,5.0,5.0,6.0,4.0,6.0,5.0,6.0,6.0,5.0,4.0,4.0,5.0,4.0,5.0,5.0,6.0,4.0,5.0,5.0,5.0,5.0,1.0,3,,,,,,,,,,,,,,,,,,,,,,,,,,,,,,,,,8,,,,,,,,,,,,,,,,,,,,,,,,,,,,,,,,,10,,,,,,,,,,,,,,,,,,,,,,,,,,,,,,,,,14,,,,,,,,,,,,,,,,,,,,,,,,,,,,,,,,,9,,,,,,,,,,,,,,,,,,,,,,,,,,,,,,,,,12,,,,,,,,,,,,,,,,,,,,,,,,,,,,,,,,,0,2.0,5.0,4.0,3.0,3.0,2.0,6.0,4.0,6.0,3.0,3.0,2.0,5.0,4.0,5.0,2.0,5.0,4.0,4.0,2.0,2.0,3.0,4.0,2.0,3.0,4.0,1.0,2.0,4.0,4.0,2.0,1.0,7,,,,,,,,,,,,,,,,,,,,,,,,,,,,,,,,,11,,,,,,,,,,,,,,,,,,,,,,,,,,,,,,,,,4,,,,,,,,,,,,,,,,,,,,,,,,,,,,,,,,,13,,,,,,,,,,,,,,,,,,,,,,,,,,,,,,,,,5,,,,,,,,,,,,,,,,,,,,,,,,,,,,,,,,,6,,,,,,,,,,,,,,,,,,,,,,,,,,,,,,,,,1,5.0,5.0,5.0,5.0,4.0,4.0,4.0,5.0,5.0,4.0,5.0,4.0,5.0,4.0,5.0,5.0,5.0,5.0,4.0,3.0,4.0,5.0,4.0,5.0,5.0,5.0,2.0,5.0,5.0,4.0,4.0,1.0,,335.59,36.65,,,,8.17,,37.23,,74.26,,,,,,,,,,,,,,,,,,,,,101.88,,,,,,,,,,,,,,,,,,,,,74.16,,,3.24,,APPROVED,Female,21.0,FALSE
1007,2022-03-22 02:41:52,19,en,815625749,2022-03-22 02:36:40,2022-03-22 02:41:52,Y,Y,-oth-,HS Graduate,,10,,,,,,,,,,,,,,,,,,,,,,,,,,,,,,,,,6,,,,,,,,,,,,,,,,,,,,,,,,,,,,,,,,,13,,,,,,,,,,,,,,,,,,,,,,,,,,,,,,,,,14,,,,,,,,,,,,,,,,,,,,,,,,,,,,,,,,,12,,,,,,,,,,,,,,,,,,,,,,,,,,,,,,,,,7,,,,,,,,,,,,,,,,,,,,,,,,,,,,,,,,,5,,,,,,,,,,,,,,,,,,,,,,,,,,,,,,,,,3,,,,,,,,,,,,,,,,,,,,,,,,,,,,,,,,,0,2.0,2.0,2.0,3.0,1.0,2.0,6.0,1.0,5.0,1.0,1.0,4.0,1.0,4.0,5.0,1.0,4.0,2.0,1.0,1.0,3.0,2.0,1.0,2.0,2.0,3.0,3.0,2.0,3.0,2.0,1.0,2.0,8,,,,,,,,,,,,,,,,,,,,,,,,,,,,,,,,,9,,,,,,,,,,,,,,,,,,,,,,,,,,,,,,,,,1,2.0,5.0,4.0,6.0,2.0,2.0,3.0,5.0,6.0,2.0,2.0,3.0,4.0,4.0,5.0,4.0,6.0,3.0,3.0,2.0,3.0,3.0,2.0,3.0,5.0,1.0,5.0,2.0,2.0,2.0,2.0,5.0,11,,,,,,,,,,,,,,,,,,,,,,,,,,,,,,,,,2,4.0,5.0,3.0,5.0,2.0,5.0,2.0,6.0,7.0,2.0,2.0,6.0,4.0,5.0,5.0,3.0,6.0,3.0,4.0,2.0,5.0,2.0,5.0,3.0,3.0,5.0,5.0,3.0,6.0,3.0,4.0,7.0,4,,,,,,,,,,,,,,,,,,,,,,,,,,,,,,,,,Thank you for allowing me to participate.,315.9,37.78,,,,39.28,,30.37,,,,,,,,,,,,,,,,,,,,,,,,,,63.94,,,,,,,,,62.77,,,,,,61.79,,,,,,19.97,,APPROVED,Female,55.0,FALSE
1008,2022-03-22 02:41:31,19,en,922948269,2022-03-22 02:36:43,2022-03-22 02:41:31,Y,Y,A1,,,9,,,,,,,,,,,,,,,,,,,,,,,,,,,,,,,,,13,,,,,,,,,,,,,,,,,,,,,,,,,,,,,,,,,3,,,,,,,,,,,,,,,,,,,,,,,,,,,,,,,,,10,,,,,,,,,,,,,,,,,,,,,,,,,,,,,,,,,8,,,,,,,,,,,,,,,,,,,,,,,,,,,,,,,,,12,,,,,,,,,,,,,,,,,,,,,,,,,,,,,,,,,11,,,,,,,,,,,,,,,,,,,,,,,,,,,,,,,,,2,2.0,5.0,3.0,3.0,2.0,1.0,6.0,4.0,4.0,1.0,2.0,5.0,2.0,4.0,5.0,4.0,5.0,3.0,3.0,3.0,3.0,3.0,4.0,2.0,2.0,3.0,3.0,4.0,2.0,4.0,2.0,1.0,14,,,,,,,,,,,,,,,,,,,,,,,,,,,,,,,,,0,6.0,6.0,6.0,4.0,5.0,4.0,6.0,2.0,6.0,5.0,5.0,5.0,4.0,5.0,6.0,5.0,6.0,3.0,4.0,5.0,4.0,4.0,5.0,6.0,5.0,5.0,3.0,6.0,5.0,4.0,5.0,3.0,4,,,,,,,,,,,,,,,,,,,,,,,,,,,,,,,,,6,,,,,,,,,,,,,,,,,,,,,,,,,,,,,,,,,1,6.0,7.0,6.0,4.0,5.0,3.0,6.0,6.0,6.0,5.0,6.0,6.0,4.0,5.0,6.0,5.0,6.0,5.0,5.0,5.0,5.0,5.0,5.0,6.0,5.0,5.0,5.0,6.0,5.0,4.0,4.0,6.0,5,,,,,,,,,,,,,,,,,,,,,,,,,,,,,,,,,7,,,,,,,,,,,,,,,,,,,,,,,,,,,,,,,,,,291.93,22.18,,,,8.43,,27.42,,,,,,,,,,,,,,,,,,,,,,,66.71,,,,,,81.16,,,,,,,,,64.61,,,,,,,,,21.42,,APPROVED,Female,49.0,FALSE
1009,2022-03-22 02:39:20,19,en,944550647,2022-03-22 02:36:47,2022-03-22 02:39:20,Y,Y,A2,,,8,,,,,,,,,,,,,,,,,,,,,,,,,,,,,,,,,10,,,,,,,,,,,,,,,,,,,,,,,,,,,,,,,,,6,,,,,,,,,,,,,,,,,,,,,,,,,,,,,,,,,13,,,,,,,,,,,,,,,,,,,,,,,,,,,,,,,,,9,,,,,,,,,,,,,,,,,,,,,,,,,,,,,,,,,11,,,,,,,,,,,,,,,,,,,,,,,,,,,,,,,,,12,,,,,,,,,,,,,,,,,,,,,,,,,,,,,,,,,5,,,,,,,,,,,,,,,,,,,,,,,,,,,,,,,,,4,,,,,,,,,,,,,,,,,,,,,,,,,,,,,,,,,3,,,,,,,,,,,,,,,,,,,,,,,,,,,,,,,,,7,,,,,,,,,,,,,,,,,,,,,,,,,,,,,,,,,0,6.0,7.0,6.0,6.0,6.0,6.0,1.0,6.0,6.0,6.0,6.0,6.0,6.0,6.0,6.0,6.0,6.0,2.0,5.0,6.0,6.0,6.0,6.0,6.0,6.0,5.0,2.0,5.0,6.0,6.0,6.0,5.0,2,2.0,6.0,6.0,6.0,6.0,2.0,6.0,2.0,3.0,3.0,2.0,2.0,2.0,2.0,2.0,6.0,2.0,2.0,6.0,2.0,2.0,6.0,6.0,2.0,2.0,6.0,6.0,2.0,2.0,6.0,6.0,6.0,14,,,,,,,,,,,,,,,,,,,,,,,,,,,,,,,,,1,6.0,6.0,6.0,4.0,6.0,7.0,2.0,6.0,6.0,7.0,6.0,6.0,6.0,6.0,6.0,7.0,6.0,6.0,6.0,6.0,7.0,6.0,6.0,6.0,6.0,6.0,6.0,6.0,7.0,7.0,7.0,1.0,,154.53,9.94,,,,5.25,,16.17,,,,,,,,,,,,,,,,,,,,,,,,,,,,,,,,,,,40.13,,,47.45,,,,,,31.02,,,4.57,,APPROVED,Male,28.0,FALSE
1010,2022-03-22 02:47:53,19,en,170415556,2022-03-22 02:36:48,2022-03-22 02:47:53,Y,Y,-oth-,High School Graduate,,9,,,,,,,,,,,,,,,,,,,,,,,,,,,,,,,,,4,,,,,,,,,,,,,,,,,,,,,,,,,,,,,,,,,5,,,,,,,,,,,,,,,,,,,,,,,,,,,,,,,,,8,,,,,,,,,,,,,,,,,,,,,,,,,,,,,,,,,6,,,,,,,,,,,,,,,,,,,,,,,,,,,,,,,,,14,,,,,,,,,,,,,,,,,,,,,,,,,,,,,,,,,3,,,,,,,,,,,,,,,,,,,,,,,,,,,,,,,,,10,,,,,,,,,,,,,,,,,,,,,,,,,,,,,,,,,12,,,,,,,,,,,,,,,,,,,,,,,,,,,,,,,,,7,,,,,,,,,,,,,,,,,,,,,,,,,,,,,,,,,0,3.0,7.0,3.0,3.0,3.0,3.0,7.0,3.0,4.0,3.0,3.0,3.0,4.0,3.0,3.0,2.0,4.0,3.0,3.0,3.0,3.0,3.0,3.0,3.0,3.0,5.0,2.0,3.0,3.0,4.0,4.0,4.0,13,,,,,,,,,,,,,,,,,,,,,,,,,,,,,,,,,1,1.0,1.0,1.0,4.0,1.0,4.0,7.0,1.0,1.0,1.0,1.0,1.0,1.0,1.0,1.0,1.0,1.0,1.0,1.0,1.0,1.0,1.0,1.0,1.0,1.0,1.0,1.0,1.0,1.0,1.0,1.0,6.0,2,7.0,7.0,7.0,7.0,7.0,6.0,1.0,7.0,7.0,6.0,7.0,7.0,6.0,7.0,7.0,7.0,7.0,6.0,7.0,6.0,7.0,6.0,6.0,7.0,7.0,7.0,7.0,7.0,7.0,7.0,7.0,7.0,11,,,,,,,,,,,,,,,,,,,,,,,,,,,,,,,,,Very different than my normal surveys but really enjoyable!,436.39,53.58,,,,59.51,,36.56,,,,,,,,,,,,,,,,,,,,,,,,,,,,,,,,106.66,,,,,,97.58,,,59.45,,,,,,23.05,,APPROVED,Male,42.0,FALSE
1011,2022-03-22 02:44:33,19,en,678842448,2022-03-22 02:36:48,2022-03-22 02:44:33,Y,Y,A1,,,8,,,,,,,,,,,,,,,,,,,,,,,,,,,,,,,,,7,,,,,,,,,,,,,,,,,,,,,,,,,,,,,,,,,0,6.0,6.0,6.0,4.0,5.0,4.0,5.0,6.0,6.0,5.0,6.0,5.0,6.0,6.0,6.0,3.0,7.0,5.0,5.0,5.0,4.0,5.0,2.0,5.0,6.0,4.0,5.0,4.0,5.0,5.0,4.0,3.0,13,,,,,,,,,,,,,,,,,,,,,,,,,,,,,,,,,6,,,,,,,,,,,,,,,,,,,,,,,,,,,,,,,,,4,,,,,,,,,,,,,,,,,,,,,,,,,,,,,,,,,9,,,,,,,,,,,,,,,,,,,,,,,,,,,,,,,,,14,,,,,,,,,,,,,,,,,,,,,,,,,,,,,,,,,12,,,,,,,,,,,,,,,,,,,,,,,,,,,,,,,,,1,2.0,3.0,3.0,4.0,3.0,3.0,6.0,2.0,3.0,3.0,2.0,2.0,4.0,3.0,4.0,2.0,4.0,3.0,3.0,3.0,3.0,3.0,4.0,3.0,3.0,5.0,3.0,4.0,3.0,3.0,4.0,3.0,3,,,,,,,,,,,,,,,,,,,,,,,,,,,,,,,,,10,,,,,,,,,,,,,,,,,,,,,,,,,,,,,,,,,11,,,,,,,,,,,,,,,,,,,,,,,,,,,,,,,,,2,4.0,5.0,4.0,4.0,4.0,5.0,2.0,4.0,6.0,3.0,4.0,6.0,4.0,5.0,6.0,4.0,7.0,4.0,4.0,4.0,4.0,4.0,6.0,4.0,4.0,6.0,5.0,4.0,6.0,4.0,6.0,7.0,5,,,,,,,,,,,,,,,,,,,,,,,,,,,,,,,,,,465.86,27.79,,,,12.16,,37.15,,,,,,,,137.3,,,,,,,,,,,,,,,,,,,,,121.3,,,,,,,,,,,,122.98,,,,,,7.18,,APPROVED,Male,23.0,FALSE
1013,2022-03-22 02:40:27,19,en,59326676,2022-03-22 02:36:50,2022-03-22 02:40:27,Y,Y,A2,,,13,,,,,,,,,,,,,,,,,,,,,,,,,,,,,,,,,8,,,,,,,,,,,,,,,,,,,,,,,,,,,,,,,,,0,5.0,5.0,5.0,5.0,4.0,5.0,6.0,6.0,6.0,4.0,5.0,3.0,5.0,5.0,5.0,5.0,6.0,4.0,4.0,4.0,5.0,5.0,5.0,4.0,4.0,5.0,4.0,5.0,4.0,4.0,5.0,3.0,9,,,,,,,,,,,,,,,,,,,,,,,,,,,,,,,,,5,,,,,,,,,,,,,,,,,,,,,,,,,,,,,,,,,2,6.0,4.0,5.0,4.0,5.0,4.0,5.0,5.0,5.0,5.0,5.0,4.0,5.0,3.0,4.0,5.0,5.0,4.0,5.0,3.0,4.0,4.0,5.0,5.0,4.0,5.0,3.0,4.0,3.0,5.0,4.0,6.0,3,,,,,,,,,,,,,,,,,,,,,,,,,,,,,,,,,6,,,,,,,,,,,,,,,,,,,,,,,,,,,,,,,,,1,3.0,2.0,1.0,3.0,2.0,2.0,5.0,5.0,2.0,2.0,1.0,2.0,2.0,2.0,2.0,5.0,2.0,3.0,2.0,2.0,2.0,2.0,2.0,1.0,1.0,3.0,2.0,2.0,2.0,2.0,2.0,2.0,12,,,,,,,,,,,,,,,,,,,,,,,,,,,,,,,,,4,,,,,,,,,,,,,,,,,,,,,,,,,,,,,,,,,10,,,,,,,,,,,,,,,,,,,,,,,,,,,,,,,,,14,,,,,,,,,,,,,,,,,,,,,,,,,,,,,,,,,7,,,,,,,,,,,,,,,,,,,,,,,,,,,,,,,,,11,,,,,,,,,,,,,,,,,,,,,,,,,,,,,,,,,,218.86,13.14,,,,4.93,,20.96,,,,,,,,67.68,,,,,,,,,55.23,,,,,,,,,53.73,,,,,,,,,,,,,,,,,,,,,3.19,,APPROVED,Male,34.0,FALSE
1015,2022-03-22 02:52:17,19,en,1336814107,2022-03-22 02:36:52,2022-03-22 02:52:17,Y,Y,A1,,,12,,,,,,,,,,,,,,,,,,,,,,,,,,,,,,,,,8,,,,,,,,,,,,,,,,,,,,,,,,,,,,,,,,,6,,,,,,,,,,,,,,,,,,,,,,,,,,,,,,,,,7,,,,,,,,,,,,,,,,,,,,,,,,,,,,,,,,,1,3.0,5.0,4.0,5.0,3.0,5.0,3.0,5.0,4.0,4.0,3.0,3.0,2.0,3.0,4.0,4.0,4.0,4.0,3.0,3.0,4.0,4.0,2.0,3.0,5.0,3.0,4.0,3.0,4.0,3.0,3.0,5.0,13,,,,,,,,,,,,,,,,,,,,,,,,,,,,,,,,,4,,,,,,,,,,,,,,,,,,,,,,,,,,,,,,,,,3,,,,,,,,,,,,,,,,,,,,,,,,,,,,,,,,,14,,,,,,,,,,,,,,,,,,,,,,,,,,,,,,,,,10,,,,,,,,,,,,,,,,,,,,,,,,,,,,,,,,,9,,,,,,,,,,,,,,,,,,,,,,,,,,,,,,,,,0,4.0,5.0,4.0,4.0,5.0,2.0,4.0,4.0,4.0,3.0,3.0,3.0,2.0,5.0,4.0,2.0,5.0,4.0,4.0,4.0,5.0,4.0,1.0,4.0,5.0,2.0,3.0,4.0,2.0,3.0,2.0,5.0,2,4.0,5.0,4.0,4.0,5.0,4.0,6.0,6.0,5.0,4.0,5.0,4.0,4.0,4.0,4.0,5.0,6.0,4.0,4.0,5.0,5.0,5.0,3.0,4.0,5.0,4.0,3.0,5.0,3.0,4.0,4.0,6.0,5,,,,,,,,,,,,,,,,,,,,,,,,,,,,,,,,,11,,,,,,,,,,,,,,,,,,,,,,,,,,,,,,,,,,923.87,113.11,,,,14.98,,162.31,,,,,,,,,,,,,,163.79,,,,,,,,,,,,,,,,,,,,,177.45,,,287.22,,,,,,,,,5.01,,APPROVED,Female,22.0,FALSE
1016,2022-03-22 02:48:24,19,en,128358687,2022-03-22 02:36:52,2022-03-22 02:48:24,Y,Y,-oth-,Highschool,,13,,,,,,,,,,,,,,,,,,,,,,,,,,,,,,,,,1,7.0,6.0,6.0,7.0,7.0,7.0,1.0,7.0,3.0,6.0,6.0,7.0,6.0,2.0,6.0,7.0,7.0,7.0,7.0,6.0,4.0,7.0,7.0,7.0,7.0,7.0,1.0,6.0,6.0,6.0,6.0,2.0,2,2.0,6.0,2.0,2.0,2.0,2.0,6.0,2.0,6.0,2.0,2.0,3.0,3.0,2.0,2.0,2.0,3.0,2.0,2.0,2.0,1.0,2.0,1.0,3.0,2.0,2.0,1.0,2.0,2.0,2.0,2.0,5.0,0,2.0,5.0,2.0,1.0,3.0,1.0,7.0,3.0,5.0,2.0,2.0,2.0,1.0,2.0,2.0,2.0,2.0,1.0,2.0,2.0,3.0,2.0,1.0,3.0,2.0,2.0,1.0,2.0,2.0,2.0,2.0,4.0,9,,,,,,,,,,,,,,,,,,,,,,,,,,,,,,,,,4,,,,,,,,,,,,,,,,,,,,,,,,,,,,,,,,,14,,,,,,,,,,,,,,,,,,,,,,,,,,,,,,,,,7,,,,,,,,,,,,,,,,,,,,,,,,,,,,,,,,,3,,,,,,,,,,,,,,,,,,,,,,,,,,,,,,,,,6,,,,,,,,,,,,,,,,,,,,,,,,,,,,,,,,,11,,,,,,,,,,,,,,,,,,,,,,,,,,,,,,,,,10,,,,,,,,,,,,,,,,,,,,,,,,,,,,,,,,,12,,,,,,,,,,,,,,,,,,,,,,,,,,,,,,,,,5,,,,,,,,,,,,,,,,,,,,,,,,,,,,,,,,,8,,,,,,,,,,,,,,,,,,,,,,,,,,,,,,,,,"The study had errors several times, making me have to close it and re-start.",436.95,165.48,,,,31.27,,26.14,,,,,54.09,,,65.32,,,67.33,,,,,,,,,,,,,,,,,,,,,,,,,,,,,,,,,,,,27.32,,APPROVED,Female,21.0,FALSE
1017,2022-03-22 02:41:37,19,en,703140166,2022-03-22 02:36:54,2022-03-22 02:41:37,Y,Y,A2,,,12,,,,,,,,,,,,,,,,,,,,,,,,,,,,,,,,,11,,,,,,,,,,,,,,,,,,,,,,,,,,,,,,,,,4,,,,,,,,,,,,,,,,,,,,,,,,,,,,,,,,,14,,,,,,,,,,,,,,,,,,,,,,,,,,,,,,,,,5,,,,,,,,,,,,,,,,,,,,,,,,,,,,,,,,,9,,,,,,,,,,,,,,,,,,,,,,,,,,,,,,,,,6,,,,,,,,,,,,,,,,,,,,,,,,,,,,,,,,,7,,,,,,,,,,,,,,,,,,,,,,,,,,,,,,,,,2,3.0,3.0,3.0,3.0,3.0,3.0,6.0,3.0,4.0,3.0,3.0,3.0,3.0,3.0,3.0,3.0,4.0,3.0,3.0,3.0,2.0,3.0,4.0,3.0,2.0,4.0,4.0,3.0,4.0,3.0,3.0,2.0,10,,,,,,,,,,,,,,,,,,,,,,,,,,,,,,,,,13,,,,,,,,,,,,,,,,,,,,,,,,,,,,,,,,,0,6.0,6.0,6.0,5.0,6.0,6.0,3.0,6.0,6.0,6.0,6.0,6.0,6.0,5.0,6.0,5.0,6.0,6.0,6.0,5.0,5.0,5.0,5.0,5.0,6.0,5.0,5.0,6.0,6.0,6.0,6.0,5.0,1,5.0,4.0,5.0,5.0,5.0,6.0,5.0,4.0,5.0,4.0,5.0,5.0,4.0,4.0,5.0,4.0,5.0,5.0,5.0,4.0,5.0,5.0,5.0,5.0,5.0,6.0,4.0,5.0,6.0,5.0,6.0,6.0,3,,,,,,,,,,,,,,,,,,,,,,,,,,,,,,,,,8,,,,,,,,,,,,,,,,,,,,,,,,,,,,,,,,,,284.1,21.75,,,,8.16,,24.69,,,,,,,,,,,,,,,,,,,,,,,,,,96.55,,,,,,,,,59.4,,,69.53,,,,,,,,,4.02,,APPROVED,Male,47.0,FALSE
1018,2022-03-22 02:41:31,19,en,885327786,2022-03-22 02:36:58,2022-03-22 02:41:31,Y,Y,A1,,,1,1.0,5.0,1.0,3.0,1.0,1.0,3.0,4.0,5.0,2.0,1.0,2.0,1.0,1.0,2.0,1.0,3.0,1.0,1.0,1.0,2.0,2.0,1.0,1.0,1.0,4.0,2.0,2.0,2.0,1.0,3.0,1.0,13,,,,,,,,,,,,,,,,,,,,,,,,,,,,,,,,,7,,,,,,,,,,,,,,,,,,,,,,,,,,,,,,,,,5,,,,,,,,,,,,,,,,,,,,,,,,,,,,,,,,,8,,,,,,,,,,,,,,,,,,,,,,,,,,,,,,,,,4,,,,,,,,,,,,,,,,,,,,,,,,,,,,,,,,,11,,,,,,,,,,,,,,,,,,,,,,,,,,,,,,,,,6,,,,,,,,,,,,,,,,,,,,,,,,,,,,,,,,,2,4.0,1.0,2.0,4.0,1.0,4.0,3.0,1.0,4.0,2.0,3.0,5.0,3.0,2.0,4.0,4.0,6.0,3.0,2.0,2.0,4.0,4.0,5.0,2.0,1.0,7.0,3.0,3.0,3.0,3.0,5.0,2.0,12,,,,,,,,,,,,,,,,,,,,,,,,,,,,,,,,,3,,,,,,,,,,,,,,,,,,,,,,,,,,,,,,,,,14,,,,,,,,,,,,,,,,,,,,,,,,,,,,,,,,,9,,,,,,,,,,,,,,,,,,,,,,,,,,,,,,,,,0,1.0,2.0,1.0,4.0,1.0,1.0,2.0,5.0,4.0,1.0,1.0,1.0,1.0,2.0,1.0,3.0,1.0,1.0,1.0,1.0,2.0,1.0,3.0,1.0,1.0,6.0,5.0,2.0,2.0,1.0,5.0,7.0,10,,,,,,,,,,,,,,,,,,,,,,,,,,,,,,,,,,274.94,18.62,,,,5.47,,31.97,,66.49,,,,,,,,,,,,,,,,,,,,,,,,72.25,,,,,,,,,,,,,,,75.91,,,,,,4.23,,APPROVED,Male,49.0,FALSE
1019,2022-03-22 02:42:26,19,en,871973160,2022-03-22 02:36:58,2022-03-22 02:42:26,Y,Y,A1,,,5,,,,,,,,,,,,,,,,,,,,,,,,,,,,,,,,,1,2.0,3.0,2.0,2.0,1.0,2.0,5.0,3.0,3.0,1.0,2.0,4.0,1.0,2.0,3.0,4.0,3.0,3.0,3.0,3.0,3.0,3.0,2.0,3.0,3.0,3.0,3.0,5.0,3.0,2.0,4.0,2.0,13,,,,,,,,,,,,,,,,,,,,,,,,,,,,,,,,,10,,,,,,,,,,,,,,,,,,,,,,,,,,,,,,,,,9,,,,,,,,,,,,,,,,,,,,,,,,,,,,,,,,,3,,,,,,,,,,,,,,,,,,,,,,,,,,,,,,,,,0,4.0,6.0,5.0,6.0,6.0,6.0,5.0,6.0,6.0,5.0,6.0,6.0,5.0,6.0,5.0,5.0,6.0,5.0,5.0,5.0,5.0,5.0,6.0,5.0,5.0,2.0,5.0,5.0,6.0,6.0,6.0,7.0,2,2.0,2.0,3.0,2.0,2.0,2.0,2.0,2.0,3.0,2.0,2.0,1.0,2.0,4.0,1.0,3.0,3.0,1.0,2.0,2.0,2.0,2.0,4.0,3.0,1.0,3.0,2.0,2.0,2.0,3.0,5.0,1.0,11,,,,,,,,,,,,,,,,,,,,,,,,,,,,,,,,,4,,,,,,,,,,,,,,,,,,,,,,,,,,,,,,,,,8,,,,,,,,,,,,,,,,,,,,,,,,,,,,,,,,,6,,,,,,,,,,,,,,,,,,,,,,,,,,,,,,,,,7,,,,,,,,,,,,,,,,,,,,,,,,,,,,,,,,,14,,,,,,,,,,,,,,,,,,,,,,,,,,,,,,,,,12,,,,,,,,,,,,,,,,,,,,,,,,,,,,,,,,,,328.79,15.91,,,,5.31,,9.92,,,,,56.0,,,,,,,,,,,,,,,82.36,,,58.59,,,,,,,,,,,,,,,,,,,,,,,,100.7,,APPROVED,Male,22.0,FALSE
1021,2022-03-22 02:44:45,19,en,1402102358,2022-03-22 02:37:01,2022-03-22 02:44:45,Y,Y,A2,,,14,,,,,,,,,,,,,,,,,,,,,,,,,,,,,,,,,13,,,,,,,,,,,,,,,,,,,,,,,,,,,,,,,,,0,6.0,6.0,6.0,5.0,6.0,3.0,6.0,6.0,6.0,5.0,6.0,6.0,6.0,5.0,6.0,6.0,7.0,6.0,6.0,6.0,5.0,6.0,5.0,6.0,5.0,5.0,6.0,6.0,6.0,6.0,6.0,3.0,7,,,,,,,,,,,,,,,,,,,,,,,,,,,,,,,,,4,,,,,,,,,,,,,,,,,,,,,,,,,,,,,,,,,8,,,,,,,,,,,,,,,,,,,,,,,,,,,,,,,,,2,1.0,5.0,2.0,2.0,2.0,1.0,6.0,6.0,5.0,2.0,2.0,3.0,2.0,2.0,2.0,2.0,5.0,1.0,3.0,2.0,2.0,2.0,2.0,2.0,2.0,2.0,5.0,2.0,1.0,2.0,2.0,7.0,3,,,,,,,,,,,,,,,,,,,,,,,,,,,,,,,,,5,,,,,,,,,,,,,,,,,,,,,,,,,,,,,,,,,10,,,,,,,,,,,,,,,,,,,,,,,,,,,,,,,,,9,,,,,,,,,,,,,,,,,,,,,,,,,,,,,,,,,12,,,,,,,,,,,,,,,,,,,,,,,,,,,,,,,,,11,,,,,,,,,,,,,,,,,,,,,,,,,,,,,,,,,6,,,,,,,,,,,,,,,,,,,,,,,,,,,,,,,,,1,2.0,7.0,4.0,2.0,3.0,2.0,5.0,5.0,6.0,3.0,3.0,4.0,3.0,3.0,5.0,3.0,6.0,3.0,3.0,3.0,3.0,4.0,1.0,4.0,3.0,2.0,5.0,2.0,2.0,3.0,2.0,1.0,"None, thank you",467.37,104.35,,,,8.18,,28.77,,,,,,,,98.85,,,,,,,,,,,,96.67,,,,,,,,,,,,,,,,,,,,,,,,109.32,,,21.23,,APPROVED,Female,49.0,FALSE
1023,2022-03-22 02:50:15,19,en,327995590,2022-03-22 02:37:03,2022-03-22 02:50:15,Y,Y,A1,,,5,,,,,,,,,,,,,,,,,,,,,,,,,,,,,,,,,8,,,,,,,,,,,,,,,,,,,,,,,,,,,,,,,,,10,,,,,,,,,,,,,,,,,,,,,,,,,,,,,,,,,0,6.0,7.0,6.0,5.0,7.0,3.0,6.0,6.0,6.0,5.0,7.0,5.0,6.0,6.0,6.0,6.0,6.0,5.0,6.0,6.0,4.0,5.0,3.0,6.0,6.0,6.0,4.0,6.0,6.0,6.0,5.0,4.0,1,4.0,4.0,4.0,4.0,4.0,2.0,6.0,3.0,5.0,4.0,3.0,4.0,3.0,4.0,4.0,4.0,4.0,4.0,3.0,4.0,4.0,3.0,3.0,3.0,3.0,5.0,4.0,3.0,5.0,3.0,4.0,5.0,12,,,,,,,,,,,,,,,,,,,,,,,,,,,,,,,,,3,,,,,,,,,,,,,,,,,,,,,,,,,,,,,,,,,9,,,,,,,,,,,,,,,,,,,,,,,,,,,,,,,,,7,,,,,,,,,,,,,,,,,,,,,,,,,,,,,,,,,6,,,,,,,,,,,,,,,,,,,,,,,,,,,,,,,,,4,,,,,,,,,,,,,,,,,,,,,,,,,,,,,,,,,11,,,,,,,,,,,,,,,,,,,,,,,,,,,,,,,,,13,,,,,,,,,,,,,,,,,,,,,,,,,,,,,,,,,14,,,,,,,,,,,,,,,,,,,,,,,,,,,,,,,,,2,5.0,6.0,4.0,5.0,5.0,4.0,5.0,5.0,5.0,4.0,6.0,4.0,4.0,3.0,6.0,4.0,6.0,4.0,4.0,4.0,4.0,4.0,4.0,4.0,5.0,5.0,5.0,3.0,5.0,4.0,4.0,1.0,,1679.23,35.81,,,,5.29,,1029.95,,,,,,,,,,,458.69,,,72.4,,,,,,,,,,,,,,,,,,,,,,,,,,,,,,71.85,,,5.24,,APPROVED,Male,30.0,FALSE
1024,2022-03-22 02:44:08,19,en,157395026,2022-03-22 02:37:04,2022-03-22 02:44:08,Y,Y,A1,,,4,,,,,,,,,,,,,,,,,,,,,,,,,,,,,,,,,2,7.0,5.0,7.0,7.0,5.0,7.0,2.0,6.0,5.0,5.0,6.0,6.0,7.0,4.0,6.0,7.0,7.0,7.0,7.0,7.0,6.0,7.0,7.0,7.0,7.0,7.0,1.0,7.0,6.0,7.0,7.0,2.0,5,,,,,,,,,,,,,,,,,,,,,,,,,,,,,,,,,6,,,,,,,,,,,,,,,,,,,,,,,,,,,,,,,,,11,,,,,,,,,,,,,,,,,,,,,,,,,,,,,,,,,13,,,,,,,,,,,,,,,,,,,,,,,,,,,,,,,,,14,,,,,,,,,,,,,,,,,,,,,,,,,,,,,,,,,8,,,,,,,,,,,,,,,,,,,,,,,,,,,,,,,,,1,2.0,6.0,3.0,1.0,1.0,1.0,7.0,4.0,4.0,2.0,4.0,1.0,1.0,2.0,2.0,1.0,2.0,2.0,1.0,2.0,1.0,1.0,2.0,1.0,2.0,2.0,6.0,1.0,3.0,1.0,1.0,2.0,9,,,,,,,,,,,,,,,,,,,,,,,,,,,,,,,,,10,,,,,,,,,,,,,,,,,,,,,,,,,,,,,,,,,3,,,,,,,,,,,,,,,,,,,,,,,,,,,,,,,,,7,,,,,,,,,,,,,,,,,,,,,,,,,,,,,,,,,0,5.0,5.0,4.0,5.0,5.0,4.0,5.0,6.0,5.0,4.0,3.0,6.0,5.0,4.0,6.0,5.0,6.0,5.0,6.0,3.0,3.0,6.0,5.0,6.0,4.0,5.0,6.0,4.0,5.0,5.0,5.0,7.0,12,,,,,,,,,,,,,,,,,,,,,,,,,,,,,,,,,,427.18,24.5,,,,8.0,,54.69,,,,,75.77,,,,,,,,,,,,,,,,,,,,,124.81,,,,,,,,,,,,,,,112.86,,,,,,26.55,,APPROVED,Male,40.0,FALSE
1025,2022-03-22 02:40:13,19,en,1854412851,2022-03-22 02:37:10,2022-03-22 02:40:13,Y,Y,A1,60317fc2c8f6320ecde4bcb3,,9,,,,,,,,,,,,,,,,,,,,,,,,,,,,,,,,,10,,,,,,,,,,,,,,,,,,,,,,,,,,,,,,,,,7,,,,,,,,,,,,,,,,,,,,,,,,,,,,,,,,,0,4.0,5.0,4.0,3.0,3.0,3.0,5.0,5.0,5.0,4.0,3.0,3.0,6.0,3.0,5.0,3.0,5.0,3.0,5.0,4.0,4.0,5.0,2.0,5.0,4.0,4.0,2.0,3.0,3.0,4.0,2.0,4.0,5,,,,,,,,,,,,,,,,,,,,,,,,,,,,,,,,,11,,,,,,,,,,,,,,,,,,,,,,,,,,,,,,,,,13,,,,,,,,,,,,,,,,,,,,,,,,,,,,,,,,,1,1.0,2.0,1.0,1.0,1.0,1.0,3.0,1.0,1.0,1.0,1.0,1.0,1.0,1.0,1.0,1.0,1.0,1.0,1.0,1.0,1.0,1.0,1.0,1.0,1.0,1.0,5.0,1.0,1.0,1.0,1.0,1.0,4,,,,,,,,,,,,,,,,,,,,,,,,,,,,,,,,,6,,,,,,,,,,,,,,,,,,,,,,,,,,,,,,,,,12,,,,,,,,,,,,,,,,,,,,,,,,,,,,,,,,,8,,,,,,,,,,,,,,,,,,,,,,,,,,,,,,,,,3,,,,,,,,,,,,,,,,,,,,,,,,,,,,,,,,,14,,,,,,,,,,,,,,,,,,,,,,,,,,,,,,,,,2,1.0,4.0,1.0,4.0,1.0,5.0,1.0,4.0,1.0,1.0,4.0,1.0,1.0,1.0,1.0,4.0,1.0,1.0,2.0,1.0,1.0,1.0,4.0,1.0,1.0,4.0,1.0,1.0,2.0,1.0,4.0,1.0,,183.98,11.22,,,,10.0,,7.36,,,,,,,,,,,77.44,,,,,,,,,,,,32.27,,,,,,,,,,,,,,,,,,,,,43.22,,,2.47,,APPROVED,Female,29.0,FALSE
1027,2022-03-22 02:47:37,19,en,2080785563,2022-03-22 02:37:10,2022-03-22 02:47:37,Y,Y,A2,,,12,,,,,,,,,,,,,,,,,,,,,,,,,,,,,,,,,9,,,,,,,,,,,,,,,,,,,,,,,,,,,,,,,,,13,,,,,,,,,,,,,,,,,,,,,,,,,,,,,,,,,1,6.0,4.0,5.0,4.0,5.0,6.0,6.0,4.0,6.0,5.0,5.0,4.0,5.0,4.0,5.0,5.0,6.0,4.0,5.0,4.0,4.0,6.0,5.0,5.0,6.0,2.0,5.0,5.0,6.0,5.0,3.0,4.0,4,,,,,,,,,,,,,,,,,,,,,,,,,,,,,,,,,0,3.0,5.0,2.0,4.0,2.0,1.0,6.0,6.0,5.0,4.0,1.0,4.0,2.0,4.0,2.0,3.0,5.0,4.0,2.0,4.0,4.0,2.0,1.0,2.0,2.0,1.0,4.0,1.0,5.0,2.0,1.0,6.0,7,,,,,,,,,,,,,,,,,,,,,,,,,,,,,,,,,6,,,,,,,,,,,,,,,,,,,,,,,,,,,,,,,,,8,,,,,,,,,,,,,,,,,,,,,,,,,,,,,,,,,3,,,,,,,,,,,,,,,,,,,,,,,,,,,,,,,,,14,,,,,,,,,,,,,,,,,,,,,,,,,,,,,,,,,2,4.0,1.0,4.0,5.0,5.0,5.0,2.0,5.0,1.0,4.0,5.0,4.0,5.0,4.0,4.0,4.0,4.0,4.0,4.0,4.0,4.0,5.0,6.0,4.0,3.0,7.0,4.0,5.0,5.0,5.0,6.0,5.0,5,,,,,,,,,,,,,,,,,,,,,,,,,,,,,,,,,10,,,,,,,,,,,,,,,,,,,,,,,,,,,,,,,,,11,,,,,,,,,,,,,,,,,,,,,,,,,,,,,,,,,There was an internal server error while doing it and I had to repeat the last part,433.24,65.41,,,,5.66,,39.66,,,,,,,,,,,89.49,,,,,,103.55,,,,,,,,,,,,,,,,,,80.93,,,,,,,,,,,,48.54,,APPROVED,Male,24.0,FALSE
1029,2022-03-22 02:50:28,19,en,1788731721,2022-03-22 02:37:15,2022-03-22 02:50:28,Y,Y,-oth-,College,,1,1.0,2.0,2.0,1.0,2.0,1.0,7.0,6.0,6.0,2.0,2.0,5.0,2.0,2.0,6.0,2.0,6.0,2.0,2.0,2.0,2.0,2.0,1.0,2.0,2.0,1.0,7.0,2.0,3.0,3.0,2.0,1.0,2,5.0,2.0,6.0,5.0,6.0,6.0,2.0,7.0,2.0,2.0,6.0,5.0,3.0,2.0,2.0,6.0,6.0,5.0,6.0,2.0,3.0,6.0,7.0,6.0,6.0,7.0,5.0,7.0,2.0,7.0,6.0,2.0,0,2.0,6.0,5.0,1.0,2.0,5.0,5.0,5.0,6.0,2.0,2.0,2.0,1.0,2.0,5.0,1.0,6.0,1.0,2.0,3.0,2.0,2.0,2.0,2.0,6.0,1.0,6.0,2.0,2.0,2.0,2.0,3.0,8,,,,,,,,,,,,,,,,,,,,,,,,,,,,,,,,,6,,,,,,,,,,,,,,,,,,,,,,,,,,,,,,,,,5,,,,,,,,,,,,,,,,,,,,,,,,,,,,,,,,,13,,,,,,,,,,,,,,,,,,,,,,,,,,,,,,,,,11,,,,,,,,,,,,,,,,,,,,,,,,,,,,,,,,,9,,,,,,,,,,,,,,,,,,,,,,,,,,,,,,,,,3,,,,,,,,,,,,,,,,,,,,,,,,,,,,,,,,,12,,,,,,,,,,,,,,,,,,,,,,,,,,,,,,,,,7,,,,,,,,,,,,,,,,,,,,,,,,,,,,,,,,,10,,,,,,,,,,,,,,,,,,,,,,,,,,,,,,,,,14,,,,,,,,,,,,,,,,,,,,,,,,,,,,,,,,,4,,,,,,,,,,,,,,,,,,,,,,,,,,,,,,,,,"simple and easy to follow, thanks",794.14,38.9,,,,26.13,,50.89,,306.74,,,162.87,,,142.25,,,,,,,,,,,,,,,,,,,,,,,,,,,,,,,,,,,,,,,66.36,,APPROVED,Male,55.0,FALSE
1030,2022-03-22 03:28:43,19,en,1072860138,2022-03-22 02:37:15,2022-03-22 03:28:43,Y,Y,A1,,,9,,,,,,,,,,,,,,,,,,,,,,,,,,,,,,,,,1,2.0,2.0,4.0,4.0,4.0,4.0,4.0,4.0,3.0,4.0,4.0,3.0,4.0,4.0,4.0,4.0,2.0,4.0,4.0,3.0,3.0,2.0,4.0,4.0,4.0,3.0,4.0,2.0,4.0,4.0,4.0,2.0,14,,,,,,,,,,,,,,,,,,,,,,,,,,,,,,,,,7,,,,,,,,,,,,,,,,,,,,,,,,,,,,,,,,,13,,,,,,,,,,,,,,,,,,,,,,,,,,,,,,,,,0,6.0,7.0,6.0,2.0,4.0,4.0,4.0,4.0,7.0,6.0,6.0,7.0,7.0,6.0,7.0,2.0,6.0,6.0,7.0,6.0,6.0,7.0,1.0,7.0,6.0,4.0,6.0,6.0,6.0,6.0,4.0,6.0,5,,,,,,,,,,,,,,,,,,,,,,,,,,,,,,,,,8,,,,,,,,,,,,,,,,,,,,,,,,,,,,,,,,,11,,,,,,,,,,,,,,,,,,,,,,,,,,,,,,,,,4,,,,,,,,,,,,,,,,,,,,,,,,,,,,,,,,,6,,,,,,,,,,,,,,,,,,,,,,,,,,,,,,,,,2,3.0,5.0,4.0,4.0,4.0,5.0,4.0,4.0,5.0,4.0,4.0,4.0,4.0,4.0,4.0,4.0,4.0,5.0,4.0,4.0,4.0,4.0,4.0,4.0,4.0,5.0,3.0,4.0,4.0,4.0,4.0,5.0,10,,,,,,,,,,,,,,,,,,,,,,,,,,,,,,,,,12,,,,,,,,,,,,,,,,,,,,,,,,,,,,,,,,,3,,,,,,,,,,,,,,,,,,,,,,,,,,,,,,,,,,3095.66,251.04,,,,7.56,,2021.11,,,,,203.04,,,,,,,,,,,,157.05,,,,,,,,,,,,,,,,,,451.71,,,,,,,,,,,,4.15,,TIMED-OUT,Male,56.0,FALSE
1031,2022-03-22 02:44:57,19,en,527236901,2022-03-22 02:37:19,2022-03-22 02:44:50,Y,Y,A1,,,5,,,,,,,,,,,,,,,,,,,,,,,,,,,,,,,,,6,,,,,,,,,,,,,,,,,,,,,,,,,,,,,,,,,3,,,,,,,,,,,,,,,,,,,,,,,,,,,,,,,,,13,,,,,,,,,,,,,,,,,,,,,,,,,,,,,,,,,0,6.0,7.0,5.0,4.0,6.0,6.0,2.0,6.0,6.0,6.0,5.0,6.0,6.0,5.0,5.0,6.0,6.0,6.0,6.0,5.0,7.0,6.0,7.0,6.0,5.0,7.0,5.0,5.0,5.0,5.0,7.0,5.0,7,,,,,,,,,,,,,,,,,,,,,,,,,,,,,,,,,12,,,,,,,,,,,,,,,,,,,,,,,,,,,,,,,,,10,,,,,,,,,,,,,,,,,,,,,,,,,,,,,,,,,2,2.0,5.0,3.0,3.0,3.0,3.0,3.0,3.0,5.0,3.0,5.0,5.0,3.0,5.0,3.0,3.0,5.0,5.0,3.0,3.0,3.0,3.0,3.0,3.0,3.0,5.0,5.0,3.0,3.0,5.0,5.0,2.0,11,,,,,,,,,,,,,,,,,,,,,,,,,,,,,,,,,9,,,,,,,,,,,,,,,,,,,,,,,,,,,,,,,,,14,,,,,,,,,,,,,,,,,,,,,,,,,,,,,,,,,4,,,,,,,,,,,,,,,,,,,,,,,,,,,,,,,,,8,,,,,,,,,,,,,,,,,,,,,,,,,,,,,,,,,1,7.0,5.0,6.0,4.0,6.0,6.0,6.0,6.0,6.0,5.0,5.0,4.0,5.0,5.0,7.0,5.0,6.0,6.0,6.0,7.0,5.0,6.0,5.0,6.0,6.0,6.0,6.0,6.0,7.0,4.0,6.0,1.0,,461.09,83.87,,,,9.44,,58.44,,,,,,,,,,,,,,81.4,,,,,,,,,,,,107.05,,,,,,,,,,,,,,,,,,90.63,,,30.26,,APPROVED,Female,22.0,FALSE
1032,2022-03-22 02:49:01,19,en,319002662,2022-03-22 02:37:19,2022-03-22 02:49:01,Y,Y,A2,,,3,,,,,,,,,,,,,,,,,,,,,,,,,,,,,,,,,2,6.0,5.0,6.0,5.0,5.0,6.0,2.0,6.0,5.0,5.0,6.0,6.0,5.0,5.0,5.0,5.0,6.0,5.0,6.0,4.0,5.0,5.0,6.0,5.0,5.0,6.0,5.0,6.0,5.0,6.0,6.0,2.0,2,6.0,6.0,6.0,6.0,6.0,6.0,2.0,6.0,7.0,6.0,6.0,6.0,6.0,6.0,5.0,6.0,7.0,6.0,6.0,6.0,5.0,6.0,6.0,6.0,6.0,6.0,5.0,5.0,6.0,6.0,6.0,3.0,6,,,,,,,,,,,,,,,,,,,,,,,,,,,,,,,,,7,,,,,,,,,,,,,,,,,,,,,,,,,,,,,,,,,9,,,,,,,,,,,,,,,,,,,,,,,,,,,,,,,,,10,,,,,,,,,,,,,,,,,,,,,,,,,,,,,,,,,13,,,,,,,,,,,,,,,,,,,,,,,,,,,,,,,,,4,,,,,,,,,,,,,,,,,,,,,,,,,,,,,,,,,5,,,,,,,,,,,,,,,,,,,,,,,,,,,,,,,,,12,,,,,,,,,,,,,,,,,,,,,,,,,,,,,,,,,8,,,,,,,,,,,,,,,,,,,,,,,,,,,,,,,,,14,,,,,,,,,,,,,,,,,,,,,,,,,,,,,,,,,11,,,,,,,,,,,,,,,,,,,,,,,,,,,,,,,,,0,6.0,6.0,6.0,4.0,6.0,4.0,3.0,6.0,6.0,6.0,5.0,6.0,5.0,6.0,6.0,5.0,6.0,6.0,6.0,5.0,5.0,5.0,4.0,6.0,5.0,6.0,7.0,5.0,6.0,6.0,6.0,1.0,"I enjoyed participating, thanks.",1045.68,23.38,,,,504.45,,55.98,,,,,167.73,,,112.67,,,,,,,,,,,,,,,,,,,,,,,,,,,,,,,,,,,,151.94,,,29.53,,APPROVED,Male,45.0,FALSE
1033,2022-03-22 02:48:32,19,en,1613909157,2022-03-22 02:37:25,2022-03-22 02:48:32,Y,Y,A1,,,13,,,,,,,,,,,,,,,,,,,,,,,,,,,,,,,,,11,,,,,,,,,,,,,,,,,,,,,,,,,,,,,,,,,14,,,,,,,,,,,,,,,,,,,,,,,,,,,,,,,,,11,,,,,,,,,,,,,,,,,,,,,,,,,,,,,,,,,11,,,,,,,,,,,,,,,,,,,,,,,,,,,,,,,,,11,,,,,,,,,,,,,,,,,,,,,,,,,,,,,,,,,11,,,,,,,,,,,,,,,,,,,,,,,,,,,,,,,,,11,,,,,,,,,,,,,,,,,,,,,,,,,,,,,,,,,11,,,,,,,,,,,,,,,,,,,,,,,,,,,,,,,,,11,,,,,,,,,,,,,,,,,,,,,,,,,,,,,,,,,0,3.0,6.0,4.0,5.0,4.0,2.0,4.0,6.0,5.0,3.0,3.0,5.0,3.0,4.0,5.0,5.0,6.0,3.0,4.0,4.0,4.0,4.0,2.0,3.0,4.0,2.0,5.0,4.0,2.0,4.0,3.0,4.0,11,,,,,,,,,,,,,,,,,,,,,,,,,,,,,,,,,12,,,,,,,,,,,,,,,,,,,,,,,,,,,,,,,,,11,,,,,,,,,,,,,,,,,,,,,,,,,,,,,,,,,1,5.0,6.0,5.0,6.0,4.0,6.0,3.0,4.0,4.0,6.0,6.0,4.0,5.0,6.0,5.0,5.0,6.0,4.0,5.0,4.0,4.0,6.0,6.0,5.0,5.0,6.0,4.0,5.0,6.0,5.0,6.0,1.0,,495.87,43.46,,,,8.42,,38.23,,,,,,,,,,,,,,,,,,,,,,,,,,,,,,,,103.17,,,,,,,,,,,,276.54,,,26.05,,APPROVED,Male,34.0,FALSE
1034,2022-03-22 02:48:59,19,en,1884488883,2022-03-22 02:37:25,2022-03-22 02:48:59,Y,Y,A1,,,0,3.0,6.0,3.0,2.0,3.0,2.0,6.0,3.0,7.0,5.0,2.0,5.0,5.0,5.0,5.0,5.0,6.0,3.0,3.0,3.0,2.0,5.0,1.0,3.0,2.0,3.0,6.0,5.0,6.0,2.0,5.0,1.0,6,,,,,,,,,,,,,,,,,,,,,,,,,,,,,,,,,3,,,,,,,,,,,,,,,,,,,,,,,,,,,,,,,,,1,2.0,5.0,3.0,3.0,2.0,2.0,6.0,1.0,6.0,3.0,2.0,5.0,2.0,5.0,5.0,3.0,5.0,5.0,3.0,3.0,5.0,5.0,2.0,3.0,1.0,4.0,6.0,3.0,4.0,2.0,3.0,4.0,13,,,,,,,,,,,,,,,,,,,,,,,,,,,,,,,,,11,,,,,,,,,,,,,,,,,,,,,,,,,,,,,,,,,10,,,,,,,,,,,,,,,,,,,,,,,,,,,,,,,,,9,,,,,,,,,,,,,,,,,,,,,,,,,,,,,,,,,12,,,,,,,,,,,,,,,,,,,,,,,,,,,,,,,,,5,,,,,,,,,,,,,,,,,,,,,,,,,,,,,,,,,2,5.0,5.0,7.0,4.0,3.0,3.0,4.0,6.0,7.0,3.0,4.0,6.0,5.0,6.0,5.0,6.0,5.0,5.0,5.0,3.0,5.0,6.0,5.0,6.0,6.0,3.0,3.0,6.0,5.0,6.0,5.0,4.0,14,,,,,,,,,,,,,,,,,,,,,,,,,,,,,,,,,8,,,,,,,,,,,,,,,,,,,,,,,,,,,,,,,,,4,,,,,,,,,,,,,,,,,,,,,,,,,,,,,,,,,7,,,,,,,,,,,,,,,,,,,,,,,,,,,,,,,,,"I had some server problems while doing the survey. I'll paste the error below:


Internal Server Error
CDbCommand failed to execute the SQL statement: SQLSTATE[HY000]: General error: 2006 MySQL server has gone away

An internal error occurred while the Web server was processing your request. Please contact the webmaster to report this problem.

Thank you.
2022-03-22 02:45:36",473.87,88.9,,,,9.8,,39.12,,152.99,,,,,,,,,65.63,,,,,,,,,,,,,,,,,,,,,79.45,,,,,,,,,,,,,,,37.98,,APPROVED,Female,29.0,FALSE
1035,2022-03-22 02:46:12,19,en,2081860286,2022-03-22 02:37:26,2022-03-22 02:46:11,Y,Y,A1,,,1,2.0,6.0,2.0,4.0,3.0,2.0,7.0,3.0,6.0,2.0,2.0,5.0,2.0,2.0,5.0,3.0,3.0,2.0,1.0,1.0,2.0,3.0,5.0,1.0,1.0,6.0,6.0,1.0,2.0,4.0,6.0,1.0,2,7.0,5.0,6.0,7.0,7.0,7.0,2.0,7.0,3.0,6.0,7.0,6.0,7.0,5.0,5.0,6.0,6.0,6.0,7.0,6.0,5.0,7.0,7.0,7.0,6.0,7.0,3.0,6.0,7.0,7.0,7.0,2.0,10,,,,,,,,,,,,,,,,,,,,,,,,,,,,,,,,,12,,,,,,,,,,,,,,,,,,,,,,,,,,,,,,,,,5,,,,,,,,,,,,,,,,,,,,,,,,,,,,,,,,,9,,,,,,,,,,,,,,,,,,,,,,,,,,,,,,,,,0,1.0,4.0,2.0,3.0,3.0,5.0,5.0,6.0,4.0,2.0,5.0,2.0,1.0,1.0,2.0,1.0,3.0,1.0,1.0,1.0,2.0,2.0,5.0,1.0,3.0,6.0,5.0,1.0,5.0,4.0,6.0,7.0,13,,,,,,,,,,,,,,,,,,,,,,,,,,,,,,,,,4,,,,,,,,,,,,,,,,,,,,,,,,,,,,,,,,,3,,,,,,,,,,,,,,,,,,,,,,,,,,,,,,,,,11,,,,,,,,,,,,,,,,,,,,,,,,,,,,,,,,,7,,,,,,,,,,,,,,,,,,,,,,,,,,,,,,,,,14,,,,,,,,,,,,,,,,,,,,,,,,,,,,,,,,,6,,,,,,,,,,,,,,,,,,,,,,,,,,,,,,,,,8,,,,,,,,,,,,,,,,,,,,,,,,,,,,,,,,,,316.38,23.41,,,,6.31,,61.65,,73.17,,,54.96,,,,,,,,,,,,,,,80.08,,,,,,,,,,,,,,,,,,,,,,,,,,,16.8,,RETURNED,CONSENT REVOKED,23.0,FALSE
1037,2022-03-22 02:40:35,19,en,1314997889,2022-03-22 02:37:41,2022-03-22 02:40:35,Y,Y,A1,,,9,,,,,,,,,,,,,,,,,,,,,,,,,,,,,,,,,5,,,,,,,,,,,,,,,,,,,,,,,,,,,,,,,,,4,,,,,,,,,,,,,,,,,,,,,,,,,,,,,,,,,3,,,,,,,,,,,,,,,,,,,,,,,,,,,,,,,,,11,,,,,,,,,,,,,,,,,,,,,,,,,,,,,,,,,14,,,,,,,,,,,,,,,,,,,,,,,,,,,,,,,,,7,,,,,,,,,,,,,,,,,,,,,,,,,,,,,,,,,2,5.0,7.0,5.0,3.0,5.0,2.0,6.0,7.0,6.0,2.0,2.0,6.0,3.0,4.0,6.0,1.0,6.0,2.0,4.0,5.0,2.0,2.0,4.0,1.0,3.0,3.0,6.0,3.0,6.0,2.0,3.0,1.0,13,,,,,,,,,,,,,,,,,,,,,,,,,,,,,,,,,8,,,,,,,,,,,,,,,,,,,,,,,,,,,,,,,,,1,2.0,6.0,4.0,2.0,2.0,1.0,7.0,1.0,6.0,2.0,1.0,2.0,3.0,5.0,6.0,6.0,6.0,2.0,2.0,5.0,2.0,2.0,2.0,2.0,3.0,5.0,7.0,2.0,6.0,3.0,2.0,4.0,0,6.0,7.0,6.0,4.0,6.0,6.0,4.0,4.0,6.0,6.0,5.0,2.0,6.0,6.0,5.0,6.0,4.0,6.0,6.0,6.0,2.0,6.0,2.0,6.0,7.0,5.0,6.0,6.0,6.0,4.0,3.0,5.0,10,,,,,,,,,,,,,,,,,,,,,,,,,,,,,,,,,6,,,,,,,,,,,,,,,,,,,,,,,,,,,,,,,,,12,,,,,,,,,,,,,,,,,,,,,,,,,,,,,,,,,,176.78,8.66,,,,4.79,,12.38,,,,,,,,,,,,,,,,,,,,,,,56.51,,,,,,,,,47.16,,,45.15,,,,,,,,,,,,2.13,,APPROVED,Male,24.0,FALSE
1038,2022-03-22 02:43:05,19,en,870949207,2022-03-22 02:37:54,2022-03-22 02:43:05,Y,Y,A1,,,3,,,,,,,,,,,,,,,,,,,,,,,,,,,,,,,,,6,,,,,,,,,,,,,,,,,,,,,,,,,,,,,,,,,9,,,,,,,,,,,,,,,,,,,,,,,,,,,,,,,,,14,,,,,,,,,,,,,,,,,,,,,,,,,,,,,,,,,13,,,,,,,,,,,,,,,,,,,,,,,,,,,,,,,,,4,,,,,,,,,,,,,,,,,,,,,,,,,,,,,,,,,0,1.0,3.0,2.0,7.0,2.0,4.0,2.0,6.0,4.0,3.0,2.0,4.0,3.0,3.0,4.0,5.0,5.0,3.0,4.0,2.0,2.0,4.0,6.0,3.0,3.0,5.0,6.0,3.0,3.0,3.0,6.0,7.0,8,,,,,,,,,,,,,,,,,,,,,,,,,,,,,,,,,12,,,,,,,,,,,,,,,,,,,,,,,,,,,,,,,,,1,3.0,6.0,4.0,2.0,4.0,2.0,7.0,5.0,6.0,3.0,5.0,2.0,4.0,5.0,6.0,3.0,6.0,3.0,3.0,2.0,3.0,3.0,1.0,2.0,5.0,3.0,7.0,3.0,5.0,5.0,3.0,3.0,2,5.0,3.0,3.0,6.0,2.0,5.0,2.0,6.0,3.0,5.0,2.0,5.0,5.0,4.0,3.0,5.0,5.0,6.0,6.0,4.0,5.0,5.0,6.0,5.0,4.0,2.0,3.0,6.0,3.0,3.0,6.0,4.0,5,,,,,,,,,,,,,,,,,,,,,,,,,,,,,,,,,11,,,,,,,,,,,,,,,,,,,,,,,,,,,,,,,,,10,,,,,,,,,,,,,,,,,,,,,,,,,,,,,,,,,7,,,,,,,,,,,,,,,,,,,,,,,,,,,,,,,,,,313.68,12.94,,,,7.53,,32.18,,,,,,,,,,,,,,,,,,,,83.64,,,,,,,,,85.61,,,77.96,,,,,,,,,,,,,,,13.82,,APPROVED,Female,27.0,FALSE
1039,2022-03-22 02:42:39,19,en,1358664273,2022-03-22 02:38:04,2022-03-22 02:42:39,Y,Y,A1,,,4,,,,,,,,,,,,,,,,,,,,,,,,,,,,,,,,,11,,,,,,,,,,,,,,,,,,,,,,,,,,,,,,,,,13,,,,,,,,,,,,,,,,,,,,,,,,,,,,,,,,,8,,,,,,,,,,,,,,,,,,,,,,,,,,,,,,,,,5,,,,,,,,,,,,,,,,,,,,,,,,,,,,,,,,,12,,,,,,,,,,,,,,,,,,,,,,,,,,,,,,,,,3,,,,,,,,,,,,,,,,,,,,,,,,,,,,,,,,,10,,,,,,,,,,,,,,,,,,,,,,,,,,,,,,,,,6,,,,,,,,,,,,,,,,,,,,,,,,,,,,,,,,,2,4.0,3.0,4.0,4.0,4.0,2.0,3.0,6.0,5.0,4.0,3.0,4.0,3.0,3.0,2.0,5.0,3.0,3.0,4.0,3.0,3.0,2.0,3.0,3.0,3.0,4.0,5.0,2.0,3.0,4.0,3.0,3.0,7,,,,,,,,,,,,,,,,,,,,,,,,,,,,,,,,,1,5.0,5.0,5.0,5.0,5.0,3.0,5.0,5.0,5.0,5.0,4.0,5.0,5.0,5.0,5.0,5.0,5.0,5.0,5.0,5.0,4.0,5.0,5.0,5.0,5.0,5.0,3.0,5.0,3.0,5.0,5.0,5.0,14,,,,,,,,,,,,,,,,,,,,,,,,,,,,,,,,,9,,,,,,,,,,,,,,,,,,,,,,,,,,,,,,,,,0,2.0,5.0,2.0,4.0,3.0,2.0,4.0,3.0,5.0,2.0,2.0,2.0,3.0,2.0,2.0,2.0,3.0,2.0,3.0,3.0,2.0,4.0,2.0,4.0,3.0,2.0,5.0,4.0,2.0,4.0,2.0,1.0,,278.36,16.17,,,,5.64,,32.43,,,,,,,,,,,,,,,,,,,,,,,,,,,,,75.93,,,,,,50.43,,,,,,,,,93.96,,,3.8,,APPROVED,Female,25.0,FALSE
1040,2022-03-22 02:47:00,19,en,1498031264,2022-03-22 02:38:05,2022-03-22 02:47:00,Y,Y,-oth-,College,,9,,,,,,,,,,,,,,,,,,,,,,,,,,,,,,,,,4,,,,,,,,,,,,,,,,,,,,,,,,,,,,,,,,,0,7.0,7.0,7.0,4.0,6.0,6.0,3.0,6.0,7.0,6.0,5.0,4.0,7.0,6.0,6.0,6.0,6.0,5.0,7.0,6.0,5.0,7.0,4.0,6.0,6.0,2.0,5.0,7.0,6.0,5.0,3.0,3.0,10,,,,,,,,,,,,,,,,,,,,,,,,,,,,,,,,,6,,,,,,,,,,,,,,,,,,,,,,,,,,,,,,,,,14,,,,,,,,,,,,,,,,,,,,,,,,,,,,,,,,,12,,,,,,,,,,,,,,,,,,,,,,,,,,,,,,,,,2,7.0,6.0,6.0,4.0,5.0,4.0,6.0,4.0,6.0,5.0,1.0,7.0,7.0,5.0,4.0,4.0,5.0,6.0,7.0,6.0,4.0,6.0,2.0,7.0,6.0,1.0,5.0,6.0,1.0,6.0,2.0,1.0,5,,,,,,,,,,,,,,,,,,,,,,,,,,,,,,,,,13,,,,,,,,,,,,,,,,,,,,,,,,,,,,,,,,,11,,,,,,,,,,,,,,,,,,,,,,,,,,,,,,,,,8,,,,,,,,,,,,,,,,,,,,,,,,,,,,,,,,,7,,,,,,,,,,,,,,,,,,,,,,,,,,,,,,,,,3,,,,,,,,,,,,,,,,,,,,,,,,,,,,,,,,,1,1.0,4.0,1.0,1.0,1.0,1.0,7.0,4.0,7.0,1.0,1.0,1.0,1.0,1.0,6.0,2.0,2.0,1.0,1.0,1.0,2.0,1.0,1.0,2.0,2.0,1.0,4.0,1.0,4.0,1.0,1.0,1.0,"On the last one when I continued the webpage did not load and came up with an error saying contact the webmaster. I refreshed the page and it took me back to the last task and I had to redo my choices, this time when I clicked next page this page loaded successfully.",439.78,14.75,,,,40.38,,55.99,,,,,,,,106.53,,,,,,,,,,,,,,,88.94,,,,,,,,,,,,,,,,,,,,,64.7,,,68.49,,APPROVED,Male,27.0,FALSE
1041,2022-03-22 02:51:21,19,en,1099391010,2022-03-22 02:40:08,2022-03-22 02:51:21,Y,Y,A1,,,13,,,,,,,,,,,,,,,,,,,,,,,,,,,,,,,,,8,,,,,,,,,,,,,,,,,,,,,,,,,,,,,,,,,7,,,,,,,,,,,,,,,,,,,,,,,,,,,,,,,,,10,,,,,,,,,,,,,,,,,,,,,,,,,,,,,,,,,9,,,,,,,,,,,,,,,,,,,,,,,,,,,,,,,,,3,,,,,,,,,,,,,,,,,,,,,,,,,,,,,,,,,4,,,,,,,,,,,,,,,,,,,,,,,,,,,,,,,,,0,5.0,6.0,5.0,5.0,4.0,5.0,5.0,6.0,6.0,5.0,6.0,6.0,6.0,5.0,6.0,5.0,7.0,6.0,5.0,5.0,5.0,5.0,6.0,5.0,4.0,4.0,2.0,5.0,5.0,5.0,5.0,1.0,11,,,,,,,,,,,,,,,,,,,,,,,,,,,,,,,,,6,,,,,,,,,,,,,,,,,,,,,,,,,,,,,,,,,1,7.0,7.0,7.0,5.0,7.0,6.0,5.0,7.0,6.0,6.0,5.0,6.0,6.0,6.0,7.0,6.0,7.0,7.0,7.0,6.0,6.0,6.0,6.0,6.0,7.0,5.0,2.0,7.0,7.0,6.0,7.0,4.0,5,,,,,,,,,,,,,,,,,,,,,,,,,,,,,,,,,2,5.0,6.0,5.0,6.0,5.0,6.0,5.0,3.0,7.0,5.0,5.0,6.0,6.0,5.0,6.0,4.0,6.0,5.0,6.0,5.0,6.0,5.0,5.0,6.0,6.0,7.0,2.0,5.0,6.0,5.0,7.0,6.0,12,,,,,,,,,,,,,,,,,,,,,,,,,,,,,,,,,14,,,,,,,,,,,,,,,,,,,,,,,,,,,,,,,,,"I have no comments, Thank you :)",674.04,89.59,,,,43.57,,135.88,,,,,,,,,,,,,,,,,,,,,,,133.93,,,,,,,,,112.81,,,,,,117.62,,,,,,,,,40.64,,APPROVED,Female,23.0,FALSE
1044,2022-03-22 02:51:16,19,en,349859577,2022-03-22 02:42:15,2022-03-22 02:51:16,Y,Y,A1,,,5,,,,,,,,,,,,,,,,,,,,,,,,,,,,,,,,,11,,,,,,,,,,,,,,,,,,,,,,,,,,,,,,,,,12,,,,,,,,,,,,,,,,,,,,,,,,,,,,,,,,,2,5.0,5.0,4.0,5.0,6.0,4.0,5.0,4.0,6.0,5.0,5.0,5.0,5.0,4.0,5.0,5.0,6.0,5.0,5.0,4.0,4.0,6.0,5.0,5.0,4.0,6.0,4.0,6.0,6.0,5.0,6.0,4.0,0,5.0,5.0,5.0,4.0,5.0,2.0,6.0,6.0,6.0,5.0,5.0,5.0,5.0,5.0,5.0,5.0,6.0,3.0,5.0,4.0,4.0,5.0,3.0,5.0,5.0,5.0,2.0,6.0,5.0,5.0,5.0,5.0,13,,,,,,,,,,,,,,,,,,,,,,,,,,,,,,,,,4,,,,,,,,,,,,,,,,,,,,,,,,,,,,,,,,,7,,,,,,,,,,,,,,,,,,,,,,,,,,,,,,,,,10,,,,,,,,,,,,,,,,,,,,,,,,,,,,,,,,,8,,,,,,,,,,,,,,,,,,,,,,,,,,,,,,,,,6,,,,,,,,,,,,,,,,,,,,,,,,,,,,,,,,,1,6.0,6.0,6.0,4.0,5.0,4.0,4.0,4.0,6.0,5.0,5.0,6.0,6.0,5.0,6.0,6.0,6.0,5.0,6.0,5.0,5.0,6.0,4.0,5.0,5.0,5.0,5.0,5.0,5.0,5.0,5.0,5.0,3,,,,,,,,,,,,,,,,,,,,,,,,,,,,,,,,,14,,,,,,,,,,,,,,,,,,,,,,,,,,,,,,,,,9,,,,,,,,,,,,,,,,,,,,,,,,,,,,,,,,,,584.27,37.09,,,,8.19,,6.03,,,,,,,,,,,144.64,,,257.64,,,,,,,,,,,,,,,,,,,,,127.22,,,,,,,,,,,,3.46,,APPROVED,Male,25.0,FALSE
1047,2022-03-22 02:58:33,19,en,110275836,2022-03-22 02:42:28,2022-03-22 02:58:33,Y,Y,A1,,,13,,,,,,,,,,,,,,,,,,,,,,,,,,,,,,,,,0,5.0,7.0,7.0,6.0,5.0,7.0,1.0,7.0,4.0,6.0,6.0,5.0,5.0,6.0,5.0,6.0,6.0,6.0,6.0,5.0,4.0,7.0,6.0,7.0,5.0,7.0,1.0,7.0,6.0,5.0,7.0,2.0,4,,,,,,,,,,,,,,,,,,,,,,,,,,,,,,,,,14,,,,,,,,,,,,,,,,,,,,,,,,,,,,,,,,,7,,,,,,,,,,,,,,,,,,,,,,,,,,,,,,,,,11,,,,,,,,,,,,,,,,,,,,,,,,,,,,,,,,,6,,,,,,,,,,,,,,,,,,,,,,,,,,,,,,,,,5,,,,,,,,,,,,,,,,,,,,,,,,,,,,,,,,,8,,,,,,,,,,,,,,,,,,,,,,,,,,,,,,,,,9,,,,,,,,,,,,,,,,,,,,,,,,,,,,,,,,,1,3.0,6.0,6.0,3.0,5.0,3.0,4.0,7.0,5.0,5.0,3.0,5.0,4.0,5.0,3.0,4.0,5.0,4.0,5.0,5.0,4.0,5.0,2.0,5.0,6.0,3.0,4.0,3.0,5.0,4.0,3.0,4.0,10,,,,,,,,,,,,,,,,,,,,,,,,,,,,,,,,,12,,,,,,,,,,,,,,,,,,,,,,,,,,,,,,,,,2,6.0,7.0,6.0,5.0,5.0,7.0,1.0,7.0,6.0,5.0,5.0,5.0,6.0,7.0,6.0,5.0,7.0,7.0,6.0,5.0,7.0,5.0,6.0,6.0,6.0,7.0,4.0,6.0,6.0,4.0,6.0,7.0,3,,,,,,,,,,,,,,,,,,,,,,,,,,,,,,,,,,470.43,59.77,,,,13.85,,58.38,,,,,141.17,,,,,,,,,,,,,,,,,,,,,,,,,,,103.79,,,,,,,,,89.07,,,,,,4.4,,APPROVED,Female,23.0,FALSE
1048,2022-03-22 03:05:49,19,en,1801376244,2022-03-22 02:42:31,2022-03-22 03:05:49,Y,Y,A2,,,4,,,,,,,,,,,,,,,,,,,,,,,,,,,,,,,,,9,,,,,,,,,,,,,,,,,,,,,,,,,,,,,,,,,5,,,,,,,,,,,,,,,,,,,,,,,,,,,,,,,,,1,6.0,5.0,5.0,5.0,5.0,3.0,5.0,5.0,6.0,4.0,5.0,6.0,5.0,5.0,5.0,5.0,6.0,5.0,4.0,4.0,4.0,5.0,6.0,6.0,4.0,6.0,5.0,6.0,6.0,5.0,6.0,4.0,2,4.0,4.0,3.0,2.0,3.0,4.0,6.0,2.0,5.0,3.0,2.0,4.0,4.0,5.0,3.0,2.0,3.0,4.0,4.0,3.0,3.0,4.0,3.0,3.0,3.0,4.0,3.0,4.0,3.0,3.0,3.0,5.0,11,,,,,,,,,,,,,,,,,,,,,,,,,,,,,,,,,7,,,,,,,,,,,,,,,,,,,,,,,,,,,,,,,,,6,,,,,,,,,,,,,,,,,,,,,,,,,,,,,,,,,8,,,,,,,,,,,,,,,,,,,,,,,,,,,,,,,,,0,6.0,5.0,6.0,6.0,6.0,4.0,4.0,7.0,6.0,5.0,6.0,6.0,6.0,5.0,5.0,5.0,6.0,4.0,4.0,5.0,5.0,6.0,5.0,6.0,5.0,6.0,4.0,6.0,5.0,6.0,6.0,3.0,13,,,,,,,,,,,,,,,,,,,,,,,,,,,,,,,,,10,,,,,,,,,,,,,,,,,,,,,,,,,,,,,,,,,14,,,,,,,,,,,,,,,,,,,,,,,,,,,,,,,,,12,,,,,,,,,,,,,,,,,,,,,,,,,,,,,,,,,3,,,,,,,,,,,,,,,,,,,,,,,,,,,,,,,,,,1399.05,12.98,,,,6.56,,1058.0,,,,,,,,,,,100.09,,,87.49,,,,,,,,,,,,,,,127.87,,,,,,,,,,,,,,,,,,6.06,,APPROVED,Female,33.0,FALSE
1049,2022-03-22 02:57:25,19,en,433280070,2022-03-22 02:42:32,2022-03-22 02:57:25,Y,Y,A1,,,10,,,,,,,,,,,,,,,,,,,,,,,,,,,,,,,,,11,,,,,,,,,,,,,,,,,,,,,,,,,,,,,,,,,9,,,,,,,,,,,,,,,,,,,,,,,,,,,,,,,,,13,,,,,,,,,,,,,,,,,,,,,,,,,,,,,,,,,6,,,,,,,,,,,,,,,,,,,,,,,,,,,,,,,,,2,7.0,7.0,7.0,6.0,7.0,7.0,2.0,7.0,7.0,7.0,6.0,7.0,7.0,7.0,7.0,7.0,7.0,7.0,7.0,7.0,7.0,7.0,7.0,7.0,7.0,7.0,7.0,7.0,5.0,7.0,7.0,6.0,12,,,,,,,,,,,,,,,,,,,,,,,,,,,,,,,,,4,,,,,,,,,,,,,,,,,,,,,,,,,,,,,,,,,7,,,,,,,,,,,,,,,,,,,,,,,,,,,,,,,,,5,,,,,,,,,,,,,,,,,,,,,,,,,,,,,,,,,1,5.0,6.0,5.0,6.0,5.0,5.0,3.0,6.0,5.0,4.0,4.0,5.0,4.0,5.0,5.0,6.0,5.0,5.0,4.0,5.0,4.0,5.0,3.0,4.0,5.0,4.0,4.0,4.0,4.0,5.0,6.0,4.0,8,,,,,,,,,,,,,,,,,,,,,,,,,,,,,,,,,0,4.0,3.0,3.0,3.0,3.0,4.0,4.0,7.0,5.0,3.0,1.0,1.0,3.0,4.0,4.0,6.0,6.0,1.0,4.0,4.0,1.0,4.0,1.0,4.0,5.0,1.0,4.0,4.0,2.0,3.0,2.0,6.0,14,,,,,,,,,,,,,,,,,,,,,,,,,,,,,,,,,3,,,,,,,,,,,,,,,,,,,,,,,,,,,,,,,,,,893.05,38.88,,,,7.04,,22.34,,,,,,,,,,,,,,,,,59.77,,,,,,,,,,,,,,,659.52,,,,,,102.13,,,,,,,,,3.37,,APPROVED,Female,29.0,FALSE
1050,2022-03-22 02:48:49,19,en,1795848177,2022-03-22 02:42:33,2022-03-22 02:48:48,Y,Y,A1,,,8,,,,,,,,,,,,,,,,,,,,,,,,,,,,,,,,,11,,,,,,,,,,,,,,,,,,,,,,,,,,,,,,,,,13,,,,,,,,,,,,,,,,,,,,,,,,,,,,,,,,,12,,,,,,,,,,,,,,,,,,,,,,,,,,,,,,,,,3,,,,,,,,,,,,,,,,,,,,,,,,,,,,,,,,,1,5.0,7.0,6.0,3.0,6.0,5.0,3.0,6.0,7.0,6.0,5.0,4.0,6.0,4.0,6.0,5.0,6.0,5.0,5.0,5.0,4.0,5.0,3.0,5.0,6.0,4.0,4.0,6.0,5.0,6.0,5.0,6.0,5,,,,,,,,,,,,,,,,,,,,,,,,,,,,,,,,,4,,,,,,,,,,,,,,,,,,,,,,,,,,,,,,,,,2,2.0,3.0,2.0,2.0,3.0,3.0,6.0,4.0,2.0,2.0,2.0,2.0,2.0,2.0,3.0,2.0,3.0,2.0,2.0,2.0,2.0,3.0,4.0,1.0,1.0,5.0,4.0,3.0,5.0,2.0,2.0,2.0,6,,,,,,,,,,,,,,,,,,,,,,,,,,,,,,,,,9,,,,,,,,,,,,,,,,,,,,,,,,,,,,,,,,,7,,,,,,,,,,,,,,,,,,,,,,,,,,,,,,,,,10,,,,,,,,,,,,,,,,,,,,,,,,,,,,,,,,,14,,,,,,,,,,,,,,,,,,,,,,,,,,,,,,,,,0,6.0,6.0,5.0,3.0,6.0,3.0,4.0,6.0,7.0,5.0,6.0,4.0,6.0,4.0,6.0,4.0,6.0,3.0,5.0,4.0,3.0,5.0,2.0,5.0,5.0,5.0,4.0,6.0,6.0,5.0,5.0,1.0,,378.74,18.19,,,,9.2,,37.96,,,,,,,,,,,,,,,,,60.79,,,,,,,,,84.88,,,,,,,,,,,,,,,,,,162.75,,,4.97,,APPROVED,Male,37.0,FALSE
1051,2022-03-22 02:48:50,19,en,950696951,2022-03-22 02:42:33,2022-03-22 02:48:50,Y,Y,A1,,,4,,,,,,,,,,,,,,,,,,,,,,,,,,,,,,,,,2,4.0,3.0,4.0,6.0,5.0,7.0,2.0,6.0,4.0,5.0,5.0,3.0,6.0,3.0,6.0,6.0,4.0,4.0,6.0,4.0,3.0,5.0,7.0,5.0,5.0,6.0,4.0,5.0,5.0,4.0,6.0,2.0,12,,,,,,,,,,,,,,,,,,,,,,,,,,,,,,,,,14,,,,,,,,,,,,,,,,,,,,,,,,,,,,,,,,,3,,,,,,,,,,,,,,,,,,,,,,,,,,,,,,,,,11,,,,,,,,,,,,,,,,,,,,,,,,,,,,,,,,,13,,,,,,,,,,,,,,,,,,,,,,,,,,,,,,,,,7,,,,,,,,,,,,,,,,,,,,,,,,,,,,,,,,,0,1.0,1.0,1.0,1.0,1.0,2.0,6.0,1.0,1.0,1.0,1.0,1.0,1.0,1.0,1.0,2.0,1.0,1.0,1.0,1.0,1.0,1.0,1.0,1.0,1.0,1.0,1.0,1.0,1.0,1.0,1.0,2.0,5,,,,,,,,,,,,,,,,,,,,,,,,,,,,,,,,,6,,,,,,,,,,,,,,,,,,,,,,,,,,,,,,,,,10,,,,,,,,,,,,,,,,,,,,,,,,,,,,,,,,,9,,,,,,,,,,,,,,,,,,,,,,,,,,,,,,,,,1,6.0,5.0,6.0,6.0,5.0,6.0,2.0,5.0,4.0,6.0,4.0,6.0,6.0,6.0,5.0,5.0,7.0,6.0,6.0,4.0,4.0,5.0,6.0,6.0,6.0,7.0,4.0,5.0,5.0,4.0,7.0,7.0,8,,,,,,,,,,,,,,,,,,,,,,,,,,,,,,,,,,377.16,29.76,,,,18.59,,33.56,,,,,57.16,,,,,,,,,,,,,,,,,,,,,181.29,,,,,,,,,,,,,,,53.98,,,,,,2.82,,APPROVED,Male,23.0,FALSE
1052,2022-03-22 02:49:22,19,en,1856044797,2022-03-22 02:42:34,2022-03-22 02:49:22,Y,Y,A2,,,4,,,,,,,,,,,,,,,,,,,,,,,,,,,,,,,,,13,,,,,,,,,,,,,,,,,,,,,,,,,,,,,,,,,6,,,,,,,,,,,,,,,,,,,,,,,,,,,,,,,,,2,7.0,7.0,5.0,5.0,5.0,6.0,3.0,6.0,7.0,6.0,5.0,6.0,6.0,6.0,6.0,6.0,6.0,6.0,7.0,6.0,6.0,6.0,5.0,7.0,7.0,5.0,5.0,7.0,6.0,5.0,6.0,4.0,14,,,,,,,,,,,,,,,,,,,,,,,,,,,,,,,,,0,6.0,6.0,6.0,2.0,5.0,3.0,7.0,4.0,6.0,6.0,5.0,5.0,6.0,5.0,5.0,5.0,5.0,5.0,5.0,7.0,6.0,5.0,3.0,5.0,5.0,3.0,3.0,3.0,5.0,6.0,4.0,6.0,11,,,,,,,,,,,,,,,,,,,,,,,,,,,,,,,,,10,,,,,,,,,,,,,,,,,,,,,,,,,,,,,,,,,1,3.0,5.0,4.0,5.0,2.0,5.0,7.0,1.0,5.0,3.0,4.0,4.0,4.0,3.0,5.0,2.0,5.0,3.0,3.0,3.0,5.0,3.0,5.0,3.0,2.0,5.0,5.0,3.0,5.0,5.0,4.0,2.0,9,,,,,,,,,,,,,,,,,,,,,,,,,,,,,,,,,3,,,,,,,,,,,,,,,,,,,,,,,,,,,,,,,,,12,,,,,,,,,,,,,,,,,,,,,,,,,,,,,,,,,7,,,,,,,,,,,,,,,,,,,,,,,,,,,,,,,,,5,,,,,,,,,,,,,,,,,,,,,,,,,,,,,,,,,8,,,,,,,,,,,,,,,,,,,,,,,,,,,,,,,,,"This was really interesting, thank you. I hope that the study goes well.",369.84,45.64,,,,44.09,,68.24,,,,,,,,,,,52.24,,,,,,59.81,,,,,,,,,77.08,,,,,,,,,,,,,,,,,,,,,22.74,,APPROVED,Female,29.0,FALSE
1054,2022-03-22 02:53:57,19,en,923248516,2022-03-22 02:42:35,2022-03-22 02:53:57,Y,Y,A1,,,6,,,,,,,,,,,,,,,,,,,,,,,,,,,,,,,,,11,,,,,,,,,,,,,,,,,,,,,,,,,,,,,,,,,12,,,,,,,,,,,,,,,,,,,,,,,,,,,,,,,,,1,5.0,3.0,5.0,4.0,4.0,3.0,4.0,3.0,6.0,5.0,6.0,3.0,5.0,5.0,5.0,5.0,6.0,5.0,5.0,2.0,2.0,5.0,5.0,3.0,3.0,6.0,2.0,4.0,5.0,3.0,5.0,4.0,4,,,,,,,,,,,,,,,,,,,,,,,,,,,,,,,,,10,,,,,,,,,,,,,,,,,,,,,,,,,,,,,,,,,13,,,,,,,,,,,,,,,,,,,,,,,,,,,,,,,,,14,,,,,,,,,,,,,,,,,,,,,,,,,,,,,,,,,7,,,,,,,,,,,,,,,,,,,,,,,,,,,,,,,,,2,3.0,4.0,1.0,1.0,1.0,1.0,2.0,2.0,5.0,2.0,1.0,4.0,1.0,1.0,1.0,2.0,2.0,1.0,1.0,1.0,1.0,3.0,2.0,1.0,1.0,2.0,2.0,2.0,2.0,1.0,3.0,3.0,8,,,,,,,,,,,,,,,,,,,,,,,,,,,,,,,,,0,3.0,2.0,2.0,3.0,1.0,3.0,3.0,1.0,3.0,2.0,2.0,2.0,2.0,1.0,1.0,1.0,5.0,1.0,2.0,2.0,1.0,2.0,5.0,2.0,2.0,3.0,3.0,1.0,1.0,1.0,2.0,5.0,5,,,,,,,,,,,,,,,,,,,,,,,,,,,,,,,,,9,,,,,,,,,,,,,,,,,,,,,,,,,,,,,,,,,3,,,,,,,,,,,,,,,,,,,,,,,,,,,,,,,,,,519.54,49.33,,,,9.63,,8.82,,,,,,,,,,,199.52,,,,,,,,,,,,,,,,,,104.3,,,,,,118.42,,,,,,,,,,,,29.52,,APPROVED,Male,23.0,FALSE
1055,2022-03-22 02:49:53,19,en,534092276,2022-03-22 02:42:36,2022-03-22 02:49:53,Y,Y,A1,,,1,2.0,6.0,2.0,5.0,2.0,3.0,6.0,6.0,5.0,2.0,3.0,6.0,3.0,4.0,6.0,2.0,6.0,2.0,3.0,2.0,4.0,2.0,2.0,2.0,2.0,4.0,5.0,3.0,3.0,4.0,4.0,1.0,12,,,,,,,,,,,,,,,,,,,,,,,,,,,,,,,,,3,,,,,,,,,,,,,,,,,,,,,,,,,,,,,,,,,11,,,,,,,,,,,,,,,,,,,,,,,,,,,,,,,,,0,4.0,6.0,4.0,3.0,5.0,2.0,6.0,5.0,6.0,3.0,5.0,7.0,6.0,6.0,7.0,3.0,7.0,3.0,5.0,3.0,3.0,4.0,2.0,6.0,4.0,5.0,7.0,6.0,6.0,5.0,6.0,5.0,5,,,,,,,,,,,,,,,,,,,,,,,,,,,,,,,,,10,,,,,,,,,,,,,,,,,,,,,,,,,,,,,,,,,2,6.0,4.0,5.0,6.0,4.0,6.0,5.0,7.0,5.0,5.0,5.0,6.0,7.0,4.0,6.0,7.0,6.0,6.0,6.0,5.0,6.0,6.0,6.0,7.0,4.0,6.0,6.0,7.0,6.0,6.0,6.0,1.0,6,,,,,,,,,,,,,,,,,,,,,,,,,,,,,,,,,14,,,,,,,,,,,,,,,,,,,,,,,,,,,,,,,,,7,,,,,,,,,,,,,,,,,,,,,,,,,,,,,,,,,4,,,,,,,,,,,,,,,,,,,,,,,,,,,,,,,,,13,,,,,,,,,,,,,,,,,,,,,,,,,,,,,,,,,9,,,,,,,,,,,,,,,,,,,,,,,,,,,,,,,,,8,,,,,,,,,,,,,,,,,,,,,,,,,,,,,,,,,"At one point during the survey, I did have a technical issue where the page couldn't be found. I had to go back in the survey and had to repeat one of the questions as it lost my progress.  Other than that, everything else ran smoothly and I found it enjoyable! It was interesting to see these types of unconventional diagrams and visualisations.",469.25,27.77,,,,6.7,,152.81,,64.81,,,,,,,,,,,,68.9,,,,,,,,,73.8,,,,,,,,,,,,,,,,,,,,,,,,74.46,,APPROVED,Female,25.0,FALSE
1056,2022-03-22 02:52:58,19,en,1270727653,2022-03-22 02:42:37,2022-03-22 02:52:58,Y,Y,A1,,,14,,,,,,,,,,,,,,,,,,,,,,,,,,,,,,,,,6,,,,,,,,,,,,,,,,,,,,,,,,,,,,,,,,,8,,,,,,,,,,,,,,,,,,,,,,,,,,,,,,,,,9,,,,,,,,,,,,,,,,,,,,,,,,,,,,,,,,,3,,,,,,,,,,,,,,,,,,,,,,,,,,,,,,,,,7,,,,,,,,,,,,,,,,,,,,,,,,,,,,,,,,,4,,,,,,,,,,,,,,,,,,,,,,,,,,,,,,,,,12,,,,,,,,,,,,,,,,,,,,,,,,,,,,,,,,,2,3.0,3.0,2.0,5.0,3.0,2.0,5.0,4.0,4.0,2.0,1.0,3.0,3.0,3.0,4.0,4.0,3.0,2.0,3.0,2.0,2.0,3.0,3.0,2.0,3.0,1.0,5.0,3.0,1.0,3.0,3.0,2.0,13,,,,,,,,,,,,,,,,,,,,,,,,,,,,,,,,,1,5.0,6.0,5.0,6.0,3.0,5.0,5.0,7.0,6.0,5.0,3.0,6.0,5.0,5.0,5.0,6.0,5.0,5.0,5.0,4.0,3.0,5.0,3.0,4.0,4.0,3.0,6.0,4.0,3.0,4.0,5.0,4.0,10,,,,,,,,,,,,,,,,,,,,,,,,,,,,,,,,,0,6.0,6.0,6.0,5.0,6.0,4.0,5.0,6.0,6.0,5.0,4.0,5.0,5.0,5.0,6.0,5.0,6.0,3.0,6.0,4.0,3.0,5.0,3.0,6.0,5.0,5.0,5.0,3.0,5.0,5.0,4.0,6.0,11,,,,,,,,,,,,,,,,,,,,,,,,,,,,,,,,,5,,,,,,,,,,,,,,,,,,,,,,,,,,,,,,,,,,622.7,354.95,,,,11.19,,9.04,,,,,,,,,,,,,,,,,,,,,,,,,,81.21,,,,,,84.42,,,,,,76.71,,,,,,,,,5.18,,APPROVED,Female,29.0,FALSE
1057,2022-03-22 02:52:57,19,en,588974189,2022-03-22 02:42:39,2022-03-22 02:52:57,Y,Y,A1,,,0,4.0,6.0,4.0,4.0,4.0,4.0,6.0,5.0,6.0,2.0,3.0,2.0,1.0,2.0,4.0,2.0,6.0,2.0,2.0,1.0,4.0,3.0,4.0,2.0,2.0,6.0,2.0,1.0,4.0,3.0,6.0,1.0,13,,,,,,,,,,,,,,,,,,,,,,,,,,,,,,,,,11,,,,,,,,,,,,,,,,,,,,,,,,,,,,,,,,,1,3.0,6.0,2.0,6.0,2.0,6.0,5.0,5.0,6.0,2.0,4.0,1.0,1.0,3.0,4.0,5.0,6.0,2.0,2.0,1.0,4.0,2.0,5.0,4.0,1.0,6.0,3.0,4.0,5.0,3.0,6.0,4.0,4,,,,,,,,,,,,,,,,,,,,,,,,,,,,,,,,,12,,,,,,,,,,,,,,,,,,,,,,,,,,,,,,,,,10,,,,,,,,,,,,,,,,,,,,,,,,,,,,,,,,,9,,,,,,,,,,,,,,,,,,,,,,,,,,,,,,,,,3,,,,,,,,,,,,,,,,,,,,,,,,,,,,,,,,,7,,,,,,,,,,,,,,,,,,,,,,,,,,,,,,,,,14,,,,,,,,,,,,,,,,,,,,,,,,,,,,,,,,,2,5.0,6.0,6.0,6.0,6.0,5.0,3.0,6.0,6.0,5.0,4.0,5.0,5.0,5.0,6.0,6.0,6.0,4.0,6.0,4.0,4.0,6.0,5.0,6.0,5.0,6.0,1.0,5.0,5.0,5.0,6.0,5.0,5,,,,,,,,,,,,,,,,,,,,,,,,,,,,,,,,,6,,,,,,,,,,,,,,,,,,,,,,,,,,,,,,,,,8,,,,,,,,,,,,,,,,,,,,,,,,,,,,,,,,,,377.31,6.2,,,,6.42,,44.88,,124.83,,,,,,,,,89.23,,,,,,,,,,,,,,,,,,,,,,,,102.11,,,,,,,,,,,,3.64,,APPROVED,Male,40.0,FALSE
1059,2022-03-22 02:49:27,19,en,2738054,2022-03-22 02:42:43,2022-03-22 02:49:27,Y,Y,A1,,,9,,,,,,,,,,,,,,,,,,,,,,,,,,,,,,,,,10,,,,,,,,,,,,,,,,,,,,,,,,,,,,,,,,,7,,,,,,,,,,,,,,,,,,,,,,,,,,,,,,,,,4,,,,,,,,,,,,,,,,,,,,,,,,,,,,,,,,,0,2.0,6.0,4.0,2.0,5.0,3.0,7.0,6.0,5.0,3.0,1.0,5.0,2.0,4.0,4.0,2.0,5.0,2.0,3.0,2.0,3.0,4.0,3.0,3.0,5.0,4.0,1.0,2.0,6.0,2.0,2.0,5.0,8,,,,,,,,,,,,,,,,,,,,,,,,,,,,,,,,,5,,,,,,,,,,,,,,,,,,,,,,,,,,,,,,,,,13,,,,,,,,,,,,,,,,,,,,,,,,,,,,,,,,,12,,,,,,,,,,,,,,,,,,,,,,,,,,,,,,,,,3,,,,,,,,,,,,,,,,,,,,,,,,,,,,,,,,,2,2.0,6.0,2.0,1.0,2.0,1.0,7.0,5.0,6.0,2.0,1.0,4.0,3.0,3.0,6.0,1.0,6.0,2.0,4.0,3.0,3.0,2.0,2.0,2.0,2.0,2.0,5.0,2.0,5.0,4.0,1.0,4.0,1,5.0,7.0,5.0,4.0,6.0,7.0,1.0,6.0,4.0,5.0,5.0,2.0,5.0,1.0,6.0,6.0,6.0,4.0,5.0,5.0,2.0,6.0,5.0,6.0,5.0,4.0,1.0,4.0,2.0,5.0,4.0,5.0,14,,,,,,,,,,,,,,,,,,,,,,,,,,,,,,,,,6,,,,,,,,,,,,,,,,,,,,,,,,,,,,,,,,,11,,,,,,,,,,,,,,,,,,,,,,,,,,,,,,,,,,404.4,28.82,,,,12.08,,59.98,,,,,,,,,,,,,,129.53,,,,,,,,,,,,,,,,,,80.7,,,86.23,,,,,,,,,,,,7.06,,APPROVED,Male,43.0,FALSE
1060,2022-03-22 02:48:06,19,en,659261015,2022-03-22 02:42:45,2022-03-22 02:48:06,Y,Y,A1,,,0,1.0,3.0,2.0,2.0,2.0,1.0,2.0,3.0,2.0,2.0,2.0,2.0,1.0,3.0,3.0,1.0,1.0,1.0,2.0,2.0,2.0,2.0,1.0,2.0,2.0,2.0,2.0,2.0,6.0,2.0,2.0,1.0,3,,,,,,,,,,,,,,,,,,,,,,,,,,,,,,,,,12,,,,,,,,,,,,,,,,,,,,,,,,,,,,,,,,,5,,,,,,,,,,,,,,,,,,,,,,,,,,,,,,,,,13,,,,,,,,,,,,,,,,,,,,,,,,,,,,,,,,,4,,,,,,,,,,,,,,,,,,,,,,,,,,,,,,,,,2,1.0,5.0,1.0,2.0,2.0,3.0,1.0,6.0,5.0,1.0,3.0,1.0,2.0,2.0,2.0,2.0,2.0,1.0,1.0,2.0,2.0,1.0,4.0,1.0,1.0,2.0,2.0,1.0,2.0,2.0,2.0,7.0,1,4.0,3.0,5.0,5.0,3.0,3.0,6.0,4.0,4.0,3.0,4.0,4.0,4.0,4.0,3.0,4.0,4.0,4.0,5.0,5.0,4.0,4.0,6.0,5.0,4.0,3.0,5.0,4.0,4.0,4.0,4.0,1.0,8,,,,,,,,,,,,,,,,,,,,,,,,,,,,,,,,,7,,,,,,,,,,,,,,,,,,,,,,,,,,,,,,,,,14,,,,,,,,,,,,,,,,,,,,,,,,,,,,,,,,,6,,,,,,,,,,,,,,,,,,,,,,,,,,,,,,,,,10,,,,,,,,,,,,,,,,,,,,,,,,,,,,,,,,,11,,,,,,,,,,,,,,,,,,,,,,,,,,,,,,,,,9,,,,,,,,,,,,,,,,,,,,,,,,,,,,,,,,,There were some server's errors,275.05,21.99,,,,5.87,,27.54,,113.74,,,,,,,,,,,,,,,,,,40.68,,,39.68,,,,,,,,,,,,,,,,,,,,,,,,25.55,,APPROVED,Male,21.0,FALSE
1062,2022-03-22 02:48:30,19,en,129873593,2022-03-22 02:42:46,2022-03-22 02:48:30,Y,Y,A2,,,3,,,,,,,,,,,,,,,,,,,,,,,,,,,,,,,,,0,7.0,2.0,7.0,7.0,5.0,7.0,4.0,7.0,2.0,7.0,6.0,6.0,6.0,4.0,4.0,7.0,6.0,6.0,7.0,6.0,5.0,7.0,7.0,6.0,7.0,7.0,2.0,7.0,2.0,7.0,4.0,2.0,10,,,,,,,,,,,,,,,,,,,,,,,,,,,,,,,,,13,,,,,,,,,,,,,,,,,,,,,,,,,,,,,,,,,5,,,,,,,,,,,,,,,,,,,,,,,,,,,,,,,,,4,,,,,,,,,,,,,,,,,,,,,,,,,,,,,,,,,1,2.0,2.0,2.0,6.0,4.0,5.0,6.0,2.0,2.0,2.0,2.0,2.0,2.0,2.0,2.0,2.0,2.0,2.0,2.0,2.0,2.0,4.0,6.0,2.0,2.0,4.0,2.0,2.0,2.0,2.0,4.0,7.0,12,,,,,,,,,,,,,,,,,,,,,,,,,,,,,,,,,2,1.0,2.0,2.0,6.0,2.0,1.0,2.0,6.0,2.0,2.0,1.0,2.0,2.0,1.0,5.0,2.0,6.0,2.0,2.0,1.0,4.0,2.0,6.0,1.0,2.0,2.0,2.0,2.0,2.0,2.0,1.0,2.0,11,,,,,,,,,,,,,,,,,,,,,,,,,,,,,,,,,8,,,,,,,,,,,,,,,,,,,,,,,,,,,,,,,,,9,,,,,,,,,,,,,,,,,,,,,,,,,,,,,,,,,7,,,,,,,,,,,,,,,,,,,,,,,,,,,,,,,,,6,,,,,,,,,,,,,,,,,,,,,,,,,,,,,,,,,14,,,,,,,,,,,,,,,,,,,,,,,,,,,,,,,,,,342.39,16.76,,,,9.81,,39.95,,,,,92.3,,,,,,,,,,,,,,,81.96,,,,,,96.83,,,,,,,,,,,,,,,,,,,,,4.78,,APPROVED,Female,29.0,FALSE
1063,2022-03-22 02:47:25,19,en,1153767557,2022-03-22 02:42:49,2022-03-22 02:47:25,Y,Y,A1,,,6,,,,,,,,,,,,,,,,,,,,,,,,,,,,,,,,,9,,,,,,,,,,,,,,,,,,,,,,,,,,,,,,,,,10,,,,,,,,,,,,,,,,,,,,,,,,,,,,,,,,,13,,,,,,,,,,,,,,,,,,,,,,,,,,,,,,,,,2,2.0,2.0,1.0,2.0,1.0,1.0,7.0,1.0,1.0,2.0,1.0,1.0,1.0,2.0,2.0,1.0,2.0,2.0,1.0,1.0,2.0,1.0,1.0,1.0,1.0,2.0,2.0,2.0,1.0,3.0,1.0,5.0,12,,,,,,,,,,,,,,,,,,,,,,,,,,,,,,,,,8,,,,,,,,,,,,,,,,,,,,,,,,,,,,,,,,,5,,,,,,,,,,,,,,,,,,,,,,,,,,,,,,,,,14,,,,,,,,,,,,,,,,,,,,,,,,,,,,,,,,,3,,,,,,,,,,,,,,,,,,,,,,,,,,,,,,,,,0,3.0,5.0,3.0,3.0,5.0,2.0,5.0,6.0,5.0,3.0,3.0,2.0,3.0,4.0,2.0,5.0,3.0,3.0,3.0,3.0,3.0,3.0,3.0,3.0,3.0,3.0,3.0,3.0,5.0,5.0,3.0,4.0,7,,,,,,,,,,,,,,,,,,,,,,,,,,,,,,,,,4,,,,,,,,,,,,,,,,,,,,,,,,,,,,,,,,,1,3.0,3.0,3.0,4.0,2.0,3.0,5.0,3.0,4.0,3.0,3.0,3.0,3.0,4.0,5.0,3.0,5.0,3.0,3.0,2.0,4.0,3.0,3.0,3.0,3.0,4.0,3.0,3.0,5.0,5.0,3.0,7.0,11,,,,,,,,,,,,,,,,,,,,,,,,,,,,,,,,,,276.69,11.2,,,,6.56,,33.96,,,,,,,,,,,,,,49.81,,,,,,,,,,,,,,,,,,102.09,,,,,,,,,69.47,,,,,,3.6,,APPROVED,Male,30.0,FALSE
1064,2022-03-22 02:54:57,19,en,96648830,2022-03-22 02:42:49,2022-03-22 02:54:57,Y,Y,A1,,,11,,,,,,,,,,,,,,,,,,,,,,,,,,,,,,,,,2,4.0,4.0,5.0,4.0,4.0,5.0,5.0,3.0,3.0,4.0,4.0,4.0,5.0,4.0,5.0,4.0,3.0,4.0,4.0,4.0,3.0,3.0,3.0,4.0,3.0,5.0,5.0,4.0,4.0,3.0,3.0,2.0,6,,,,,,,,,,,,,,,,,,,,,,,,,,,,,,,,,10,,,,,,,,,,,,,,,,,,,,,,,,,,,,,,,,,7,,,,,,,,,,,,,,,,,,,,,,,,,,,,,,,,,12,,,,,,,,,,,,,,,,,,,,,,,,,,,,,,,,,5,,,,,,,,,,,,,,,,,,,,,,,,,,,,,,,,,0,3.0,3.0,5.0,4.0,3.0,4.0,3.0,2.0,3.0,4.0,4.0,4.0,4.0,5.0,4.0,4.0,3.0,3.0,5.0,3.0,3.0,4.0,3.0,3.0,5.0,3.0,4.0,3.0,4.0,3.0,4.0,1.0,1,4.0,3.0,4.0,4.0,4.0,3.0,4.0,5.0,3.0,3.0,3.0,4.0,4.0,3.0,4.0,3.0,3.0,2.0,4.0,5.0,4.0,5.0,4.0,3.0,4.0,3.0,4.0,5.0,4.0,4.0,3.0,2.0,8,,,,,,,,,,,,,,,,,,,,,,,,,,,,,,,,,3,,,,,,,,,,,,,,,,,,,,,,,,,,,,,,,,,14,,,,,,,,,,,,,,,,,,,,,,,,,,,,,,,,,9,,,,,,,,,,,,,,,,,,,,,,,,,,,,,,,,,13,,,,,,,,,,,,,,,,,,,,,,,,,,,,,,,,,4,,,,,,,,,,,,,,,,,,,,,,,,,,,,,,,,,,172.12,21.87,,,,8.13,,16.3,,,,,28.7,,,,,,,,,,,,,,,,,,55.63,,,37.98,,,,,,,,,,,,,,,,,,,,,3.51,,APPROVED,Male,22.0,FALSE
1065,2022-03-22 02:48:52,19,en,1223110909,2022-03-22 02:42:49,2022-03-22 02:48:52,Y,Y,A1,,,14,,,,,,,,,,,,,,,,,,,,,,,,,,,,,,,,,3,,,,,,,,,,,,,,,,,,,,,,,,,,,,,,,,,12,,,,,,,,,,,,,,,,,,,,,,,,,,,,,,,,,13,,,,,,,,,,,,,,,,,,,,,,,,,,,,,,,,,6,,,,,,,,,,,,,,,,,,,,,,,,,,,,,,,,,11,,,,,,,,,,,,,,,,,,,,,,,,,,,,,,,,,4,,,,,,,,,,,,,,,,,,,,,,,,,,,,,,,,,10,,,,,,,,,,,,,,,,,,,,,,,,,,,,,,,,,7,,,,,,,,,,,,,,,,,,,,,,,,,,,,,,,,,8,,,,,,,,,,,,,,,,,,,,,,,,,,,,,,,,,0,2.0,5.0,2.0,4.0,3.0,4.0,5.0,6.0,5.0,2.0,3.0,2.0,3.0,2.0,2.0,4.0,3.0,2.0,2.0,1.0,1.0,1.0,2.0,3.0,3.0,2.0,2.0,4.0,2.0,4.0,2.0,4.0,2,2.0,5.0,1.0,2.0,5.0,1.0,5.0,4.0,4.0,2.0,4.0,1.0,1.0,2.0,4.0,2.0,1.0,2.0,4.0,2.0,1.0,2.0,1.0,4.0,4.0,1.0,4.0,1.0,4.0,4.0,1.0,5.0,1,3.0,4.0,2.0,5.0,2.0,3.0,6.0,4.0,4.0,3.0,2.0,4.0,3.0,3.0,2.0,4.0,4.0,4.0,3.0,2.0,3.0,2.0,5.0,3.0,2.0,4.0,4.0,4.0,5.0,3.0,4.0,6.0,5,,,,,,,,,,,,,,,,,,,,,,,,,,,,,,,,,9,,,,,,,,,,,,,,,,,,,,,,,,,,,,,,,,,,317.93,42.27,,,,10.37,,52.89,,,,,,,,,,,,,,,,,,,,,,,,,,,,,,,,80.35,,,70.95,,,57.24,,,,,,,,,3.86,,APPROVED,Male,34.0,FALSE
1066,2022-03-22 02:54:53,19,en,1551640874,2022-03-22 02:42:54,2022-03-22 02:54:53,Y,Y,A1,,,2,4.0,7.0,3.0,2.0,1.0,1.0,7.0,3.0,6.0,2.0,3.0,3.0,3.0,5.0,6.0,2.0,4.0,2.0,3.0,4.0,3.0,2.0,1.0,1.0,2.0,1.0,6.0,3.0,5.0,3.0,1.0,1.0,8,,,,,,,,,,,,,,,,,,,,,,,,,,,,,,,,,2,5.0,7.0,5.0,2.0,7.0,4.0,6.0,7.0,6.0,4.0,3.0,5.0,6.0,6.0,5.0,4.0,6.0,3.0,4.0,4.0,3.0,5.0,2.0,3.0,5.0,2.0,5.0,4.0,7.0,5.0,3.0,3.0,5,,,,,,,,,,,,,,,,,,,,,,,,,,,,,,,,,14,,,,,,,,,,,,,,,,,,,,,,,,,,,,,,,,,10,,,,,,,,,,,,,,,,,,,,,,,,,,,,,,,,,2,5.0,6.0,6.0,7.0,5.0,4.0,2.0,6.0,7.0,4.0,7.0,5.0,6.0,5.0,5.0,6.0,5.0,5.0,5.0,6.0,5.0,5.0,6.0,6.0,5.0,2.0,1.0,6.0,4.0,4.0,5.0,7.0,13,,,,,,,,,,,,,,,,,,,,,,,,,,,,,,,,,9,,,,,,,,,,,,,,,,,,,,,,,,,,,,,,,,,4,,,,,,,,,,,,,,,,,,,,,,,,,,,,,,,,,3,,,,,,,,,,,,,,,,,,,,,,,,,,,,,,,,,6,,,,,,,,,,,,,,,,,,,,,,,,,,,,,,,,,12,,,,,,,,,,,,,,,,,,,,,,,,,,,,,,,,,7,,,,,,,,,,,,,,,,,,,,,,,,,,,,,,,,,11,,,,,,,,,,,,,,,,,,,,,,,,,,,,,,,,,,397.96,31.1,,,,2.6,,22.0,,161.48,,,,,,98.98,,,,,,,,,,,,71.99,,,,,,,,,,,,,,,,,,,,,,,,,,,9.81,,APPROVED,Male,29.0,FALSE
1067,2022-03-22 02:50:41,19,en,723080097,2022-03-22 02:42:54,2022-03-22 02:50:41,Y,Y,A1,,,2,5.0,6.0,5.0,4.0,5.0,2.0,7.0,5.0,5.0,2.0,5.0,2.0,2.0,2.0,2.0,5.0,2.0,3.0,3.0,1.0,3.0,2.0,3.0,3.0,2.0,2.0,5.0,4.0,4.0,3.0,4.0,1.0,6,,,,,,,,,,,,,,,,,,,,,,,,,,,,,,,,,14,,,,,,,,,,,,,,,,,,,,,,,,,,,,,,,,,8,,,,,,,,,,,,,,,,,,,,,,,,,,,,,,,,,1,3.0,3.0,1.0,3.0,2.0,1.0,6.0,6.0,3.0,1.0,2.0,5.0,2.0,2.0,1.0,2.0,2.0,2.0,4.0,2.0,2.0,3.0,3.0,2.0,2.0,1.0,3.0,2.0,2.0,3.0,2.0,5.0,10,,,,,,,,,,,,,,,,,,,,,,,,,,,,,,,,,0,3.0,2.0,3.0,4.0,2.0,4.0,7.0,6.0,5.0,2.0,4.0,3.0,3.0,1.0,2.0,3.0,3.0,3.0,2.0,2.0,2.0,2.0,2.0,3.0,2.0,3.0,5.0,2.0,3.0,3.0,2.0,7.0,5,,,,,,,,,,,,,,,,,,,,,,,,,,,,,,,,,7,,,,,,,,,,,,,,,,,,,,,,,,,,,,,,,,,3,,,,,,,,,,,,,,,,,,,,,,,,,,,,,,,,,4,,,,,,,,,,,,,,,,,,,,,,,,,,,,,,,,,12,,,,,,,,,,,,,,,,,,,,,,,,,,,,,,,,,13,,,,,,,,,,,,,,,,,,,,,,,,,,,,,,,,,11,,,,,,,,,,,,,,,,,,,,,,,,,,,,,,,,,9,,,,,,,,,,,,,,,,,,,,,,,,,,,,,,,,,,455.69,52.86,,,,107.94,,39.27,,81.03,,,,,,,,,,,,80.39,,,,,,91.29,,,,,,,,,,,,,,,,,,,,,,,,,,,2.91,,APPROVED,Male,32.0,FALSE
1069,2022-03-22 02:50:05,19,en,266418822,2022-03-22 02:43:02,2022-03-22 02:50:05,Y,Y,A2,,,6,,,,,,,,,,,,,,,,,,,,,,,,,,,,,,,,,11,,,,,,,,,,,,,,,,,,,,,,,,,,,,,,,,,14,,,,,,,,,,,,,,,,,,,,,,,,,,,,,,,,,4,,,,,,,,,,,,,,,,,,,,,,,,,,,,,,,,,5,,,,,,,,,,,,,,,,,,,,,,,,,,,,,,,,,12,,,,,,,,,,,,,,,,,,,,,,,,,,,,,,,,,2,5.0,6.0,5.0,6.0,4.0,7.0,2.0,4.0,6.0,3.0,4.0,6.0,5.0,5.0,6.0,5.0,7.0,5.0,5.0,4.0,3.0,6.0,6.0,5.0,4.0,5.0,6.0,5.0,3.0,4.0,5.0,7.0,10,,,,,,,,,,,,,,,,,,,,,,,,,,,,,,,,,13,,,,,,,,,,,,,,,,,,,,,,,,,,,,,,,,,1,2.0,3.0,2.0,2.0,1.0,1.0,6.0,1.0,2.0,2.0,2.0,3.0,2.0,3.0,3.0,2.0,4.0,1.0,1.0,1.0,1.0,2.0,1.0,2.0,2.0,2.0,3.0,2.0,1.0,4.0,4.0,3.0,8,,,,,,,,,,,,,,,,,,,,,,,,,,,,,,,,,7,,,,,,,,,,,,,,,,,,,,,,,,,,,,,,,,,9,,,,,,,,,,,,,,,,,,,,,,,,,,,,,,,,,3,,,,,,,,,,,,,,,,,,,,,,,,,,,,,,,,,0,5.0,5.0,6.0,3.0,4.0,5.0,4.0,4.0,5.0,4.0,6.0,5.0,5.0,5.0,3.0,4.0,6.0,4.0,5.0,4.0,2.0,6.0,2.0,5.0,5.0,4.0,3.0,5.0,6.0,4.0,4.0,1.0,,360.06,14.87,,,,9.99,,51.02,,,,,,,,,,,,,,,,,,,,92.86,,,,,,,,,83.97,,,,,,,,,,,,,,,102.66,,,4.69,,APPROVED,Male,51.0,FALSE
1070,2022-03-22 02:53:32,19,en,2054656276,2022-03-22 02:43:02,2022-03-22 02:53:32,Y,Y,A1,,,0,5.0,7.0,6.0,6.0,6.0,4.0,3.0,5.0,7.0,5.0,6.0,6.0,6.0,6.0,7.0,4.0,6.0,4.0,6.0,6.0,6.0,6.0,5.0,6.0,6.0,6.0,5.0,5.0,6.0,6.0,6.0,1.0,8,,,,,,,,,,,,,,,,,,,,,,,,,,,,,,,,,13,,,,,,,,,,,,,,,,,,,,,,,,,,,,,,,,,6,,,,,,,,,,,,,,,,,,,,,,,,,,,,,,,,,14,,,,,,,,,,,,,,,,,,,,,,,,,,,,,,,,,5,,,,,,,,,,,,,,,,,,,,,,,,,,,,,,,,,12,,,,,,,,,,,,,,,,,,,,,,,,,,,,,,,,,10,,,,,,,,,,,,,,,,,,,,,,,,,,,,,,,,,9,,,,,,,,,,,,,,,,,,,,,,,,,,,,,,,,,11,,,,,,,,,,,,,,,,,,,,,,,,,,,,,,,,,2,2.0,7.0,5.0,2.0,4.0,3.0,7.0,7.0,6.0,2.0,5.0,5.0,4.0,3.0,6.0,5.0,5.0,3.0,2.0,3.0,2.0,3.0,2.0,2.0,3.0,5.0,5.0,2.0,5.0,5.0,6.0,4.0,4,,,,,,,,,,,,,,,,,,,,,,,,,,,,,,,,,1,2.0,4.0,2.0,2.0,3.0,5.0,5.0,5.0,2.0,1.0,3.0,1.0,2.0,1.0,4.0,3.0,4.0,1.0,1.0,2.0,1.0,2.0,2.0,2.0,3.0,3.0,5.0,1.0,3.0,4.0,1.0,6.0,3,,,,,,,,,,,,,,,,,,,,,,,,,,,,,,,,,7,,,,,,,,,,,,,,,,,,,,,,,,,,,,,,,,,"So interesting, thank you",404.88,15.21,,,,7.17,,35.3,,107.27,,,,,,,,,,,,,,,,,,,,,,,,,,,,,,110.03,,,,,,113.49,,,,,,,,,16.41,,APPROVED,Female,69.0,FALSE
1071,2022-03-22 02:52:55,19,en,1176663371,2022-03-22 02:43:05,2022-03-22 02:52:54,Y,Y,-oth-,Secondary education,,1,6.0,5.0,6.0,5.0,5.0,4.0,5.0,3.0,6.0,4.0,5.0,5.0,6.0,4.0,5.0,4.0,5.0,4.0,5.0,5.0,5.0,5.0,3.0,4.0,4.0,4.0,5.0,5.0,6.0,5.0,4.0,1.0,0,4.0,2.0,3.0,5.0,4.0,3.0,3.0,4.0,2.0,2.0,4.0,5.0,5.0,4.0,4.0,3.0,4.0,5.0,5.0,3.0,4.0,4.0,4.0,4.0,3.0,3.0,4.0,3.0,3.0,5.0,3.0,2.0,9,,,,,,,,,,,,,,,,,,,,,,,,,,,,,,,,,5,,,,,,,,,,,,,,,,,,,,,,,,,,,,,,,,,2,5.0,4.0,4.0,5.0,4.0,6.0,3.0,5.0,4.0,5.0,4.0,5.0,5.0,4.0,5.0,5.0,5.0,5.0,5.0,4.0,5.0,6.0,5.0,5.0,5.0,6.0,3.0,5.0,4.0,5.0,6.0,5.0,12,,,,,,,,,,,,,,,,,,,,,,,,,,,,,,,,,10,,,,,,,,,,,,,,,,,,,,,,,,,,,,,,,,,6,,,,,,,,,,,,,,,,,,,,,,,,,,,,,,,,,3,,,,,,,,,,,,,,,,,,,,,,,,,,,,,,,,,7,,,,,,,,,,,,,,,,,,,,,,,,,,,,,,,,,8,,,,,,,,,,,,,,,,,,,,,,,,,,,,,,,,,13,,,,,,,,,,,,,,,,,,,,,,,,,,,,,,,,,11,,,,,,,,,,,,,,,,,,,,,,,,,,,,,,,,,14,,,,,,,,,,,,,,,,,,,,,,,,,,,,,,,,,4,,,,,,,,,,,,,,,,,,,,,,,,,,,,,,,,,,591.74,125.0,,,,93.06,,50.16,,99.26,,,138.47,,,,,,,,,81.79,,,,,,,,,,,,,,,,,,,,,,,,,,,,,,,,,4.0,,APPROVED,Male,20.0,FALSE
1072,2022-03-22 03:02:07,19,en,384963706,2022-03-22 02:43:05,2022-03-22 03:02:07,Y,Y,A2,,,2,6.0,5.0,6.0,6.0,6.0,5.0,6.0,6.0,7.0,7.0,6.0,5.0,6.0,7.0,7.0,5.0,6.0,5.0,6.0,7.0,5.0,6.0,6.0,5.0,6.0,5.0,6.0,7.0,6.0,6.0,6.0,1.0,9,,,,,,,,,,,,,,,,,,,,,,,,,,,,,,,,,6,,,,,,,,,,,,,,,,,,,,,,,,,,,,,,,,,5,,,,,,,,,,,,,,,,,,,,,,,,,,,,,,,,,0,6.0,6.0,5.0,5.0,5.0,4.0,4.0,4.0,5.0,6.0,6.0,6.0,5.0,5.0,5.0,5.0,5.0,5.0,6.0,6.0,5.0,6.0,4.0,6.0,6.0,5.0,5.0,6.0,7.0,4.0,5.0,5.0,14,,,,,,,,,,,,,,,,,,,,,,,,,,,,,,,,,1,7.0,6.0,7.0,5.0,6.0,6.0,7.0,5.0,6.0,6.0,6.0,6.0,7.0,7.0,6.0,6.0,7.0,6.0,6.0,6.0,6.0,6.0,6.0,6.0,7.0,4.0,5.0,6.0,6.0,5.0,5.0,7.0,12,,,,,,,,,,,,,,,,,,,,,,,,,,,,,,,,,13,,,,,,,,,,,,,,,,,,,,,,,,,,,,,,,,,10,,,,,,,,,,,,,,,,,,,,,,,,,,,,,,,,,11,,,,,,,,,,,,,,,,,,,,,,,,,,,,,,,,,8,,,,,,,,,,,,,,,,,,,,,,,,,,,,,,,,,3,,,,,,,,,,,,,,,,,,,,,,,,,,,,,,,,,4,,,,,,,,,,,,,,,,,,,,,,,,,,,,,,,,,7,,,,,,,,,,,,,,,,,,,,,,,,,,,,,,,,,,640.77,17.06,,,,32.4,,11.38,,316.83,,,,,,,,,,,,83.44,,,,,,174.8,,,,,,,,,,,,,,,,,,,,,,,,,,,4.86,,APPROVED,Male,43.0,FALSE
1073,2022-03-22 02:51:15,19,en,980199268,2022-03-22 02:43:05,2022-03-22 02:51:15,Y,Y,A3,,,12,,,,,,,,,,,,,,,,,,,,,,,,,,,,,,,,,4,,,,,,,,,,,,,,,,,,,,,,,,,,,,,,,,,13,,,,,,,,,,,,,,,,,,,,,,,,,,,,,,,,,5,,,,,,,,,,,,,,,,,,,,,,,,,,,,,,,,,7,,,,,,,,,,,,,,,,,,,,,,,,,,,,,,,,,0,2.0,2.0,2.0,2.0,2.0,1.0,7.0,5.0,4.0,2.0,2.0,2.0,2.0,2.0,2.0,2.0,2.0,2.0,2.0,2.0,2.0,2.0,1.0,2.0,2.0,4.0,4.0,2.0,4.0,2.0,1.0,6.0,8,,,,,,,,,,,,,,,,,,,,,,,,,,,,,,,,,10,,,,,,,,,,,,,,,,,,,,,,,,,,,,,,,,,6,,,,,,,,,,,,,,,,,,,,,,,,,,,,,,,,,9,,,,,,,,,,,,,,,,,,,,,,,,,,,,,,,,,14,,,,,,,,,,,,,,,,,,,,,,,,,,,,,,,,,2,3.0,4.0,3.0,1.0,3.0,5.0,2.0,4.0,2.0,2.0,5.0,2.0,3.0,2.0,3.0,2.0,2.0,2.0,3.0,2.0,3.0,3.0,5.0,3.0,1.0,5.0,2.0,2.0,3.0,5.0,4.0,5.0,11,,,,,,,,,,,,,,,,,,,,,,,,,,,,,,,,,3,,,,,,,,,,,,,,,,,,,,,,,,,,,,,,,,,1,2.0,1.0,2.0,1.0,5.0,1.0,7.0,5.0,2.0,2.0,5.0,1.0,1.0,1.0,1.0,1.0,1.0,1.0,2.0,2.0,1.0,2.0,2.0,4.0,3.0,3.0,1.0,1.0,2.0,5.0,1.0,1.0,"The map based on Antarctica was the clearest, but if I came across the other two in a presentation, I'd run screaming.",386.22,18.04,,,,7.79,,41.1,,,,,,,,,,,,,,,,,96.16,,,,,,,,,,,,,,,,,,82.08,,,,,,,,,91.13,,,49.92,,APPROVED,Female,61.0,FALSE
1074,2022-03-22 02:50:24,19,en,2139094385,2022-03-22 02:43:06,2022-03-22 02:50:24,Y,Y,A1,,,12,,,,,,,,,,,,,,,,,,,,,,,,,,,,,,,,,9,,,,,,,,,,,,,,,,,,,,,,,,,,,,,,,,,2,4.0,4.0,3.0,5.0,3.0,4.0,4.0,3.0,4.0,3.0,3.0,4.0,3.0,3.0,4.0,4.0,4.0,4.0,3.0,4.0,4.0,4.0,4.0,3.0,4.0,3.0,3.0,4.0,4.0,3.0,4.0,3.0,1,4.0,5.0,4.0,3.0,5.0,4.0,5.0,4.0,5.0,4.0,3.0,4.0,4.0,4.0,4.0,4.0,5.0,4.0,4.0,3.0,3.0,5.0,4.0,3.0,5.0,3.0,4.0,4.0,4.0,3.0,4.0,4.0,7,,,,,,,,,,,,,,,,,,,,,,,,,,,,,,,,,10,,,,,,,,,,,,,,,,,,,,,,,,,,,,,,,,,11,,,,,,,,,,,,,,,,,,,,,,,,,,,,,,,,,13,,,,,,,,,,,,,,,,,,,,,,,,,,,,,,,,,6,,,,,,,,,,,,,,,,,,,,,,,,,,,,,,,,,14,,,,,,,,,,,,,,,,,,,,,,,,,,,,,,,,,0,3.0,4.0,3.0,3.0,1.0,2.0,6.0,4.0,3.0,3.0,3.0,2.0,2.0,2.0,4.0,1.0,3.0,1.0,3.0,2.0,2.0,3.0,1.0,3.0,1.0,1.0,2.0,2.0,2.0,2.0,1.0,4.0,5,,,,,,,,,,,,,,,,,,,,,,,,,,,,,,,,,8,,,,,,,,,,,,,,,,,,,,,,,,,,,,,,,,,3,,,,,,,,,,,,,,,,,,,,,,,,,,,,,,,,,4,,,,,,,,,,,,,,,,,,,,,,,,,,,,,,,,,It was a very interesting survey,264.44,10.59,,,,24.47,,64.11,,,,,,,,47.31,,,55.45,,,,,,,,,,,,,,,,,,,,,50.18,,,,,,,,,,,,,,,12.33,,APPROVED,Male,33.0,FALSE
1075,2022-03-22 02:51:00,19,en,1968994457,2022-03-22 02:43:11,2022-03-22 02:51:00,Y,Y,A1,,,0,4.0,6.0,5.0,6.0,1.0,2.0,5.0,6.0,6.0,2.0,2.0,6.0,4.0,1.0,4.0,5.0,6.0,3.0,5.0,2.0,4.0,2.0,5.0,1.0,1.0,3.0,5.0,5.0,3.0,3.0,4.0,1.0,6,,,,,,,,,,,,,,,,,,,,,,,,,,,,,,,,,8,,,,,,,,,,,,,,,,,,,,,,,,,,,,,,,,,1,5.0,5.0,4.0,6.0,6.0,6.0,6.0,6.0,6.0,4.0,6.0,6.0,4.0,4.0,5.0,6.0,6.0,7.0,6.0,4.0,4.0,6.0,7.0,6.0,5.0,7.0,5.0,6.0,5.0,4.0,7.0,4.0,14,,,,,,,,,,,,,,,,,,,,,,,,,,,,,,,,,9,,,,,,,,,,,,,,,,,,,,,,,,,,,,,,,,,4,,,,,,,,,,,,,,,,,,,,,,,,,,,,,,,,,7,,,,,,,,,,,,,,,,,,,,,,,,,,,,,,,,,2,2.0,1.0,1.0,3.0,1.0,6.0,4.0,6.0,1.0,1.0,3.0,2.0,1.0,1.0,1.0,4.0,5.0,2.0,1.0,2.0,4.0,1.0,4.0,1.0,2.0,6.0,1.0,3.0,1.0,1.0,3.0,2.0,13,,,,,,,,,,,,,,,,,,,,,,,,,,,,,,,,,12,,,,,,,,,,,,,,,,,,,,,,,,,,,,,,,,,5,,,,,,,,,,,,,,,,,,,,,,,,,,,,,,,,,3,,,,,,,,,,,,,,,,,,,,,,,,,,,,,,,,,10,,,,,,,,,,,,,,,,,,,,,,,,,,,,,,,,,11,,,,,,,,,,,,,,,,,,,,,,,,,,,,,,,,,,469.4,51.32,,,,16.98,,45.04,,141.21,,,,,,,,,112.96,,,,,,,,,,,,,,,96.63,,,,,,,,,,,,,,,,,,,,,5.26,,APPROVED,Female,25.0,FALSE
1076,2022-03-22 02:53:41,19,en,1437956109,2022-03-22 02:43:11,2022-03-22 02:53:41,Y,Y,A1,,,14,,,,,,,,,,,,,,,,,,,,,,,,,,,,,,,,,11,,,,,,,,,,,,,,,,,,,,,,,,,,,,,,,,,2,5.0,4.0,4.0,6.0,5.0,7.0,1.0,5.0,4.0,5.0,4.0,4.0,4.0,4.0,4.0,4.0,4.0,5.0,6.0,5.0,4.0,6.0,6.0,6.0,6.0,5.0,4.0,4.0,4.0,4.0,5.0,3.0,3,,,,,,,,,,,,,,,,,,,,,,,,,,,,,,,,,0,5.0,6.0,3.0,2.0,5.0,5.0,7.0,3.0,5.0,4.0,4.0,3.0,3.0,4.0,5.0,4.0,5.0,3.0,5.0,3.0,2.0,4.0,5.0,3.0,5.0,6.0,4.0,4.0,4.0,2.0,5.0,5.0,7,,,,,,,,,,,,,,,,,,,,,,,,,,,,,,,,,12,,,,,,,,,,,,,,,,,,,,,,,,,,,,,,,,,8,,,,,,,,,,,,,,,,,,,,,,,,,,,,,,,,,13,,,,,,,,,,,,,,,,,,,,,,,,,,,,,,,,,10,,,,,,,,,,,,,,,,,,,,,,,,,,,,,,,,,4,,,,,,,,,,,,,,,,,,,,,,,,,,,,,,,,,5,,,,,,,,,,,,,,,,,,,,,,,,,,,,,,,,,9,,,,,,,,,,,,,,,,,,,,,,,,,,,,,,,,,6,,,,,,,,,,,,,,,,,,,,,,,,,,,,,,,,,1,6.0,6.0,6.0,6.0,6.0,6.0,3.0,6.0,6.0,6.0,6.0,6.0,5.0,5.0,6.0,4.0,6.0,6.0,6.0,6.0,4.0,6.0,6.0,6.0,6.0,6.0,3.0,5.0,6.0,4.0,6.0,1.0,simple and clear,630.35,81.18,,,,90.09,,52.56,,,,,,,,112.09,,,,,,138.14,,,,,,,,,,,,,,,,,,,,,,,,,,,,,,124.21,,,32.08,,APPROVED,Female,23.0,FALSE
1078,2022-03-22 02:50:12,19,en,490110260,2022-03-22 02:43:15,2022-03-22 02:50:12,Y,Y,-oth-,High School,,3,,,,,,,,,,,,,,,,,,,,,,,,,,,,,,,,,12,,,,,,,,,,,,,,,,,,,,,,,,,,,,,,,,,7,,,,,,,,,,,,,,,,,,,,,,,,,,,,,,,,,5,,,,,,,,,,,,,,,,,,,,,,,,,,,,,,,,,13,,,,,,,,,,,,,,,,,,,,,,,,,,,,,,,,,4,,,,,,,,,,,,,,,,,,,,,,,,,,,,,,,,,1,1.0,2.0,1.0,1.0,1.0,3.0,6.0,2.0,2.0,1.0,1.0,1.0,1.0,1.0,1.0,1.0,1.0,1.0,1.0,1.0,1.0,1.0,1.0,1.0,1.0,2.0,4.0,1.0,1.0,2.0,2.0,7.0,9,,,,,,,,,,,,,,,,,,,,,,,,,,,,,,,,,8,,,,,,,,,,,,,,,,,,,,,,,,,,,,,,,,,10,,,,,,,,,,,,,,,,,,,,,,,,,,,,,,,,,11,,,,,,,,,,,,,,,,,,,,,,,,,,,,,,,,,0,7.0,7.0,7.0,7.0,7.0,7.0,1.0,6.0,7.0,7.0,7.0,7.0,7.0,6.0,6.0,7.0,7.0,7.0,7.0,7.0,6.0,7.0,6.0,7.0,7.0,6.0,1.0,7.0,6.0,6.0,6.0,5.0,2,7.0,7.0,7.0,2.0,6.0,6.0,2.0,6.0,7.0,7.0,5.0,7.0,7.0,6.0,7.0,5.0,7.0,7.0,7.0,7.0,5.0,7.0,3.0,7.0,6.0,5.0,1.0,7.0,5.0,7.0,5.0,6.0,6,,,,,,,,,,,,,,,,,,,,,,,,,,,,,,,,,14,,,,,,,,,,,,,,,,,,,,,,,,,,,,,,,,,,419.44,21.29,,,,61.55,,27.62,,,,,,,,,,,,,,,,,,,,76.24,,,,,,,,,,,,,,,124.27,,,104.97,,,,,,,,,3.5,,APPROVED,Female,54.0,FALSE
1079,2022-03-22 02:53:13,19,en,618878394,2022-03-22 02:43:15,2022-03-22 02:53:13,Y,Y,A1,,,3,,,,,,,,,,,,,,,,,,,,,,,,,,,,,,,,,6,,,,,,,,,,,,,,,,,,,,,,,,,,,,,,,,,5,,,,,,,,,,,,,,,,,,,,,,,,,,,,,,,,,8,,,,,,,,,,,,,,,,,,,,,,,,,,,,,,,,,10,,,,,,,,,,,,,,,,,,,,,,,,,,,,,,,,,4,,,,,,,,,,,,,,,,,,,,,,,,,,,,,,,,,7,,,,,,,,,,,,,,,,,,,,,,,,,,,,,,,,,11,,,,,,,,,,,,,,,,,,,,,,,,,,,,,,,,,13,,,,,,,,,,,,,,,,,,,,,,,,,,,,,,,,,1,6.0,6.0,6.0,5.0,5.0,4.0,4.0,4.0,6.0,6.0,6.0,6.0,6.0,5.0,6.0,6.0,6.0,6.0,6.0,6.0,5.0,6.0,3.0,6.0,5.0,6.0,5.0,4.0,4.0,6.0,5.0,3.0,9,,,,,,,,,,,,,,,,,,,,,,,,,,,,,,,,,12,,,,,,,,,,,,,,,,,,,,,,,,,,,,,,,,,0,4.0,3.0,5.0,4.0,4.0,3.0,5.0,6.0,3.0,3.0,4.0,4.0,4.0,3.0,4.0,3.0,5.0,5.0,5.0,4.0,3.0,5.0,3.0,5.0,4.0,5.0,3.0,3.0,4.0,4.0,3.0,6.0,2,3.0,2.0,3.0,3.0,2.0,3.0,4.0,6.0,4.0,2.0,1.0,3.0,3.0,1.0,3.0,3.0,3.0,3.0,3.0,3.0,3.0,4.0,3.0,3.0,2.0,4.0,2.0,2.0,1.0,1.0,3.0,7.0,14,,,,,,,,,,,,,,,,,,,,,,,,,,,,,,,,,None,589.39,73.48,,,,17.04,,115.62,,,,,,,,,,,,,,,,,,,,,,,,,,,,,129.77,,,,,,,,,133.56,,,111.52,,,,,,8.4,,APPROVED,Female,19.0,FALSE
1081,2022-03-22 02:50:31,19,en,590794921,2022-03-22 02:43:18,2022-03-22 02:50:31,Y,Y,A1,,,7,,,,,,,,,,,,,,,,,,,,,,,,,,,,,,,,,2,6.0,4.0,6.0,7.0,6.0,7.0,1.0,7.0,4.0,6.0,7.0,6.0,6.0,4.0,6.0,7.0,6.0,5.0,6.0,5.0,5.0,6.0,7.0,7.0,6.0,7.0,2.0,6.0,3.0,6.0,6.0,2.0,3,,,,,,,,,,,,,,,,,,,,,,,,,,,,,,,,,1,2.0,5.0,1.0,1.0,1.0,1.0,7.0,4.0,4.0,1.0,1.0,2.0,2.0,2.0,3.0,1.0,3.0,2.0,2.0,1.0,1.0,1.0,1.0,1.0,1.0,5.0,1.0,2.0,6.0,4.0,4.0,4.0,9,,,,,,,,,,,,,,,,,,,,,,,,,,,,,,,,,10,,,,,,,,,,,,,,,,,,,,,,,,,,,,,,,,,14,,,,,,,,,,,,,,,,,,,,,,,,,,,,,,,,,8,,,,,,,,,,,,,,,,,,,,,,,,,,,,,,,,,4,,,,,,,,,,,,,,,,,,,,,,,,,,,,,,,,,13,,,,,,,,,,,,,,,,,,,,,,,,,,,,,,,,,11,,,,,,,,,,,,,,,,,,,,,,,,,,,,,,,,,12,,,,,,,,,,,,,,,,,,,,,,,,,,,,,,,,,5,,,,,,,,,,,,,,,,,,,,,,,,,,,,,,,,,6,,,,,,,,,,,,,,,,,,,,,,,,,,,,,,,,,0,1.0,3.0,2.0,1.0,1.0,4.0,6.0,4.0,2.0,1.0,1.0,1.0,1.0,1.0,2.0,2.0,2.0,2.0,2.0,1.0,1.0,1.0,1.0,2.0,1.0,6.0,4.0,2.0,6.0,4.0,4.0,1.0,,465.74,68.42,,,,78.0,,29.6,,,,,71.42,,,,,,91.97,,,,,,,,,,,,,,,,,,,,,,,,,,,,,,,,,115.12,,,11.21,,APPROVED,Female,21.0,FALSE
1083,2022-03-22 03:02:56,19,en,212932665,2022-03-22 02:43:20,2022-03-22 03:02:56,Y,Y,A1,,,10,,,,,,,,,,,,,,,,,,,,,,,,,,,,,,,,,7,,,,,,,,,,,,,,,,,,,,,,,,,,,,,,,,,12,,,,,,,,,,,,,,,,,,,,,,,,,,,,,,,,,6,,,,,,,,,,,,,,,,,,,,,,,,,,,,,,,,,2,4.0,5.0,6.0,6.0,4.0,3.0,5.0,5.0,5.0,4.0,4.0,4.0,4.0,4.0,5.0,5.0,5.0,4.0,4.0,3.0,4.0,6.0,4.0,5.0,5.0,5.0,4.0,5.0,4.0,5.0,5.0,5.0,13,,,,,,,,,,,,,,,,,,,,,,,,,,,,,,,,,14,,,,,,,,,,,,,,,,,,,,,,,,,,,,,,,,,4,,,,,,,,,,,,,,,,,,,,,,,,,,,,,,,,,0,4.0,5.0,2.0,4.0,3.0,2.0,5.0,4.0,5.0,2.0,2.0,5.0,2.0,2.0,3.0,3.0,5.0,2.0,3.0,2.0,1.0,2.0,4.0,3.0,2.0,3.0,2.0,3.0,2.0,3.0,3.0,2.0,8,,,,,,,,,,,,,,,,,,,,,,,,,,,,,,,,,5,,,,,,,,,,,,,,,,,,,,,,,,,,,,,,,,,1,4.0,6.0,6.0,5.0,6.0,4.0,4.0,6.0,5.0,4.0,5.0,5.0,4.0,4.0,5.0,4.0,6.0,5.0,6.0,4.0,4.0,6.0,4.0,5.0,5.0,5.0,6.0,6.0,5.0,4.0,5.0,5.0,11,,,,,,,,,,,,,,,,,,,,,,,,,,,,,,,,,9,,,,,,,,,,,,,,,,,,,,,,,,,,,,,,,,,3,,,,,,,,,,,,,,,,,,,,,,,,,,,,,,,,,nope,1179.5,370.48,,,,6.93,,109.72,,,,,,,,,,,,,,155.19,,,,,,,,,,,,422.15,,,,,,,,,108.59,,,,,,,,,,,,6.44,,APPROVED,Female,24.0,FALSE
1085,2022-03-22 03:13:12,19,en,1933748175,2022-03-22 02:43:25,2022-03-22 03:13:12,Y,Y,A1,,,3,,,,,,,,,,,,,,,,,,,,,,,,,,,,,,,,,10,,,,,,,,,,,,,,,,,,,,,,,,,,,,,,,,,14,,,,,,,,,,,,,,,,,,,,,,,,,,,,,,,,,6,,,,,,,,,,,,,,,,,,,,,,,,,,,,,,,,,5,,,,,,,,,,,,,,,,,,,,,,,,,,,,,,,,,0,7.0,6.0,7.0,6.0,5.0,6.0,6.0,7.0,5.0,7.0,5.0,7.0,6.0,5.0,6.0,5.0,7.0,5.0,6.0,6.0,6.0,6.0,5.0,6.0,7.0,6.0,3.0,7.0,7.0,7.0,5.0,6.0,8,,,,,,,,,,,,,,,,,,,,,,,,,,,,,,,,,2,4.0,6.0,3.0,4.0,2.0,3.0,5.0,3.0,3.0,4.0,5.0,2.0,3.0,6.0,3.0,2.0,6.0,6.0,3.0,6.0,4.0,5.0,3.0,4.0,4.0,5.0,2.0,3.0,3.0,3.0,3.0,1.0,7,,,,,,,,,,,,,,,,,,,,,,,,,,,,,,,,,4,,,,,,,,,,,,,,,,,,,,,,,,,,,,,,,,,1,2.0,3.0,1.0,3.0,3.0,3.0,3.0,3.0,7.0,1.0,1.0,2.0,2.0,3.0,2.0,3.0,5.0,1.0,2.0,2.0,2.0,3.0,2.0,2.0,2.0,3.0,4.0,1.0,2.0,4.0,1.0,2.0,12,,,,,,,,,,,,,,,,,,,,,,,,,,,,,,,,,11,,,,,,,,,,,,,,,,,,,,,,,,,,,,,,,,,9,,,,,,,,,,,,,,,,,,,,,,,,,,,,,,,,,13,,,,,,,,,,,,,,,,,,,,,,,,,,,,,,,,,,1604.63,16.19,,,,29.18,,14.31,,,,,,,,,,,,,,,,,1462.53,,,,,,43.23,,,,,,,,,36.21,,,,,,,,,,,,,,,2.98,,APPROVED,Male,23.0,FALSE
1087,2022-03-22 02:49:36,19,en,1060232829,2022-03-22 02:43:27,2022-03-22 02:49:36,Y,Y,-oth-,A levels ,,1,4.0,7.0,4.0,4.0,5.0,5.0,5.0,6.0,6.0,4.0,4.0,5.0,5.0,5.0,6.0,3.0,6.0,3.0,4.0,3.0,3.0,4.0,3.0,3.0,4.0,4.0,3.0,5.0,3.0,4.0,4.0,1.0,2,4.0,4.0,6.0,5.0,4.0,6.0,1.0,6.0,4.0,4.0,5.0,4.0,4.0,4.0,4.0,4.0,4.0,4.0,6.0,6.0,4.0,5.0,7.0,5.0,4.0,7.0,4.0,7.0,7.0,6.0,7.0,2.0,4,,,,,,,,,,,,,,,,,,,,,,,,,,,,,,,,,13,,,,,,,,,,,,,,,,,,,,,,,,,,,,,,,,,8,,,,,,,,,,,,,,,,,,,,,,,,,,,,,,,,,9,,,,,,,,,,,,,,,,,,,,,,,,,,,,,,,,,6,,,,,,,,,,,,,,,,,,,,,,,,,,,,,,,,,10,,,,,,,,,,,,,,,,,,,,,,,,,,,,,,,,,0,1.0,4.0,1.0,2.0,1.0,2.0,7.0,1.0,1.0,1.0,1.0,2.0,1.0,2.0,2.0,1.0,4.0,1.0,2.0,1.0,1.0,1.0,1.0,2.0,1.0,1.0,2.0,1.0,1.0,1.0,1.0,2.0,7,,,,,,,,,,,,,,,,,,,,,,,,,,,,,,,,,5,,,,,,,,,,,,,,,,,,,,,,,,,,,,,,,,,14,,,,,,,,,,,,,,,,,,,,,,,,,,,,,,,,,11,,,,,,,,,,,,,,,,,,,,,,,,,,,,,,,,,3,,,,,,,,,,,,,,,,,,,,,,,,,,,,,,,,,12,,,,,,,,,,,,,,,,,,,,,,,,,,,,,,,,,,337.27,29.95,,,,21.99,,50.42,,94.39,,,60.84,,,,,,,,,,,,,,,,,,,,,74.97,,,,,,,,,,,,,,,,,,,,,4.71,,APPROVED,Female,21.0,FALSE
1088,2022-03-22 02:55:08,19,en,984702474,2022-03-22 02:43:35,2022-03-22 02:55:08,Y,Y,-oth-,Abitur,,9,,,,,,,,,,,,,,,,,,,,,,,,,,,,,,,,,4,,,,,,,,,,,,,,,,,,,,,,,,,,,,,,,,,0,4.0,6.0,5.0,4.0,5.0,2.0,3.0,6.0,6.0,5.0,4.0,5.0,5.0,3.0,6.0,5.0,5.0,5.0,5.0,5.0,4.0,5.0,4.0,4.0,5.0,3.0,2.0,5.0,4.0,3.0,5.0,3.0,5,,,,,,,,,,,,,,,,,,,,,,,,,,,,,,,,,12,,,,,,,,,,,,,,,,,,,,,,,,,,,,,,,,,2,5.0,7.0,6.0,5.0,6.0,4.0,2.0,7.0,7.0,5.0,5.0,5.0,6.0,4.0,5.0,6.0,6.0,5.0,6.0,2.0,5.0,6.0,5.0,6.0,6.0,5.0,2.0,6.0,5.0,5.0,5.0,6.0,8,,,,,,,,,,,,,,,,,,,,,,,,,,,,,,,,,13,,,,,,,,,,,,,,,,,,,,,,,,,,,,,,,,,3,,,,,,,,,,,,,,,,,,,,,,,,,,,,,,,,,1,1.0,2.0,1.0,1.0,1.0,3.0,7.0,1.0,1.0,1.0,1.0,2.0,1.0,2.0,5.0,2.0,4.0,1.0,2.0,2.0,1.0,2.0,1.0,2.0,1.0,3.0,4.0,2.0,2.0,2.0,1.0,3.0,11,,,,,,,,,,,,,,,,,,,,,,,,,,,,,,,,,7,,,,,,,,,,,,,,,,,,,,,,,,,,,,,,,,,6,,,,,,,,,,,,,,,,,,,,,,,,,,,,,,,,,14,,,,,,,,,,,,,,,,,,,,,,,,,,,,,,,,,10,,,,,,,,,,,,,,,,,,,,,,,,,,,,,,,,,,532.87,22.81,,,,16.91,,59.51,,,,,,,,201.14,,,,,,,,,106.69,,,,,,,,,,,,122.59,,,,,,,,,,,,,,,,,,3.22,,APPROVED,Female,20.0,FALSE
1089,2022-03-22 02:50:16,19,en,1017635137,2022-03-22 02:43:37,2022-03-22 02:50:16,Y,Y,A1,,,9,,,,,,,,,,,,,,,,,,,,,,,,,,,,,,,,,4,,,,,,,,,,,,,,,,,,,,,,,,,,,,,,,,,14,,,,,,,,,,,,,,,,,,,,,,,,,,,,,,,,,5,,,,,,,,,,,,,,,,,,,,,,,,,,,,,,,,,0,6.0,6.0,6.0,6.0,5.0,6.0,3.0,5.0,6.0,6.0,5.0,6.0,6.0,5.0,6.0,5.0,6.0,6.0,6.0,6.0,6.0,6.0,5.0,6.0,6.0,5.0,6.0,5.0,6.0,6.0,6.0,5.0,11,,,,,,,,,,,,,,,,,,,,,,,,,,,,,,,,,8,,,,,,,,,,,,,,,,,,,,,,,,,,,,,,,,,6,,,,,,,,,,,,,,,,,,,,,,,,,,,,,,,,,10,,,,,,,,,,,,,,,,,,,,,,,,,,,,,,,,,12,,,,,,,,,,,,,,,,,,,,,,,,,,,,,,,,,1,6.0,6.0,6.0,5.0,6.0,5.0,5.0,6.0,6.0,5.0,5.0,6.0,5.0,5.0,5.0,5.0,6.0,5.0,6.0,6.0,5.0,5.0,5.0,5.0,6.0,5.0,5.0,6.0,5.0,5.0,5.0,4.0,3,,,,,,,,,,,,,,,,,,,,,,,,,,,,,,,,,7,,,,,,,,,,,,,,,,,,,,,,,,,,,,,,,,,2,5.0,6.0,6.0,5.0,5.0,5.0,5.0,5.0,6.0,5.0,5.0,6.0,5.0,5.0,6.0,5.0,6.0,6.0,5.0,5.0,5.0,5.0,5.0,5.0,6.0,6.0,5.0,5.0,5.0,5.0,6.0,7.0,13,,,,,,,,,,,,,,,,,,,,,,,,,,,,,,,,,,384.07,34.62,,,,38.89,,41.47,,,,,,,,,,,,,,116.46,,,,,,,,,,,,,,,,,,75.96,,,,,,,,,68.46,,,,,,8.21,,APPROVED,Female,18.0,FALSE
1090,2022-03-22 02:53:17,19,en,2138560763,2022-03-22 02:43:43,2022-03-22 02:53:17,Y,Y,A1,,,4,,,,,,,,,,,,,,,,,,,,,,,,,,,,,,,,,1,5.0,4.0,4.0,5.0,3.0,6.0,3.0,6.0,3.0,3.0,3.0,4.0,4.0,2.0,2.0,6.0,5.0,3.0,4.0,2.0,2.0,5.0,6.0,2.0,4.0,4.0,3.0,5.0,3.0,3.0,4.0,2.0,7,,,,,,,,,,,,,,,,,,,,,,,,,,,,,,,,,10,,,,,,,,,,,,,,,,,,,,,,,,,,,,,,,,,5,,,,,,,,,,,,,,,,,,,,,,,,,,,,,,,,,6,,,,,,,,,,,,,,,,,,,,,,,,,,,,,,,,,11,,,,,,,,,,,,,,,,,,,,,,,,,,,,,,,,,2,1.0,1.0,4.0,3.0,1.0,1.0,7.0,5.0,2.0,1.0,1.0,2.0,2.0,2.0,1.0,4.0,5.0,2.0,2.0,1.0,1.0,2.0,2.0,2.0,2.0,1.0,4.0,3.0,1.0,1.0,1.0,1.0,14,,,,,,,,,,,,,,,,,,,,,,,,,,,,,,,,,12,,,,,,,,,,,,,,,,,,,,,,,,,,,,,,,,,0,5.0,6.0,5.0,5.0,3.0,3.0,6.0,6.0,6.0,3.0,2.0,4.0,3.0,3.0,3.0,5.0,5.0,4.0,4.0,2.0,2.0,3.0,4.0,3.0,3.0,5.0,4.0,3.0,4.0,5.0,5.0,4.0,13,,,,,,,,,,,,,,,,,,,,,,,,,,,,,,,,,9,,,,,,,,,,,,,,,,,,,,,,,,,,,,,,,,,8,,,,,,,,,,,,,,,,,,,,,,,,,,,,,,,,,3,,,,,,,,,,,,,,,,,,,,,,,,,,,,,,,,,,575.91,59.07,,,,78.03,,35.44,,,,,118.38,,,,,,,,,,,,,,,,,,139.34,,,,,,,,,140.76,,,,,,,,,,,,,,,4.89,,APPROVED,Male,23.0,FALSE
1091,2022-03-22 02:56:31,19,en,861465270,2022-03-22 02:43:44,2022-03-22 02:56:31,Y,Y,A3,,,11,,,,,,,,,,,,,,,,,,,,,,,,,,,,,,,,,0,6.0,6.0,6.0,6.0,6.0,7.0,2.0,7.0,4.0,5.0,6.0,6.0,6.0,4.0,5.0,6.0,6.0,5.0,6.0,6.0,4.0,7.0,7.0,5.0,6.0,6.0,1.0,6.0,6.0,6.0,6.0,2.0,1,7.0,7.0,7.0,6.0,7.0,6.0,4.0,7.0,7.0,7.0,7.0,7.0,7.0,7.0,7.0,7.0,7.0,7.0,7.0,7.0,7.0,7.0,5.0,7.0,7.0,6.0,7.0,6.0,7.0,7.0,7.0,3.0,7,,,,,,,,,,,,,,,,,,,,,,,,,,,,,,,,,4,,,,,,,,,,,,,,,,,,,,,,,,,,,,,,,,,3,,,,,,,,,,,,,,,,,,,,,,,,,,,,,,,,,14,,,,,,,,,,,,,,,,,,,,,,,,,,,,,,,,,5,,,,,,,,,,,,,,,,,,,,,,,,,,,,,,,,,8,,,,,,,,,,,,,,,,,,,,,,,,,,,,,,,,,2,5.0,7.0,6.0,3.0,5.0,2.0,7.0,4.0,7.0,4.0,5.0,6.0,6.0,7.0,7.0,1.0,7.0,7.0,5.0,5.0,4.0,6.0,3.0,6.0,5.0,5.0,7.0,5.0,6.0,6.0,4.0,3.0,6,,,,,,,,,,,,,,,,,,,,,,,,,,,,,,,,,9,,,,,,,,,,,,,,,,,,,,,,,,,,,,,,,,,10,,,,,,,,,,,,,,,,,,,,,,,,,,,,,,,,,12,,,,,,,,,,,,,,,,,,,,,,,,,,,,,,,,,13,,,,,,,,,,,,,,,,,,,,,,,,,,,,,,,,,"The survey itself was good but I feel this platform is really slow and buggy comparing to other survey platforms from the many I've tried. But besides that, great survey",797.69,63.29,,,,50.35,,73.96,,,,,296.86,,,167.63,,,,,,,,,,,,,,,,,,,,,95.94,,,,,,,,,,,,,,,,,,49.66,,APPROVED,Male,27.0,FALSE
1092,2022-03-22 02:54:56,19,en,1760765685,2022-03-22 02:44:19,2022-03-22 02:54:56,Y,Y,-oth-,highschool,,2,5.0,7.0,2.0,1.0,2.0,1.0,4.0,2.0,7.0,4.0,4.0,1.0,1.0,6.0,6.0,4.0,7.0,5.0,4.0,4.0,1.0,2.0,4.0,7.0,2.0,1.0,6.0,1.0,4.0,4.0,1.0,1.0,0,5.0,6.0,5.0,4.0,2.0,3.0,5.0,7.0,2.0,1.0,4.0,5.0,4.0,4.0,6.0,7.0,4.0,4.0,4.0,4.0,1.0,5.0,5.0,4.0,5.0,4.0,4.0,4.0,4.0,4.0,4.0,2.0,14,,,,,,,,,,,,,,,,,,,,,,,,,,,,,,,,,8,,,,,,,,,,,,,,,,,,,,,,,,,,,,,,,,,6,,,,,,,,,,,,,,,,,,,,,,,,,,,,,,,,,7,,,,,,,,,,,,,,,,,,,,,,,,,,,,,,,,,9,,,,,,,,,,,,,,,,,,,,,,,,,,,,,,,,,4,,,,,,,,,,,,,,,,,,,,,,,,,,,,,,,,,10,,,,,,,,,,,,,,,,,,,,,,,,,,,,,,,,,1,4.0,1.0,1.0,1.0,5.0,1.0,1.0,1.0,1.0,1.0,4.0,5.0,1.0,5.0,6.0,4.0,5.0,1.0,4.0,1.0,4.0,4.0,4.0,1.0,4.0,4.0,5.0,1.0,4.0,1.0,1.0,3.0,13,,,,,,,,,,,,,,,,,,,,,,,,,,,,,,,,,12,,,,,,,,,,,,,,,,,,,,,,,,,,,,,,,,,11,,,,,,,,,,,,,,,,,,,,,,,,,,,,,,,,,5,,,,,,,,,,,,,,,,,,,,,,,,,,,,,,,,,3,,,,,,,,,,,,,,,,,,,,,,,,,,,,,,,,,,589.06,10.66,,,,84.09,,14.44,,95.01,,,293.67,,,,,,,,,,,,,,,,,,,,,,,,88.07,,,,,,,,,,,,,,,,,,3.12,,APPROVED,Female,40.0,FALSE
1093,2022-03-22 02:51:44,19,en,54319296,2022-03-22 02:44:19,2022-03-22 02:51:44,Y,Y,A1,,,11,,,,,,,,,,,,,,,,,,,,,,,,,,,,,,,,,1,6.0,4.0,4.0,5.0,4.0,5.0,3.0,7.0,5.0,5.0,6.0,5.0,4.0,6.0,6.0,6.0,2.0,6.0,6.0,4.0,6.0,5.0,3.0,5.0,5.0,6.0,4.0,5.0,4.0,5.0,6.0,2.0,4,,,,,,,,,,,,,,,,,,,,,,,,,,,,,,,,,6,,,,,,,,,,,,,,,,,,,,,,,,,,,,,,,,,13,,,,,,,,,,,,,,,,,,,,,,,,,,,,,,,,,7,,,,,,,,,,,,,,,,,,,,,,,,,,,,,,,,,12,,,,,,,,,,,,,,,,,,,,,,,,,,,,,,,,,2,3.0,2.0,2.0,3.0,3.0,2.0,2.0,1.0,1.0,1.0,2.0,3.0,2.0,3.0,3.0,2.0,1.0,2.0,2.0,3.0,2.0,3.0,2.0,3.0,3.0,3.0,3.0,2.0,2.0,3.0,2.0,1.0,9,,,,,,,,,,,,,,,,,,,,,,,,,,,,,,,,,5,,,,,,,,,,,,,,,,,,,,,,,,,,,,,,,,,10,,,,,,,,,,,,,,,,,,,,,,,,,,,,,,,,,8,,,,,,,,,,,,,,,,,,,,,,,,,,,,,,,,,14,,,,,,,,,,,,,,,,,,,,,,,,,,,,,,,,,3,,,,,,,,,,,,,,,,,,,,,,,,,,,,,,,,,1,4.0,1.0,3.0,1.0,4.0,3.0,3.0,3.0,2.0,1.0,2.0,4.0,2.0,3.0,2.0,4.0,1.0,2.0,4.0,4.0,4.0,4.0,4.0,1.0,2.0,4.0,4.0,3.0,3.0,1.0,4.0,1.0,,344.77,28.65,,,,8.87,,25.64,,,,,87.67,,,,,,,,,,,,,,,,,,63.08,,,,,,,,,,,,,,,,,,,,,127.14,,,3.72,,APPROVED,Female,26.0,FALSE
1094,2022-03-22 02:59:31,19,en,1380594560,2022-03-22 02:45:12,2022-03-22 02:59:31,Y,Y,-oth-,A levels,,14,,,,,,,,,,,,,,,,,,,,,,,,,,,,,,,,,2,4.0,5.0,5.0,4.0,4.0,6.0,4.0,6.0,6.0,4.0,2.0,5.0,4.0,3.0,5.0,6.0,6.0,5.0,4.0,3.0,3.0,5.0,4.0,5.0,6.0,6.0,1.0,5.0,4.0,4.0,5.0,2.0,12,,,,,,,,,,,,,,,,,,,,,,,,,,,,,,,,,13,,,,,,,,,,,,,,,,,,,,,,,,,,,,,,,,,8,,,,,,,,,,,,,,,,,,,,,,,,,,,,,,,,,9,,,,,,,,,,,,,,,,,,,,,,,,,,,,,,,,,4,,,,,,,,,,,,,,,,,,,,,,,,,,,,,,,,,11,,,,,,,,,,,,,,,,,,,,,,,,,,,,,,,,,1,2.0,3.0,1.0,2.0,1.0,1.0,7.0,2.0,4.0,1.0,1.0,2.0,1.0,2.0,2.0,2.0,3.0,2.0,1.0,2.0,2.0,2.0,1.0,2.0,1.0,2.0,2.0,1.0,2.0,2.0,2.0,2.0,0,5.0,5.0,4.0,3.0,5.0,6.0,5.0,4.0,5.0,3.0,3.0,5.0,5.0,5.0,6.0,3.0,6.0,4.0,4.0,6.0,3.0,6.0,2.0,5.0,2.0,5.0,4.0,4.0,4.0,3.0,4.0,3.0,6,,,,,,,,,,,,,,,,,,,,,,,,,,,,,,,,,7,,,,,,,,,,,,,,,,,,,,,,,,,,,,,,,,,5,,,,,,,,,,,,,,,,,,,,,,,,,,,,,,,,,3,,,,,,,,,,,,,,,,,,,,,,,,,,,,,,,,,10,,,,,,,,,,,,,,,,,,,,,,,,,,,,,,,,,,763.05,16.2,,,,26.49,,71.19,,,,,233.75,,,,,,,,,,,,,,,,,,,,,188.96,,,221.14,,,,,,,,,,,,,,,,,,5.32,,APPROVED,Female,63.0,FALSE
1095,2022-03-22 02:53:03,19,en,834809679,2022-03-22 02:45:27,2022-03-22 02:53:03,Y,Y,A2,,,9,,,,,,,,,,,,,,,,,,,,,,,,,,,,,,,,,12,,,,,,,,,,,,,,,,,,,,,,,,,,,,,,,,,0,4.0,5.0,4.0,5.0,4.0,6.0,3.0,3.0,5.0,4.0,4.0,5.0,4.0,4.0,4.0,6.0,4.0,5.0,5.0,4.0,4.0,4.0,5.0,4.0,4.0,5.0,2.0,4.0,4.0,4.0,5.0,3.0,1,6.0,6.0,6.0,5.0,6.0,6.0,3.0,5.0,6.0,6.0,5.0,6.0,6.0,6.0,6.0,5.0,6.0,6.0,6.0,6.0,5.0,6.0,6.0,5.0,6.0,6.0,4.0,5.0,5.0,6.0,5.0,4.0,3,,,,,,,,,,,,,,,,,,,,,,,,,,,,,,,,,5,,,,,,,,,,,,,,,,,,,,,,,,,,,,,,,,,14,,,,,,,,,,,,,,,,,,,,,,,,,,,,,,,,,11,,,,,,,,,,,,,,,,,,,,,,,,,,,,,,,,,4,,,,,,,,,,,,,,,,,,,,,,,,,,,,,,,,,6,,,,,,,,,,,,,,,,,,,,,,,,,,,,,,,,,10,,,,,,,,,,,,,,,,,,,,,,,,,,,,,,,,,13,,,,,,,,,,,,,,,,,,,,,,,,,,,,,,,,,2,2.0,4.0,2.0,4.0,2.0,3.0,6.0,2.0,3.0,2.0,4.0,3.0,3.0,2.0,3.0,2.0,2.0,2.0,4.0,2.0,2.0,3.0,3.0,2.0,2.0,4.0,4.0,4.0,2.0,2.0,1.0,6.0,8,,,,,,,,,,,,,,,,,,,,,,,,,,,,,,,,,7,,,,,,,,,,,,,,,,,,,,,,,,,,,,,,,,,,436.73,34.68,,,,6.36,,44.61,,,,,,,,156.32,,,93.49,,,,,,,,,,,,,,,,,,,,,,,,,,,97.6,,,,,,,,,3.67,,APPROVED,Male,44.0,FALSE
1096,2022-03-22 02:50:47,19,en,608795552,2022-03-22 02:45:42,2022-03-22 02:50:47,Y,Y,A1,,,11,,,,,,,,,,,,,,,,,,,,,,,,,,,,,,,,,8,,,,,,,,,,,,,,,,,,,,,,,,,,,,,,,,,1,6.0,6.0,7.0,3.0,6.0,5.0,5.0,6.0,7.0,6.0,6.0,4.0,5.0,6.0,4.0,5.0,6.0,4.0,6.0,4.0,5.0,6.0,4.0,6.0,7.0,6.0,4.0,4.0,5.0,6.0,4.0,3.0,10,,,,,,,,,,,,,,,,,,,,,,,,,,,,,,,,,4,,,,,,,,,,,,,,,,,,,,,,,,,,,,,,,,,9,,,,,,,,,,,,,,,,,,,,,,,,,,,,,,,,,13,,,,,,,,,,,,,,,,,,,,,,,,,,,,,,,,,0,4.0,6.0,3.0,2.0,2.0,2.0,6.0,2.0,6.0,4.0,2.0,6.0,4.0,5.0,6.0,5.0,6.0,4.0,5.0,1.0,5.0,3.0,4.0,2.0,3.0,1.0,5.0,6.0,2.0,3.0,4.0,1.0,3,,,,,,,,,,,,,,,,,,,,,,,,,,,,,,,,,14,,,,,,,,,,,,,,,,,,,,,,,,,,,,,,,,,2,3.0,6.0,3.0,3.0,4.0,2.0,5.0,4.0,6.0,2.0,1.0,6.0,5.0,6.0,5.0,3.0,6.0,2.0,5.0,2.0,3.0,5.0,3.0,4.0,2.0,1.0,5.0,2.0,1.0,2.0,1.0,4.0,5,,,,,,,,,,,,,,,,,,,,,,,,,,,,,,,,,6,,,,,,,,,,,,,,,,,,,,,,,,,,,,,,,,,7,,,,,,,,,,,,,,,,,,,,,,,,,,,,,,,,,12,,,,,,,,,,,,,,,,,,,,,,,,,,,,,,,,,,308.66,12.49,,,,5.54,,20.45,,,,,,,,95.73,,,,,,,,,,,,,,,82.21,,,,,,,,,86.53,,,,,,,,,,,,,,,5.71,,APPROVED,Female,30.0,FALSE
1097,2022-03-22 02:54:46,19,en,1107655179,2022-03-22 02:45:45,2022-03-22 02:54:46,Y,Y,A2,,,9,,,,,,,,,,,,,,,,,,,,,,,,,,,,,,,,,7,,,,,,,,,,,,,,,,,,,,,,,,,,,,,,,,,8,,,,,,,,,,,,,,,,,,,,,,,,,,,,,,,,,13,,,,,,,,,,,,,,,,,,,,,,,,,,,,,,,,,0,4.0,1.0,4.0,3.0,2.0,3.0,5.0,5.0,3.0,3.0,6.0,3.0,4.0,4.0,2.0,4.0,5.0,2.0,4.0,3.0,2.0,4.0,6.0,4.0,2.0,6.0,3.0,4.0,5.0,5.0,4.0,5.0,11,,,,,,,,,,,,,,,,,,,,,,,,,,,,,,,,,6,,,,,,,,,,,,,,,,,,,,,,,,,,,,,,,,,2,3.0,3.0,4.0,4.0,3.0,5.0,6.0,5.0,3.0,4.0,4.0,3.0,4.0,3.0,3.0,3.0,5.0,3.0,4.0,3.0,3.0,4.0,6.0,3.0,3.0,3.0,4.0,4.0,5.0,4.0,5.0,1.0,5,,,,,,,,,,,,,,,,,,,,,,,,,,,,,,,,,10,,,,,,,,,,,,,,,,,,,,,,,,,,,,,,,,,14,,,,,,,,,,,,,,,,,,,,,,,,,,,,,,,,,1,5.0,5.0,5.0,6.0,5.0,5.0,2.0,6.0,5.0,3.0,5.0,5.0,4.0,3.0,4.0,6.0,5.0,4.0,5.0,3.0,2.0,5.0,5.0,5.0,5.0,6.0,3.0,4.0,5.0,4.0,5.0,5.0,3,,,,,,,,,,,,,,,,,,,,,,,,,,,,,,,,,4,,,,,,,,,,,,,,,,,,,,,,,,,,,,,,,,,12,,,,,,,,,,,,,,,,,,,,,,,,,,,,,,,,,,542.74,53.12,,,,77.59,,50.22,,,,,,,,,,,,,,113.42,,,,,,,,,121.23,,,,,,,,,,,,121.99,,,,,,,,,,,,5.17,,APPROVED,Male,36.0,FALSE
1100,2022-03-22 02:56:19,19,en,676472775,2022-03-22 02:46:10,2022-03-22 02:56:19,Y,Y,A1,,,0,5.0,6.0,4.0,4.0,5.0,4.0,4.0,5.0,5.0,4.0,3.0,6.0,4.0,6.0,6.0,4.0,6.0,5.0,5.0,4.0,4.0,5.0,5.0,4.0,5.0,4.0,5.0,1.0,6.0,4.0,5.0,1.0,3,,,,,,,,,,,,,,,,,,,,,,,,,,,,,,,,,5,,,,,,,,,,,,,,,,,,,,,,,,,,,,,,,,,11,,,,,,,,,,,,,,,,,,,,,,,,,,,,,,,,,1,6.0,3.0,5.0,6.0,4.0,6.0,3.0,4.0,3.0,4.0,4.0,3.0,4.0,3.0,4.0,4.0,5.0,4.0,5.0,5.0,3.0,5.0,6.0,5.0,4.0,6.0,3.0,6.0,5.0,5.0,5.0,5.0,14,,,,,,,,,,,,,,,,,,,,,,,,,,,,,,,,,2,1.0,3.0,3.0,5.0,1.0,4.0,1.0,4.0,1.0,2.0,1.0,3.0,1.0,1.0,2.0,4.0,2.0,3.0,3.0,1.0,1.0,1.0,4.0,1.0,1.0,3.0,1.0,1.0,1.0,3.0,3.0,7.0,6,,,,,,,,,,,,,,,,,,,,,,,,,,,,,,,,,4,,,,,,,,,,,,,,,,,,,,,,,,,,,,,,,,,10,,,,,,,,,,,,,,,,,,,,,,,,,,,,,,,,,8,,,,,,,,,,,,,,,,,,,,,,,,,,,,,,,,,12,,,,,,,,,,,,,,,,,,,,,,,,,,,,,,,,,9,,,,,,,,,,,,,,,,,,,,,,,,,,,,,,,,,7,,,,,,,,,,,,,,,,,,,,,,,,,,,,,,,,,13,,,,,,,,,,,,,,,,,,,,,,,,,,,,,,,,,,611.32,128.13,,,,15.64,,82.42,,126.16,,,,,,,,,,,,130.77,,,,,,122.17,,,,,,,,,,,,,,,,,,,,,,,,,,,6.03,,APPROVED,Male,33.0,FALSE
1101,2022-03-22 02:51:34,19,en,806037052,2022-03-22 02:46:11,2022-03-22 02:51:34,Y,Y,-oth-,in college,,8,,,,,,,,,,,,,,,,,,,,,,,,,,,,,,,,,12,,,,,,,,,,,,,,,,,,,,,,,,,,,,,,,,,13,,,,,,,,,,,,,,,,,,,,,,,,,,,,,,,,,9,,,,,,,,,,,,,,,,,,,,,,,,,,,,,,,,,7,,,,,,,,,,,,,,,,,,,,,,,,,,,,,,,,,5,,,,,,,,,,,,,,,,,,,,,,,,,,,,,,,,,11,,,,,,,,,,,,,,,,,,,,,,,,,,,,,,,,,4,,,,,,,,,,,,,,,,,,,,,,,,,,,,,,,,,0,3.0,3.0,3.0,2.0,3.0,1.0,6.0,2.0,1.0,3.0,1.0,3.0,4.0,3.0,3.0,4.0,4.0,3.0,3.0,3.0,3.0,1.0,1.0,2.0,1.0,4.0,5.0,1.0,3.0,3.0,3.0,2.0,10,,,,,,,,,,,,,,,,,,,,,,,,,,,,,,,,,1,7.0,6.0,6.0,5.0,5.0,3.0,4.0,6.0,5.0,5.0,4.0,4.0,5.0,4.0,5.0,4.0,5.0,5.0,6.0,3.0,4.0,3.0,5.0,5.0,6.0,2.0,4.0,5.0,4.0,6.0,6.0,4.0,6,,,,,,,,,,,,,,,,,,,,,,,,,,,,,,,,,14,,,,,,,,,,,,,,,,,,,,,,,,,,,,,,,,,3,,,,,,,,,,,,,,,,,,,,,,,,,,,,,,,,,2,6.0,6.0,4.0,5.0,4.0,3.0,4.0,5.0,6.0,4.0,3.0,5.0,4.0,5.0,6.0,3.0,6.0,4.0,4.0,3.0,3.0,6.0,4.0,4.0,3.0,3.0,5.0,5.0,4.0,6.0,6.0,1.0,,306.36,33.61,,,,11.63,,42.42,,,,,,,,,,,,,,,,,,,,,,,,,,68.75,,,,,,76.26,,,,,,,,,,,,70.41,,,3.28,,APPROVED,Female,19.0,FALSE
1102,2022-03-22 02:50:26,19,en,328910732,2022-03-22 02:46:24,2022-03-22 02:50:26,Y,Y,-oth-,A-Level,,13,,,,,,,,,,,,,,,,,,,,,,,,,,,,,,,,,4,,,,,,,,,,,,,,,,,,,,,,,,,,,,,,,,,1,5.0,6.0,4.0,4.0,5.0,3.0,6.0,6.0,5.0,5.0,5.0,5.0,5.0,5.0,5.0,5.0,6.0,3.0,5.0,4.0,4.0,5.0,4.0,4.0,6.0,5.0,6.0,5.0,4.0,5.0,4.0,3.0,2,4.0,6.0,3.0,5.0,4.0,4.0,6.0,4.0,5.0,4.0,6.0,5.0,3.0,4.0,4.0,3.0,6.0,2.0,4.0,3.0,3.0,4.0,5.0,3.0,4.0,6.0,6.0,5.0,5.0,4.0,4.0,4.0,3,,,,,,,,,,,,,,,,,,,,,,,,,,,,,,,,,8,,,,,,,,,,,,,,,,,,,,,,,,,,,,,,,,,6,,,,,,,,,,,,,,,,,,,,,,,,,,,,,,,,,0,3.0,5.0,3.0,3.0,3.0,2.0,7.0,4.0,5.0,3.0,2.0,4.0,5.0,5.0,5.0,3.0,6.0,4.0,4.0,4.0,4.0,4.0,3.0,4.0,3.0,2.0,5.0,3.0,3.0,3.0,3.0,1.0,7,,,,,,,,,,,,,,,,,,,,,,,,,,,,,,,,,10,,,,,,,,,,,,,,,,,,,,,,,,,,,,,,,,,5,,,,,,,,,,,,,,,,,,,,,,,,,,,,,,,,,14,,,,,,,,,,,,,,,,,,,,,,,,,,,,,,,,,12,,,,,,,,,,,,,,,,,,,,,,,,,,,,,,,,,9,,,,,,,,,,,,,,,,,,,,,,,,,,,,,,,,,11,,,,,,,,,,,,,,,,,,,,,,,,,,,,,,,,,,245.53,18.92,,,,25.28,,20.35,,,,,,,,55.89,,,58.9,,,,,,,,,,,,62.77,,,,,,,,,,,,,,,,,,,,,,,,3.42,,APPROVED,Female,18.0,FALSE
1103,2022-03-22 02:55:48,19,en,1721935576,2022-03-22 02:46:33,2022-03-22 02:55:48,Y,Y,A2,,,7,,,,,,,,,,,,,,,,,,,,,,,,,,,,,,,,,4,,,,,,,,,,,,,,,,,,,,,,,,,,,,,,,,,11,,,,,,,,,,,,,,,,,,,,,,,,,,,,,,,,,6,,,,,,,,,,,,,,,,,,,,,,,,,,,,,,,,,3,,,,,,,,,,,,,,,,,,,,,,,,,,,,,,,,,12,,,,,,,,,,,,,,,,,,,,,,,,,,,,,,,,,13,,,,,,,,,,,,,,,,,,,,,,,,,,,,,,,,,0,3.0,3.0,3.0,3.0,3.0,3.0,5.0,4.0,3.0,4.0,3.0,3.0,3.0,3.0,3.0,3.0,5.0,3.0,3.0,3.0,4.0,3.0,4.0,3.0,3.0,4.0,3.0,3.0,3.0,4.0,3.0,1.0,5,,,,,,,,,,,,,,,,,,,,,,,,,,,,,,,,,9,,,,,,,,,,,,,,,,,,,,,,,,,,,,,,,,,8,,,,,,,,,,,,,,,,,,,,,,,,,,,,,,,,,2,3.0,2.0,3.0,2.0,2.0,4.0,1.0,2.0,2.0,2.0,2.0,2.0,2.0,2.0,3.0,2.0,3.0,3.0,2.0,2.0,2.0,1.0,2.0,3.0,1.0,2.0,2.0,2.0,2.0,4.0,2.0,5.0,14,,,,,,,,,,,,,,,,,,,,,,,,,,,,,,,,,1,1.0,3.0,1.0,3.0,1.0,3.0,3.0,3.0,2.0,1.0,1.0,2.0,1.0,2.0,3.0,2.0,5.0,1.0,1.0,1.0,2.0,2.0,2.0,1.0,1.0,4.0,4.0,1.0,1.0,1.0,3.0,7.0,10,,,,,,,,,,,,,,,,,,,,,,,,,,,,,,,,,interesting survey,558.32,171.2,,,,6.63,,60.93,,,,,,,,,,,,,,,,,,,,,,,111.19,,,,,,,,,,,,83.24,,,,,,108.77,,,,,,16.36,,APPROVED,Female,44.0,FALSE
1104,2022-03-22 03:05:15,19,en,1739033882,2022-03-22 02:46:54,2022-03-22 03:05:15,Y,Y,-oth-,Grade 12 or High School,,5,,,,,,,,,,,,,,,,,,,,,,,,,,,,,,,,,9,,,,,,,,,,,,,,,,,,,,,,,,,,,,,,,,,13,,,,,,,,,,,,,,,,,,,,,,,,,,,,,,,,,2,7.0,6.0,6.0,6.0,6.0,5.0,3.0,7.0,6.0,5.0,5.0,5.0,5.0,6.0,5.0,4.0,6.0,6.0,6.0,5.0,5.0,6.0,6.0,6.0,6.0,5.0,4.0,5.0,5.0,5.0,7.0,4.0,1,5.0,6.0,5.0,2.0,4.0,2.0,3.0,6.0,5.0,5.0,5.0,3.0,2.0,5.0,2.0,3.0,3.0,4.0,3.0,3.0,3.0,3.0,2.0,4.0,2.0,2.0,2.0,2.0,3.0,3.0,5.0,5.0,8,,,,,,,,,,,,,,,,,,,,,,,,,,,,,,,,,11,,,,,,,,,,,,,,,,,,,,,,,,,,,,,,,,,0,2.0,5.0,1.0,1.0,1.0,1.0,7.0,4.0,3.0,1.0,2.0,2.0,2.0,2.0,2.0,3.0,1.0,2.0,1.0,1.0,2.0,1.0,4.0,1.0,2.0,2.0,4.0,2.0,3.0,3.0,2.0,1.0,3,,,,,,,,,,,,,,,,,,,,,,,,,,,,,,,,,10,,,,,,,,,,,,,,,,,,,,,,,,,,,,,,,,,6,,,,,,,,,,,,,,,,,,,,,,,,,,,,,,,,,14,,,,,,,,,,,,,,,,,,,,,,,,,,,,,,,,,12,,,,,,,,,,,,,,,,,,,,,,,,,,,,,,,,,7,,,,,,,,,,,,,,,,,,,,,,,,,,,,,,,,,4,,,,,,,,,,,,,,,,,,,,,,,,,,,,,,,,,,1103.77,279.29,,,,51.88,,98.28,,,,,,,,,,,144.16,,,181.29,,,,,,,,,339.68,,,,,,,,,,,,,,,,,,,,,,,,9.19,,APPROVED,Male,32.0,FALSE
1106,2022-03-22 02:54:39,19,en,293372000,2022-03-22 02:47:13,2022-03-22 02:54:39,Y,Y,A1,,,9,,,,,,,,,,,,,,,,,,,,,,,,,,,,,,,,,12,,,,,,,,,,,,,,,,,,,,,,,,,,,,,,,,,5,,,,,,,,,,,,,,,,,,,,,,,,,,,,,,,,,2,6.0,5.0,6.0,6.0,4.0,6.0,5.0,5.0,5.0,5.0,6.0,7.0,6.0,6.0,6.0,6.0,7.0,5.0,6.0,5.0,6.0,5.0,6.0,5.0,5.0,6.0,5.0,5.0,6.0,5.0,6.0,4.0,13,,,,,,,,,,,,,,,,,,,,,,,,,,,,,,,,,0,5.0,6.0,3.0,3.0,6.0,2.0,4.0,5.0,5.0,5.0,4.0,5.0,4.0,3.0,6.0,3.0,5.0,3.0,5.0,5.0,3.0,4.0,3.0,3.0,5.0,5.0,4.0,3.0,5.0,4.0,4.0,6.0,14,,,,,,,,,,,,,,,,,,,,,,,,,,,,,,,,,11,,,,,,,,,,,,,,,,,,,,,,,,,,,,,,,,,4,,,,,,,,,,,,,,,,,,,,,,,,,,,,,,,,,8,,,,,,,,,,,,,,,,,,,,,,,,,,,,,,,,,10,,,,,,,,,,,,,,,,,,,,,,,,,,,,,,,,,1,2.0,3.0,2.0,3.0,2.0,2.0,3.0,3.0,3.0,3.0,2.0,2.0,2.0,2.0,3.0,2.0,3.0,1.0,3.0,2.0,2.0,3.0,3.0,2.0,2.0,4.0,3.0,1.0,2.0,3.0,3.0,5.0,7,,,,,,,,,,,,,,,,,,,,,,,,,,,,,,,,,3,,,,,,,,,,,,,,,,,,,,,,,,,,,,,,,,,6,,,,,,,,,,,,,,,,,,,,,,,,,,,,,,,,,,447.23,23.97,,,,6.56,,94.05,,,,,,,,,,,101.02,,,,,,128.84,,,,,,,,,,,,,,,,,,89.36,,,,,,,,,,,,3.43,,APPROVED,Female,23.0,FALSE
1107,2022-03-22 03:06:15,19,en,263236783,2022-03-22 02:47:17,2022-03-22 03:06:15,Y,Y,A1,,,14,,,,,,,,,,,,,,,,,,,,,,,,,,,,,,,,,11,,,,,,,,,,,,,,,,,,,,,,,,,,,,,,,,,1,5.0,5.0,4.0,4.0,6.0,6.0,1.0,6.0,3.0,4.0,4.0,7.0,5.0,5.0,4.0,5.0,6.0,7.0,6.0,4.0,6.0,5.0,6.0,4.0,5.0,5.0,3.0,4.0,3.0,4.0,6.0,1.0,4,,,,,,,,,,,,,,,,,,,,,,,,,,,,,,,,,10,,,,,,,,,,,,,,,,,,,,,,,,,,,,,,,,,0,4.0,6.0,5.0,2.0,2.0,1.0,6.0,5.0,6.0,4.0,2.0,3.0,3.0,3.0,4.0,5.0,4.0,1.0,4.0,3.0,4.0,3.0,1.0,4.0,2.0,2.0,5.0,3.0,4.0,3.0,2.0,6.0,2,3.0,6.0,3.0,4.0,3.0,5.0,5.0,3.0,2.0,5.0,3.0,4.0,3.0,5.0,4.0,4.0,6.0,5.0,4.0,3.0,2.0,3.0,3.0,4.0,2.0,4.0,4.0,4.0,3.0,3.0,4.0,7.0,12,,,,,,,,,,,,,,,,,,,,,,,,,,,,,,,,,7,,,,,,,,,,,,,,,,,,,,,,,,,,,,,,,,,5,,,,,,,,,,,,,,,,,,,,,,,,,,,,,,,,,9,,,,,,,,,,,,,,,,,,,,,,,,,,,,,,,,,3,,,,,,,,,,,,,,,,,,,,,,,,,,,,,,,,,8,,,,,,,,,,,,,,,,,,,,,,,,,,,,,,,,,6,,,,,,,,,,,,,,,,,,,,,,,,,,,,,,,,,13,,,,,,,,,,,,,,,,,,,,,,,,,,,,,,,,,,1140.48,213.24,,,,21.02,,159.2,,,,,,,,202.08,,,,,,,,,287.64,,,243.89,,,,,,,,,,,,,,,,,,,,,,,,,,,13.41,,APPROVED,Female,24.0,FALSE
1108,2022-03-22 02:53:35,19,en,2109078376,2022-03-22 02:47:18,2022-03-22 02:53:35,Y,Y,A1,,,3,,,,,,,,,,,,,,,,,,,,,,,,,,,,,,,,,10,,,,,,,,,,,,,,,,,,,,,,,,,,,,,,,,,14,,,,,,,,,,,,,,,,,,,,,,,,,,,,,,,,,8,,,,,,,,,,,,,,,,,,,,,,,,,,,,,,,,,4,,,,,,,,,,,,,,,,,,,,,,,,,,,,,,,,,9,,,,,,,,,,,,,,,,,,,,,,,,,,,,,,,,,2,2.0,5.0,2.0,2.0,2.0,2.0,3.0,2.0,5.0,2.0,2.0,3.0,2.0,2.0,2.0,2.0,2.0,2.0,2.0,2.0,2.0,2.0,3.0,2.0,2.0,4.0,5.0,2.0,3.0,2.0,2.0,7.0,13,,,,,,,,,,,,,,,,,,,,,,,,,,,,,,,,,6,,,,,,,,,,,,,,,,,,,,,,,,,,,,,,,,,12,,,,,,,,,,,,,,,,,,,,,,,,,,,,,,,,,11,,,,,,,,,,,,,,,,,,,,,,,,,,,,,,,,,1,3.0,4.0,3.0,4.0,3.0,4.0,3.0,5.0,4.0,3.0,3.0,3.0,3.0,3.0,2.0,3.0,3.0,3.0,3.0,3.0,3.0,3.0,4.0,3.0,3.0,4.0,4.0,3.0,3.0,4.0,3.0,5.0,0,4.0,5.0,4.0,4.0,4.0,4.0,4.0,3.0,5.0,3.0,4.0,4.0,4.0,4.0,3.0,3.0,5.0,4.0,5.0,4.0,4.0,4.0,5.0,4.0,4.0,5.0,4.0,4.0,4.0,4.0,4.0,6.0,7,,,,,,,,,,,,,,,,,,,,,,,,,,,,,,,,,5,,,,,,,,,,,,,,,,,,,,,,,,,,,,,,,,,no,380.15,33.46,,,,8.43,,36.55,,,,,,,,,,,,,,,,,,,,97.3,,,,,,,,,,,,,,,100.01,,,94.84,,,,,,,,,9.56,,APPROVED,Female,49.0,FALSE
1110,2022-03-22 02:51:20,19,en,912205446,2022-03-22 02:47:49,2022-03-22 02:51:20,Y,Y,A1,,,11,,,,,,,,,,,,,,,,,,,,,,,,,,,,,,,,,5,,,,,,,,,,,,,,,,,,,,,,,,,,,,,,,,,2,5.0,5.0,5.0,6.0,4.0,5.0,4.0,5.0,5.0,6.0,5.0,4.0,6.0,6.0,4.0,6.0,5.0,6.0,4.0,5.0,4.0,5.0,5.0,5.0,6.0,5.0,6.0,5.0,4.0,5.0,6.0,5.0,7,,,,,,,,,,,,,,,,,,,,,,,,,,,,,,,,,12,,,,,,,,,,,,,,,,,,,,,,,,,,,,,,,,,13,,,,,,,,,,,,,,,,,,,,,,,,,,,,,,,,,1,1.0,2.0,1.0,1.0,1.0,5.0,6.0,5.0,1.0,1.0,1.0,1.0,1.0,2.0,1.0,4.0,1.0,1.0,1.0,1.0,1.0,1.0,1.0,1.0,1.0,4.0,1.0,1.0,1.0,1.0,3.0,7.0,3,,,,,,,,,,,,,,,,,,,,,,,,,,,,,,,,,14,,,,,,,,,,,,,,,,,,,,,,,,,,,,,,,,,9,,,,,,,,,,,,,,,,,,,,,,,,,,,,,,,,,6,,,,,,,,,,,,,,,,,,,,,,,,,,,,,,,,,10,,,,,,,,,,,,,,,,,,,,,,,,,,,,,,,,,4,,,,,,,,,,,,,,,,,,,,,,,,,,,,,,,,,0,2.0,3.0,1.0,5.0,2.0,5.0,1.0,5.0,3.0,2.0,4.0,5.0,2.0,2.0,6.0,6.0,2.0,4.0,4.0,2.0,5.0,4.0,6.0,2.0,2.0,5.0,5.0,4.0,5.0,3.0,4.0,7.0,8,,,,,,,,,,,,,,,,,,,,,,,,,,,,,,,,,,214.19,29.21,,,,5.46,,12.97,,,,,,,,48.73,,,,,,,,,,,,54.38,,,,,,,,,,,,,,,,,,,,,60.26,,,,,,3.18,,APPROVED,Female,19.0,FALSE
1111,2022-03-22 02:52:45,19,en,719011816,2022-03-22 02:47:58,2022-03-22 02:52:45,Y,Y,-oth-,,,0,2.0,6.0,5.0,1.0,5.0,4.0,6.0,5.0,5.0,1.0,5.0,5.0,5.0,4.0,5.0,2.0,5.0,4.0,4.0,4.0,2.0,4.0,1.0,4.0,5.0,3.0,5.0,5.0,5.0,5.0,4.0,1.0,10,,,,,,,,,,,,,,,,,,,,,,,,,,,,,,,,,11,,,,,,,,,,,,,,,,,,,,,,,,,,,,,,,,,6,,,,,,,,,,,,,,,,,,,,,,,,,,,,,,,,,13,,,,,,,,,,,,,,,,,,,,,,,,,,,,,,,,,1,5.0,5.0,6.0,4.0,6.0,4.0,3.0,5.0,7.0,4.0,4.0,6.0,5.0,4.0,5.0,5.0,5.0,6.0,6.0,6.0,4.0,6.0,4.0,6.0,5.0,5.0,4.0,6.0,5.0,5.0,5.0,6.0,12,,,,,,,,,,,,,,,,,,,,,,,,,,,,,,,,,9,,,,,,,,,,,,,,,,,,,,,,,,,,,,,,,,,8,,,,,,,,,,,,,,,,,,,,,,,,,,,,,,,,,14,,,,,,,,,,,,,,,,,,,,,,,,,,,,,,,,,4,,,,,,,,,,,,,,,,,,,,,,,,,,,,,,,,,5,,,,,,,,,,,,,,,,,,,,,,,,,,,,,,,,,3,,,,,,,,,,,,,,,,,,,,,,,,,,,,,,,,,7,,,,,,,,,,,,,,,,,,,,,,,,,,,,,,,,,2,5.0,5.0,6.0,4.0,5.0,4.0,5.0,6.0,6.0,4.0,6.0,4.0,4.0,4.0,4.0,5.0,5.0,5.0,4.0,5.0,5.0,4.0,3.0,5.0,5.0,5.0,4.0,4.0,6.0,5.0,6.0,1.0,,291.11,22.77,,,,40.65,,24.5,,74.42,,,,,,,,,,,,,,,63.65,,,,,,,,,,,,,,,,,,,,,,,,,,,58.87,,,6.25,,TIMED-OUT,Female,58.0,FALSE
1113,2022-03-22 02:57:13,19,en,951563456,2022-03-22 02:49:56,2022-03-22 02:57:13,Y,Y,-oth-,Associate's Degree,,10,,,,,,,,,,,,,,,,,,,,,,,,,,,,,,,,,2,6.0,4.0,5.0,6.0,5.0,7.0,1.0,6.0,3.0,4.0,4.0,6.0,6.0,4.0,4.0,5.0,6.0,5.0,6.0,4.0,5.0,6.0,7.0,5.0,4.0,7.0,4.0,6.0,4.0,6.0,7.0,2.0,6,,,,,,,,,,,,,,,,,,,,,,,,,,,,,,,,,3,,,,,,,,,,,,,,,,,,,,,,,,,,,,,,,,,13,,,,,,,,,,,,,,,,,,,,,,,,,,,,,,,,,7,,,,,,,,,,,,,,,,,,,,,,,,,,,,,,,,,9,,,,,,,,,,,,,,,,,,,,,,,,,,,,,,,,,5,,,,,,,,,,,,,,,,,,,,,,,,,,,,,,,,,12,,,,,,,,,,,,,,,,,,,,,,,,,,,,,,,,,0,5.0,7.0,6.0,4.0,6.0,4.0,5.0,4.0,7.0,6.0,7.0,6.0,5.0,4.0,7.0,6.0,7.0,5.0,6.0,5.0,4.0,5.0,3.0,5.0,6.0,4.0,5.0,6.0,6.0,6.0,4.0,3.0,14,,,,,,,,,,,,,,,,,,,,,,,,,,,,,,,,,11,,,,,,,,,,,,,,,,,,,,,,,,,,,,,,,,,1,2.0,4.0,3.0,3.0,2.0,2.0,6.0,4.0,5.0,2.0,2.0,3.0,4.0,2.0,4.0,2.0,5.0,1.0,4.0,3.0,3.0,3.0,3.0,2.0,2.0,3.0,3.0,2.0,4.0,4.0,5.0,6.0,4,,,,,,,,,,,,,,,,,,,,,,,,,,,,,,,,,8,,,,,,,,,,,,,,,,,,,,,,,,,,,,,,,,,,441.44,18.96,,,,12.78,,20.49,,,,,166.57,,,,,,,,,,,,,,,,,,,,,,,,91.42,,,,,,,,,127.4,,,,,,,,,3.82,,APPROVED,Prefer not to say,19.0,FALSE
1115,2022-03-22 03:04:42,19,en,97246427,2022-03-22 02:50:32,2022-03-22 03:04:42,Y,Y,-oth-,collee degree,,9,,,,,,,,,,,,,,,,,,,,,,,,,,,,,,,,,7,,,,,,,,,,,,,,,,,,,,,,,,,,,,,,,,,11,,,,,,,,,,,,,,,,,,,,,,,,,,,,,,,,,4,,,,,,,,,,,,,,,,,,,,,,,,,,,,,,,,,8,,,,,,,,,,,,,,,,,,,,,,,,,,,,,,,,,1,2.0,1.0,2.0,1.0,1.0,1.0,7.0,7.0,3.0,5.0,2.0,5.0,2.0,2.0,7.0,7.0,1.0,5.0,3.0,5.0,1.0,2.0,2.0,2.0,2.0,6.0,3.0,5.0,1.0,1.0,1.0,6.0,2,7.0,5.0,7.0,6.0,6.0,7.0,7.0,6.0,5.0,5.0,6.0,7.0,6.0,6.0,6.0,6.0,6.0,6.0,6.0,6.0,5.0,6.0,6.0,5.0,7.0,6.0,1.0,6.0,6.0,7.0,5.0,7.0,6,,,,,,,,,,,,,,,,,,,,,,,,,,,,,,,,,14,,,,,,,,,,,,,,,,,,,,,,,,,,,,,,,,,10,,,,,,,,,,,,,,,,,,,,,,,,,,,,,,,,,12,,,,,,,,,,,,,,,,,,,,,,,,,,,,,,,,,5,,,,,,,,,,,,,,,,,,,,,,,,,,,,,,,,,0,5.0,6.0,2.0,5.0,6.0,2.0,7.0,7.0,7.0,6.0,2.0,6.0,5.0,6.0,2.0,2.0,6.0,6.0,6.0,6.0,7.0,6.0,6.0,6.0,6.0,7.0,1.0,6.0,5.0,2.0,2.0,6.0,3,,,,,,,,,,,,,,,,,,,,,,,,,,,,,,,,,13,,,,,,,,,,,,,,,,,,,,,,,,,,,,,,,,,I enjoyed taking this study.,854.31,66.98,,,,33.84,,87.18,,,,,,,,,,,,,,,,,181.82,,,158.61,,,,,,,,,,,,,,,,,,284.15,,,,,,,,,41.73,,APPROVED,Male,29.0,FALSE
1116,2022-03-22 02:54:43,19,en,510044312,2022-03-22 02:51:26,2022-03-22 02:54:43,Y,Y,-oth-,High school,,14,,,,,,,,,,,,,,,,,,,,,,,,,,,,,,,,,3,,,,,,,,,,,,,,,,,,,,,,,,,,,,,,,,,0,5.0,6.0,5.0,4.0,6.0,5.0,6.0,6.0,6.0,5.0,5.0,5.0,5.0,6.0,5.0,4.0,5.0,5.0,5.0,5.0,4.0,5.0,5.0,5.0,6.0,4.0,4.0,4.0,5.0,5.0,5.0,1.0,4,,,,,,,,,,,,,,,,,,,,,,,,,,,,,,,,,6,,,,,,,,,,,,,,,,,,,,,,,,,,,,,,,,,9,,,,,,,,,,,,,,,,,,,,,,,,,,,,,,,,,12,,,,,,,,,,,,,,,,,,,,,,,,,,,,,,,,,11,,,,,,,,,,,,,,,,,,,,,,,,,,,,,,,,,7,,,,,,,,,,,,,,,,,,,,,,,,,,,,,,,,,13,,,,,,,,,,,,,,,,,,,,,,,,,,,,,,,,,5,,,,,,,,,,,,,,,,,,,,,,,,,,,,,,,,,1,6.0,7.0,6.0,5.0,6.0,4.0,4.0,6.0,6.0,6.0,4.0,7.0,6.0,7.0,6.0,4.0,7.0,4.0,6.0,6.0,5.0,6.0,4.0,7.0,6.0,4.0,6.0,5.0,3.0,5.0,6.0,5.0,8,,,,,,,,,,,,,,,,,,,,,,,,,,,,,,,,,2,5.0,4.0,4.0,4.0,3.0,4.0,4.0,3.0,5.0,3.0,2.0,6.0,5.0,5.0,6.0,3.0,5.0,4.0,5.0,3.0,3.0,5.0,4.0,3.0,3.0,4.0,6.0,3.0,4.0,4.0,5.0,7.0,10,,,,,,,,,,,,,,,,,,,,,,,,,,,,,,,,,,200.72,13.27,,,,9.07,,19.84,,,,,,,,47.7,,,,,,,,,,,,,,,,,,,,,,,,,,,50.83,,,,,,56.86,,,,,,3.15,,APPROVED,Female,19.0,FALSE
1117,2022-03-22 03:03:01,19,en,57802345,2022-03-22 02:52:19,2022-03-22 03:03:01,Y,Y,A1,,,9,,,,,,,,,,,,,,,,,,,,,,,,,,,,,,,,,11,,,,,,,,,,,,,,,,,,,,,,,,,,,,,,,,,14,,,,,,,,,,,,,,,,,,,,,,,,,,,,,,,,,6,,,,,,,,,,,,,,,,,,,,,,,,,,,,,,,,,5,,,,,,,,,,,,,,,,,,,,,,,,,,,,,,,,,4,,,,,,,,,,,,,,,,,,,,,,,,,,,,,,,,,12,,,,,,,,,,,,,,,,,,,,,,,,,,,,,,,,,3,,,,,,,,,,,,,,,,,,,,,,,,,,,,,,,,,8,,,,,,,,,,,,,,,,,,,,,,,,,,,,,,,,,0,4.0,4.0,4.0,2.0,3.0,3.0,6.0,2.0,4.0,2.0,4.0,4.0,4.0,2.0,2.0,2.0,4.0,2.0,4.0,2.0,2.0,2.0,3.0,4.0,2.0,4.0,3.0,3.0,3.0,4.0,3.0,3.0,2,1.0,2.0,2.0,2.0,2.0,2.0,2.0,4.0,2.0,2.0,2.0,2.0,3.0,1.0,2.0,2.0,2.0,2.0,4.0,2.0,1.0,2.0,2.0,2.0,1.0,2.0,1.0,2.0,2.0,1.0,3.0,4.0,10,,,,,,,,,,,,,,,,,,,,,,,,,,,,,,,,,7,,,,,,,,,,,,,,,,,,,,,,,,,,,,,,,,,1,1.0,1.0,1.0,1.0,1.0,2.0,4.0,1.0,1.0,1.0,1.0,1.0,1.0,1.0,1.0,1.0,1.0,1.0,1.0,1.0,1.0,1.0,2.0,2.0,1.0,1.0,1.0,1.0,1.0,1.0,1.0,7.0,13,,,,,,,,,,,,,,,,,,,,,,,,,,,,,,,,,,644.86,59.12,,,,15.09,,84.95,,,,,,,,,,,,,,,,,,,,,,,,,,,,,206.2,,,167.47,,,,,,,,,103.29,,,,,,8.74,,APPROVED,Female,22.0,FALSE
1119,2022-03-22 03:00:56,19,en,349231033,2022-03-22 02:56:53,2022-03-22 03:00:56,Y,Y,A1,,,6,,,,,,,,,,,,,,,,,,,,,,,,,,,,,,,,,3,,,,,,,,,,,,,,,,,,,,,,,,,,,,,,,,,8,,,,,,,,,,,,,,,,,,,,,,,,,,,,,,,,,1,5.0,6.0,6.0,2.0,5.0,3.0,3.0,6.0,5.0,5.0,3.0,3.0,5.0,3.0,6.0,2.0,5.0,5.0,3.0,6.0,2.0,5.0,2.0,5.0,5.0,2.0,2.0,5.0,3.0,2.0,5.0,4.0,9,,,,,,,,,,,,,,,,,,,,,,,,,,,,,,,,,7,,,,,,,,,,,,,,,,,,,,,,,,,,,,,,,,,13,,,,,,,,,,,,,,,,,,,,,,,,,,,,,,,,,5,,,,,,,,,,,,,,,,,,,,,,,,,,,,,,,,,14,,,,,,,,,,,,,,,,,,,,,,,,,,,,,,,,,11,,,,,,,,,,,,,,,,,,,,,,,,,,,,,,,,,2,2.0,4.0,3.0,5.0,3.0,3.0,2.0,3.0,4.0,4.0,3.0,3.0,5.0,3.0,3.0,2.0,6.0,2.0,3.0,3.0,2.0,5.0,2.0,2.0,5.0,2.0,2.0,3.0,3.0,3.0,2.0,4.0,4,,,,,,,,,,,,,,,,,,,,,,,,,,,,,,,,,0,3.0,7.0,4.0,3.0,4.0,3.0,3.0,3.0,7.0,4.0,6.0,3.0,5.0,3.0,5.0,4.0,5.0,3.0,6.0,4.0,4.0,5.0,3.0,5.0,5.0,3.0,3.0,5.0,5.0,2.0,5.0,6.0,10,,,,,,,,,,,,,,,,,,,,,,,,,,,,,,,,,12,,,,,,,,,,,,,,,,,,,,,,,,,,,,,,,,,,309.86,36.73,,,,5.84,,13.48,,,,,,,,,,,84.89,,,,,,,,,,,,,,,,,,,,,41.63,,,,,,124.04,,,,,,,,,3.25,,APPROVED,Female,23.0,FALSE
1120,2022-03-22 03:03:00,19,en,547263543,2022-03-22 02:56:57,2022-03-22 03:03:00,Y,Y,A2,,,14,,,,,,,,,,,,,,,,,,,,,,,,,,,,,,,,,8,,,,,,,,,,,,,,,,,,,,,,,,,,,,,,,,,5,,,,,,,,,,,,,,,,,,,,,,,,,,,,,,,,,2,3.0,5.0,3.0,7.0,5.0,6.0,5.0,5.0,5.0,4.0,4.0,5.0,3.0,4.0,4.0,5.0,4.0,5.0,6.0,5.0,4.0,3.0,3.0,4.0,4.0,5.0,5.0,5.0,6.0,5.0,7.0,4.0,1,5.0,4.0,2.0,6.0,4.0,5.0,2.0,5.0,5.0,5.0,2.0,5.0,6.0,5.0,2.0,2.0,2.0,5.0,4.0,2.0,2.0,6.0,5.0,5.0,1.0,4.0,3.0,5.0,5.0,3.0,5.0,5.0,3,,,,,,,,,,,,,,,,,,,,,,,,,,,,,,,,,4,,,,,,,,,,,,,,,,,,,,,,,,,,,,,,,,,10,,,,,,,,,,,,,,,,,,,,,,,,,,,,,,,,,9,,,,,,,,,,,,,,,,,,,,,,,,,,,,,,,,,13,,,,,,,,,,,,,,,,,,,,,,,,,,,,,,,,,6,,,,,,,,,,,,,,,,,,,,,,,,,,,,,,,,,7,,,,,,,,,,,,,,,,,,,,,,,,,,,,,,,,,12,,,,,,,,,,,,,,,,,,,,,,,,,,,,,,,,,0,2.0,5.0,6.0,5.0,4.0,5.0,4.0,5.0,6.0,5.0,6.0,6.0,2.0,6.0,6.0,6.0,2.0,5.0,4.0,1.0,1.0,4.0,6.0,6.0,4.0,3.0,5.0,5.0,5.0,5.0,6.0,7.0,11,,,,,,,,,,,,,,,,,,,,,,,,,,,,,,,,,,366.37,12.82,,,,6.68,,33.44,,,,,,,,,,,114.31,,,134.21,,,,,,,,,,,,,,,,,,,,,,,,,,,61.23,,,,,,3.68,,APPROVED,Male,27.0,FALSE
1121,2022-03-22 03:02:57,19,en,970708834,2022-03-22 02:56:59,2022-03-22 03:02:57,Y,Y,A1,,,1,1.0,1.0,1.0,1.0,1.0,1.0,6.0,1.0,4.0,1.0,1.0,1.0,1.0,1.0,4.0,1.0,1.0,1.0,1.0,1.0,1.0,1.0,1.0,1.0,1.0,1.0,4.0,1.0,1.0,1.0,1.0,1.0,14,,,,,,,,,,,,,,,,,,,,,,,,,,,,,,,,,6,,,,,,,,,,,,,,,,,,,,,,,,,,,,,,,,,0,4.0,3.0,7.0,3.0,5.0,4.0,5.0,4.0,5.0,5.0,6.0,5.0,5.0,4.0,5.0,6.0,6.0,5.0,5.0,5.0,5.0,4.0,3.0,6.0,5.0,5.0,5.0,5.0,7.0,5.0,5.0,4.0,8,,,,,,,,,,,,,,,,,,,,,,,,,,,,,,,,,12,,,,,,,,,,,,,,,,,,,,,,,,,,,,,,,,,10,,,,,,,,,,,,,,,,,,,,,,,,,,,,,,,,,11,,,,,,,,,,,,,,,,,,,,,,,,,,,,,,,,,5,,,,,,,,,,,,,,,,,,,,,,,,,,,,,,,,,3,,,,,,,,,,,,,,,,,,,,,,,,,,,,,,,,,7,,,,,,,,,,,,,,,,,,,,,,,,,,,,,,,,,13,,,,,,,,,,,,,,,,,,,,,,,,,,,,,,,,,4,,,,,,,,,,,,,,,,,,,,,,,,,,,,,,,,,9,,,,,,,,,,,,,,,,,,,,,,,,,,,,,,,,,2,2.0,4.0,1.0,2.0,1.0,4.0,2.0,1.0,1.0,1.0,3.0,1.0,2.0,2.0,1.0,1.0,2.0,1.0,1.0,1.0,1.0,3.0,1.0,4.0,2.0,2.0,1.0,3.0,1.0,1.0,1.0,1.0,,361.37,43.74,,,,43.59,,40.0,,82.37,,,,,,,,,59.93,,,,,,,,,,,,,,,,,,,,,,,,,,,,,,,,,61.97,,,29.77,,APPROVED,Male,39.0,FALSE
1122,2022-03-22 03:01:39,19,en,659530636,2022-03-22 02:57:03,2022-03-22 03:01:39,Y,Y,A1,,,2,2.0,2.0,3.0,3.0,4.0,3.0,4.0,2.0,2.0,3.0,2.0,3.0,3.0,4.0,3.0,2.0,2.0,2.0,3.0,2.0,3.0,3.0,3.0,3.0,4.0,2.0,3.0,3.0,3.0,3.0,4.0,1.0,6,,,,,,,,,,,,,,,,,,,,,,,,,,,,,,,,,13,,,,,,,,,,,,,,,,,,,,,,,,,,,,,,,,,14,,,,,,,,,,,,,,,,,,,,,,,,,,,,,,,,,10,,,,,,,,,,,,,,,,,,,,,,,,,,,,,,,,,3,,,,,,,,,,,,,,,,,,,,,,,,,,,,,,,,,11,,,,,,,,,,,,,,,,,,,,,,,,,,,,,,,,,7,,,,,,,,,,,,,,,,,,,,,,,,,,,,,,,,,5,,,,,,,,,,,,,,,,,,,,,,,,,,,,,,,,,1,1.0,2.0,2.0,2.0,2.0,1.0,5.0,1.0,2.0,1.0,3.0,1.0,1.0,2.0,4.0,3.0,2.0,1.0,2.0,1.0,1.0,1.0,1.0,2.0,1.0,1.0,2.0,1.0,1.0,1.0,3.0,3.0,4,,,,,,,,,,,,,,,,,,,,,,,,,,,,,,,,,12,,,,,,,,,,,,,,,,,,,,,,,,,,,,,,,,,8,,,,,,,,,,,,,,,,,,,,,,,,,,,,,,,,,9,,,,,,,,,,,,,,,,,,,,,,,,,,,,,,,,,0,3.0,2.0,4.0,3.0,4.0,2.0,3.0,1.0,2.0,3.0,5.0,2.0,4.0,4.0,5.0,1.0,4.0,2.0,2.0,2.0,2.0,1.0,3.0,5.0,4.0,3.0,1.0,2.0,3.0,2.0,3.0,1.0,No,278.17,16.01,,,,3.3,,41.29,,76.16,,,,,,,,,,,,,,,,,,,,,,,,,,,55.86,,,,,,,,,,,,,,,81.14,,,4.41,,APPROVED,Male,24.0,FALSE
1123,2022-03-22 03:04:07,19,en,466895165,2022-03-22 02:57:04,2022-03-22 03:04:07,Y,Y,A3,,,2,1.0,4.0,3.0,4.0,3.0,2.0,4.0,5.0,5.0,2.0,3.0,3.0,2.0,5.0,3.0,2.0,4.0,2.0,1.0,2.0,4.0,3.0,4.0,1.0,2.0,4.0,4.0,2.0,4.0,3.0,4.0,1.0,8,,,,,,,,,,,,,,,,,,,,,,,,,,,,,,,,,1,5.0,5.0,5.0,5.0,5.0,6.0,3.0,6.0,4.0,4.0,5.0,4.0,5.0,3.0,4.0,5.0,5.0,4.0,5.0,4.0,4.0,5.0,6.0,5.0,6.0,4.0,1.0,5.0,5.0,5.0,5.0,3.0,12,,,,,,,,,,,,,,,,,,,,,,,,,,,,,,,,,3,,,,,,,,,,,,,,,,,,,,,,,,,,,,,,,,,5,,,,,,,,,,,,,,,,,,,,,,,,,,,,,,,,,10,,,,,,,,,,,,,,,,,,,,,,,,,,,,,,,,,14,,,,,,,,,,,,,,,,,,,,,,,,,,,,,,,,,7,,,,,,,,,,,,,,,,,,,,,,,,,,,,,,,,,4,,,,,,,,,,,,,,,,,,,,,,,,,,,,,,,,,6,,,,,,,,,,,,,,,,,,,,,,,,,,,,,,,,,13,,,,,,,,,,,,,,,,,,,,,,,,,,,,,,,,,11,,,,,,,,,,,,,,,,,,,,,,,,,,,,,,,,,9,,,,,,,,,,,,,,,,,,,,,,,,,,,,,,,,,0,5.0,6.0,5.0,4.0,5.0,4.0,3.0,6.0,4.0,4.0,5.0,4.0,6.0,4.0,4.0,6.0,5.0,4.0,6.0,4.0,3.0,6.0,4.0,6.0,5.0,4.0,2.0,5.0,4.0,5.0,6.0,1.0,,426.25,13.78,,,,6.41,,34.5,,132.7,,,,,,99.0,,,,,,,,,,,,,,,,,,,,,,,,,,,,,,,,,,,,136.33,,,3.53,,APPROVED,Male,43.0,FALSE
1124,2022-03-22 03:02:53,19,en,290347282,2022-03-22 02:57:07,2022-03-22 03:02:53,Y,Y,A1,,,14,,,,,,,,,,,,,,,,,,,,,,,,,,,,,,,,,0,3.0,4.0,6.0,4.0,7.0,6.0,6.0,6.0,3.0,4.0,6.0,5.0,6.0,6.0,3.0,5.0,3.0,5.0,5.0,2.0,5.0,6.0,7.0,4.0,6.0,6.0,5.0,3.0,4.0,4.0,7.0,2.0,8,,,,,,,,,,,,,,,,,,,,,,,,,,,,,,,,,11,,,,,,,,,,,,,,,,,,,,,,,,,,,,,,,,,10,,,,,,,,,,,,,,,,,,,,,,,,,,,,,,,,,13,,,,,,,,,,,,,,,,,,,,,,,,,,,,,,,,,6,,,,,,,,,,,,,,,,,,,,,,,,,,,,,,,,,2,2.0,4.0,1.0,3.0,2.0,1.0,2.0,1.0,3.0,2.0,2.0,1.0,1.0,1.0,1.0,3.0,1.0,1.0,1.0,2.0,3.0,2.0,2.0,1.0,1.0,1.0,7.0,2.0,1.0,1.0,1.0,7.0,7,,,,,,,,,,,,,,,,,,,,,,,,,,,,,,,,,4,,,,,,,,,,,,,,,,,,,,,,,,,,,,,,,,,12,,,,,,,,,,,,,,,,,,,,,,,,,,,,,,,,,5,,,,,,,,,,,,,,,,,,,,,,,,,,,,,,,,,3,,,,,,,,,,,,,,,,,,,,,,,,,,,,,,,,,1,4.0,7.0,5.0,5.0,4.0,5.0,4.0,6.0,4.0,5.0,6.0,6.0,3.0,4.0,4.0,4.0,6.0,6.0,4.0,4.0,3.0,5.0,4.0,4.0,5.0,6.0,3.0,3.0,4.0,4.0,2.0,7.0,9,,,,,,,,,,,,,,,,,,,,,,,,,,,,,,,,,,349.58,13.8,,,,109.2,,37.11,,,,,89.95,,,,,,,,,,,,,,,,,,45.66,,,,,,,,,,,,,,,,,,50.91,,,,,,2.95,,APPROVED,Male,22.0,FALSE
1125,2022-03-22 03:05:05,19,en,363098828,2022-03-22 02:57:07,2022-03-22 03:05:05,Y,Y,A1,,,2,2.0,7.0,6.0,3.0,7.0,4.0,6.0,3.0,7.0,3.0,4.0,4.0,4.0,7.0,7.0,2.0,7.0,3.0,3.0,4.0,3.0,4.0,2.0,4.0,6.0,3.0,4.0,6.0,5.0,4.0,3.0,1.0,3,,,,,,,,,,,,,,,,,,,,,,,,,,,,,,,,,1,6.0,7.0,7.0,7.0,7.0,7.0,2.0,7.0,7.0,6.0,5.0,7.0,6.0,6.0,7.0,7.0,7.0,6.0,7.0,7.0,6.0,6.0,6.0,7.0,7.0,5.0,3.0,7.0,4.0,6.0,7.0,1.0,8,,,,,,,,,,,,,,,,,,,,,,,,,,,,,,,,,9,,,,,,,,,,,,,,,,,,,,,,,,,,,,,,,,,6,,,,,,,,,,,,,,,,,,,,,,,,,,,,,,,,,13,,,,,,,,,,,,,,,,,,,,,,,,,,,,,,,,,4,,,,,,,,,,,,,,,,,,,,,,,,,,,,,,,,,12,,,,,,,,,,,,,,,,,,,,,,,,,,,,,,,,,5,,,,,,,,,,,,,,,,,,,,,,,,,,,,,,,,,10,,,,,,,,,,,,,,,,,,,,,,,,,,,,,,,,,14,,,,,,,,,,,,,,,,,,,,,,,,,,,,,,,,,7,,,,,,,,,,,,,,,,,,,,,,,,,,,,,,,,,11,,,,,,,,,,,,,,,,,,,,,,,,,,,,,,,,,0,5.0,7.0,6.0,3.0,7.0,4.0,6.0,3.0,5.0,4.0,6.0,5.0,5.0,6.0,7.0,4.0,7.0,4.0,5.0,5.0,4.0,5.0,4.0,5.0,7.0,6.0,4.0,5.0,6.0,4.0,3.0,1.0,,481.1,20.77,,,,8.5,,57.11,,108.51,,,,,,174.32,,,,,,,,,,,,,,,,,,,,,,,,,,,,,,,,,,,,106.14,,,5.75,,APPROVED,Male,21.0,FALSE
1126,2022-03-22 03:04:05,19,en,1634373667,2022-03-22 02:57:10,2022-03-22 03:04:05,Y,Y,A1,,,10,,,,,,,,,,,,,,,,,,,,,,,,,,,,,,,,,5,,,,,,,,,,,,,,,,,,,,,,,,,,,,,,,,,9,,,,,,,,,,,,,,,,,,,,,,,,,,,,,,,,,12,,,,,,,,,,,,,,,,,,,,,,,,,,,,,,,,,14,,,,,,,,,,,,,,,,,,,,,,,,,,,,,,,,,0,3.0,2.0,3.0,3.0,3.0,5.0,4.0,2.0,3.0,3.0,2.0,2.0,3.0,2.0,3.0,3.0,2.0,3.0,3.0,2.0,3.0,3.0,5.0,3.0,3.0,6.0,2.0,3.0,2.0,4.0,4.0,6.0,8,,,,,,,,,,,,,,,,,,,,,,,,,,,,,,,,,7,,,,,,,,,,,,,,,,,,,,,,,,,,,,,,,,,11,,,,,,,,,,,,,,,,,,,,,,,,,,,,,,,,,4,,,,,,,,,,,,,,,,,,,,,,,,,,,,,,,,,1,4.0,5.0,3.0,3.0,3.0,4.0,4.0,5.0,5.0,3.0,3.0,2.0,3.0,4.0,4.0,4.0,4.0,3.0,4.0,3.0,4.0,5.0,3.0,3.0,3.0,3.0,4.0,4.0,3.0,3.0,3.0,4.0,6,,,,,,,,,,,,,,,,,,,,,,,,,,,,,,,,,2,3.0,4.0,2.0,3.0,3.0,5.0,5.0,4.0,4.0,2.0,2.0,2.0,2.0,2.0,3.0,4.0,2.0,2.0,3.0,1.0,3.0,3.0,4.0,3.0,2.0,5.0,2.0,3.0,4.0,4.0,2.0,6.0,13,,,,,,,,,,,,,,,,,,,,,,,,,,,,,,,,,3,,,,,,,,,,,,,,,,,,,,,,,,,,,,,,,,,,418.41,69.71,,,,7.27,,33.77,,,,,,,,,,,,,,,,,114.07,,,,,,,,,,,,,,,97.5,,,,,,91.35,,,,,,,,,4.74,,APPROVED,Female,25.0,FALSE
1127,2022-03-22 03:00:31,19,en,51320632,2022-03-22 02:57:10,2022-03-22 03:00:31,Y,Y,A1,,,3,,,,,,,,,,,,,,,,,,,,,,,,,,,,,,,,,9,,,,,,,,,,,,,,,,,,,,,,,,,,,,,,,,,10,,,,,,,,,,,,,,,,,,,,,,,,,,,,,,,,,1,1.0,2.0,4.0,1.0,2.0,1.0,1.0,4.0,4.0,1.0,2.0,2.0,2.0,3.0,4.0,2.0,5.0,2.0,1.0,2.0,1.0,2.0,2.0,1.0,1.0,4.0,4.0,1.0,4.0,2.0,2.0,4.0,5,,,,,,,,,,,,,,,,,,,,,,,,,,,,,,,,,8,,,,,,,,,,,,,,,,,,,,,,,,,,,,,,,,,0,1.0,2.0,1.0,1.0,1.0,1.0,1.0,4.0,4.0,1.0,1.0,1.0,1.0,1.0,1.0,1.0,3.0,1.0,1.0,1.0,1.0,1.0,1.0,1.0,1.0,2.0,1.0,1.0,1.0,1.0,1.0,7.0,4,,,,,,,,,,,,,,,,,,,,,,,,,,,,,,,,,12,,,,,,,,,,,,,,,,,,,,,,,,,,,,,,,,,13,,,,,,,,,,,,,,,,,,,,,,,,,,,,,,,,,7,,,,,,,,,,,,,,,,,,,,,,,,,,,,,,,,,14,,,,,,,,,,,,,,,,,,,,,,,,,,,,,,,,,2,4.0,4.0,4.0,3.0,4.0,5.0,4.0,6.0,5.0,4.0,5.0,5.0,4.0,4.0,4.0,4.0,5.0,4.0,4.0,3.0,4.0,4.0,4.0,3.0,4.0,4.0,4.0,4.0,4.0,2.0,5.0,6.0,6,,,,,,,,,,,,,,,,,,,,,,,,,,,,,,,,,11,,,,,,,,,,,,,,,,,,,,,,,,,,,,,,,,,all good,204.15,13.68,,,,9.13,,14.41,,,,,,,,,,,54.28,,,,,,,,,53.3,,,,,,,,,,,,,,,,,,48.72,,,,,,,,,10.63,,APPROVED,Male,20.0,FALSE
1128,2022-03-22 03:03:13,19,en,1820925982,2022-03-22 02:57:11,2022-03-22 03:03:13,Y,Y,-oth-,High School Diploma,,13,,,,,,,,,,,,,,,,,,,,,,,,,,,,,,,,,14,,,,,,,,,,,,,,,,,,,,,,,,,,,,,,,,,11,,,,,,,,,,,,,,,,,,,,,,,,,,,,,,,,,4,,,,,,,,,,,,,,,,,,,,,,,,,,,,,,,,,3,,,,,,,,,,,,,,,,,,,,,,,,,,,,,,,,,2,7.0,6.0,6.0,5.0,5.0,6.0,4.0,7.0,7.0,6.0,6.0,6.0,6.0,5.0,5.0,5.0,6.0,5.0,6.0,6.0,5.0,6.0,4.0,6.0,6.0,5.0,5.0,6.0,5.0,4.0,5.0,6.0,6,,,,,,,,,,,,,,,,,,,,,,,,,,,,,,,,,7,,,,,,,,,,,,,,,,,,,,,,,,,,,,,,,,,5,,,,,,,,,,,,,,,,,,,,,,,,,,,,,,,,,1,3.0,2.0,1.0,3.0,1.0,3.0,5.0,4.0,2.0,2.0,3.0,2.0,2.0,3.0,3.0,3.0,3.0,2.0,3.0,3.0,3.0,3.0,3.0,2.0,3.0,4.0,4.0,3.0,5.0,4.0,4.0,3.0,9,,,,,,,,,,,,,,,,,,,,,,,,,,,,,,,,,10,,,,,,,,,,,,,,,,,,,,,,,,,,,,,,,,,0,4.0,4.0,4.0,4.0,3.0,5.0,5.0,3.0,6.0,3.0,4.0,4.0,6.0,4.0,4.0,4.0,5.0,4.0,4.0,2.0,4.0,4.0,4.0,4.0,4.0,4.0,5.0,5.0,6.0,4.0,4.0,6.0,8,,,,,,,,,,,,,,,,,,,,,,,,,,,,,,,,,12,,,,,,,,,,,,,,,,,,,,,,,,,,,,,,,,,,363.52,14.56,,,,29.68,,24.99,,,,,,,,,,,,,,,,,80.57,,,,,,,,,,,,108.01,,,,,,,,,100.65,,,,,,,,,5.06,,APPROVED,Male,19.0,FALSE
1129,2022-03-22 03:03:54,19,en,1218146013,2022-03-22 02:57:14,2022-03-22 03:03:54,Y,Y,-oth-,high school,,8,,,,,,,,,,,,,,,,,,,,,,,,,,,,,,,,,1,5.0,3.0,5.0,4.0,3.0,4.0,4.0,6.0,2.0,3.0,4.0,3.0,4.0,4.0,4.0,5.0,5.0,3.0,4.0,3.0,3.0,4.0,5.0,4.0,3.0,4.0,4.0,3.0,3.0,4.0,5.0,2.0,3,,,,,,,,,,,,,,,,,,,,,,,,,,,,,,,,,4,,,,,,,,,,,,,,,,,,,,,,,,,,,,,,,,,7,,,,,,,,,,,,,,,,,,,,,,,,,,,,,,,,,11,,,,,,,,,,,,,,,,,,,,,,,,,,,,,,,,,13,,,,,,,,,,,,,,,,,,,,,,,,,,,,,,,,,12,,,,,,,,,,,,,,,,,,,,,,,,,,,,,,,,,6,,,,,,,,,,,,,,,,,,,,,,,,,,,,,,,,,2,2.0,5.0,1.0,1.0,5.0,2.0,7.0,1.0,4.0,1.0,1.0,5.0,1.0,5.0,2.0,1.0,5.0,1.0,1.0,1.0,1.0,2.0,1.0,1.0,1.0,4.0,6.0,1.0,1.0,1.0,1.0,3.0,0,2.0,5.0,2.0,5.0,2.0,5.0,2.0,6.0,4.0,2.0,2.0,3.0,3.0,2.0,4.0,5.0,4.0,3.0,2.0,2.0,2.0,4.0,5.0,2.0,2.0,4.0,3.0,2.0,2.0,4.0,4.0,4.0,14,,,,,,,,,,,,,,,,,,,,,,,,,,,,,,,,,5,,,,,,,,,,,,,,,,,,,,,,,,,,,,,,,,,10,,,,,,,,,,,,,,,,,,,,,,,,,,,,,,,,,9,,,,,,,,,,,,,,,,,,,,,,,,,,,,,,,,,,402.63,21.09,,,,25.19,,66.1,,,,,112.78,,,,,,,,,,,,,,,,,,,,,,,,71.38,,,101.5,,,,,,,,,,,,,,,4.59,,APPROVED,Female,34.0,FALSE
1130,2022-03-22 03:03:15,19,en,672572322,2022-03-22 02:57:19,2022-03-22 03:03:15,Y,Y,A1,,,5,,,,,,,,,,,,,,,,,,,,,,,,,,,,,,,,,3,,,,,,,,,,,,,,,,,,,,,,,,,,,,,,,,,14,,,,,,,,,,,,,,,,,,,,,,,,,,,,,,,,,13,,,,,,,,,,,,,,,,,,,,,,,,,,,,,,,,,1,6.0,2.0,6.0,6.0,4.0,6.0,5.0,6.0,3.0,4.0,4.0,3.0,5.0,2.0,3.0,5.0,4.0,4.0,5.0,3.0,4.0,5.0,6.0,4.0,4.0,7.0,3.0,3.0,2.0,5.0,7.0,5.0,12,,,,,,,,,,,,,,,,,,,,,,,,,,,,,,,,,4,,,,,,,,,,,,,,,,,,,,,,,,,,,,,,,,,0,3.0,1.0,2.0,5.0,2.0,4.0,6.0,5.0,5.0,2.0,2.0,5.0,5.0,4.0,3.0,3.0,5.0,4.0,6.0,3.0,1.0,5.0,3.0,3.0,2.0,1.0,4.0,4.0,2.0,4.0,3.0,1.0,11,,,,,,,,,,,,,,,,,,,,,,,,,,,,,,,,,9,,,,,,,,,,,,,,,,,,,,,,,,,,,,,,,,,8,,,,,,,,,,,,,,,,,,,,,,,,,,,,,,,,,7,,,,,,,,,,,,,,,,,,,,,,,,,,,,,,,,,2,4.0,2.0,5.0,6.0,2.0,5.0,6.0,6.0,3.0,3.0,6.0,3.0,4.0,1.0,2.0,4.0,4.0,3.0,4.0,2.0,2.0,5.0,5.0,4.0,3.0,5.0,4.0,6.0,2.0,5.0,5.0,6.0,6,,,,,,,,,,,,,,,,,,,,,,,,,,,,,,,,,10,,,,,,,,,,,,,,,,,,,,,,,,,,,,,,,,,,358.83,19.77,,,,5.3,,49.5,,,,,,,,,,,,,,77.2,,,,,,,,,133.18,,,,,,,,,,,,,,,71.2,,,,,,,,,2.68,,APPROVED,Male,28.0,FALSE
1131,2022-03-22 03:04:11,19,en,1225144473,2022-03-22 02:57:21,2022-03-22 03:04:11,Y,Y,A2,,,7,,,,,,,,,,,,,,,,,,,,,,,,,,,,,,,,,11,,,,,,,,,,,,,,,,,,,,,,,,,,,,,,,,,3,,,,,,,,,,,,,,,,,,,,,,,,,,,,,,,,,14,,,,,,,,,,,,,,,,,,,,,,,,,,,,,,,,,9,,,,,,,,,,,,,,,,,,,,,,,,,,,,,,,,,4,,,,,,,,,,,,,,,,,,,,,,,,,,,,,,,,,12,,,,,,,,,,,,,,,,,,,,,,,,,,,,,,,,,8,,,,,,,,,,,,,,,,,,,,,,,,,,,,,,,,,6,,,,,,,,,,,,,,,,,,,,,,,,,,,,,,,,,5,,,,,,,,,,,,,,,,,,,,,,,,,,,,,,,,,2,6.0,6.0,6.0,2.0,7.0,2.0,7.0,5.0,7.0,5.0,2.0,6.0,6.0,7.0,7.0,3.0,6.0,6.0,6.0,4.0,4.0,6.0,2.0,6.0,6.0,5.0,7.0,6.0,4.0,4.0,7.0,4.0,1,6.0,6.0,6.0,4.0,7.0,7.0,2.0,7.0,6.0,3.0,4.0,6.0,6.0,7.0,6.0,6.0,7.0,4.0,6.0,4.0,5.0,6.0,6.0,6.0,6.0,7.0,5.0,7.0,4.0,5.0,6.0,5.0,10,,,,,,,,,,,,,,,,,,,,,,,,,,,,,,,,,0,3.0,5.0,3.0,4.0,4.0,6.0,2.0,3.0,3.0,2.0,4.0,5.0,2.0,2.0,6.0,4.0,5.0,2.0,3.0,1.0,2.0,5.0,6.0,3.0,2.0,6.0,4.0,5.0,4.0,4.0,6.0,7.0,13,,,,,,,,,,,,,,,,,,,,,,,,,,,,,,,,,,413.17,59.64,,,,15.61,,35.02,,,,,,,,,,,,,,,,,,,,,,,,,,,,,,,,85.42,,,121.68,,,,,,91.25,,,,,,4.55,,APPROVED,Female,29.0,FALSE
1132,2022-03-22 03:05:58,19,en,1426465388,2022-03-22 02:57:23,2022-03-22 03:05:58,Y,Y,-oth-,Highschool degree,,2,3.0,4.0,2.0,1.0,1.0,1.0,6.0,1.0,4.0,2.0,1.0,3.0,2.0,4.0,2.0,1.0,5.0,2.0,1.0,2.0,1.0,2.0,1.0,2.0,1.0,1.0,1.0,1.0,1.0,2.0,4.0,1.0,4,,,,,,,,,,,,,,,,,,,,,,,,,,,,,,,,,12,,,,,,,,,,,,,,,,,,,,,,,,,,,,,,,,,8,,,,,,,,,,,,,,,,,,,,,,,,,,,,,,,,,3,,,,,,,,,,,,,,,,,,,,,,,,,,,,,,,,,11,,,,,,,,,,,,,,,,,,,,,,,,,,,,,,,,,6,,,,,,,,,,,,,,,,,,,,,,,,,,,,,,,,,5,,,,,,,,,,,,,,,,,,,,,,,,,,,,,,,,,10,,,,,,,,,,,,,,,,,,,,,,,,,,,,,,,,,14,,,,,,,,,,,,,,,,,,,,,,,,,,,,,,,,,0,5.0,7.0,6.0,6.0,6.0,2.0,3.0,5.0,7.0,6.0,4.0,5.0,6.0,4.0,5.0,3.0,5.0,6.0,6.0,5.0,4.0,5.0,2.0,6.0,6.0,3.0,5.0,6.0,4.0,6.0,5.0,4.0,7,,,,,,,,,,,,,,,,,,,,,,,,,,,,,,,,,1,5.0,3.0,3.0,3.0,4.0,2.0,5.0,2.0,4.0,3.0,4.0,5.0,3.0,4.0,3.0,3.0,5.0,3.0,5.0,5.0,2.0,4.0,4.0,3.0,4.0,3.0,3.0,3.0,4.0,4.0,4.0,6.0,13,,,,,,,,,,,,,,,,,,,,,,,,,,,,,,,,,9,,,,,,,,,,,,,,,,,,,,,,,,,,,,,,,,,,517.35,114.4,,,,54.48,,63.09,,82.45,,,,,,,,,,,,,,,,,,,,,,,,,,,,,,107.23,,,,,,91.52,,,,,,,,,4.18,,APPROVED,Female,19.0,FALSE
1133,2022-03-22 03:05:13,19,en,986857305,2022-03-22 02:57:26,2022-03-22 03:05:13,Y,Y,A1,,,7,,,,,,,,,,,,,,,,,,,,,,,,,,,,,,,,,13,,,,,,,,,,,,,,,,,,,,,,,,,,,,,,,,,5,,,,,,,,,,,,,,,,,,,,,,,,,,,,,,,,,9,,,,,,,,,,,,,,,,,,,,,,,,,,,,,,,,,6,,,,,,,,,,,,,,,,,,,,,,,,,,,,,,,,,8,,,,,,,,,,,,,,,,,,,,,,,,,,,,,,,,,3,,,,,,,,,,,,,,,,,,,,,,,,,,,,,,,,,2,6.0,6.0,5.0,5.0,4.0,5.0,3.0,5.0,5.0,5.0,3.0,6.0,6.0,5.0,5.0,5.0,6.0,4.0,5.0,3.0,4.0,5.0,5.0,5.0,4.0,4.0,5.0,5.0,3.0,4.0,4.0,3.0,1,5.0,5.0,5.0,5.0,4.0,3.0,5.0,3.0,6.0,4.0,3.0,5.0,5.0,5.0,5.0,4.0,6.0,4.0,6.0,4.0,3.0,4.0,5.0,4.0,5.0,4.0,5.0,5.0,3.0,4.0,4.0,2.0,14,,,,,,,,,,,,,,,,,,,,,,,,,,,,,,,,,11,,,,,,,,,,,,,,,,,,,,,,,,,,,,,,,,,0,4.0,5.0,4.0,4.0,4.0,3.0,5.0,6.0,5.0,2.0,2.0,4.0,4.0,2.0,3.0,5.0,4.0,2.0,4.0,3.0,3.0,4.0,4.0,4.0,5.0,4.0,4.0,4.0,3.0,3.0,4.0,5.0,10,,,,,,,,,,,,,,,,,,,,,,,,,,,,,,,,,4,,,,,,,,,,,,,,,,,,,,,,,,,,,,,,,,,12,,,,,,,,,,,,,,,,,,,,,,,,,,,,,,,,,,469.85,118.71,,,,12.11,,40.62,,,,,,,,,,,,,,,,,,,,,,,80.04,,,92.47,,,,,,,,,123.3,,,,,,,,,,,,2.6,,APPROVED,Female,33.0,FALSE
1134,2022-03-22 03:01:50,19,en,1118942884,2022-03-22 02:57:27,2022-03-22 03:01:50,Y,Y,A1,,,0,2.0,6.0,3.0,3.0,3.0,2.0,6.0,4.0,6.0,3.0,3.0,4.0,2.0,3.0,3.0,3.0,5.0,2.0,2.0,2.0,4.0,2.0,1.0,1.0,3.0,1.0,3.0,2.0,4.0,3.0,1.0,1.0,12,,,,,,,,,,,,,,,,,,,,,,,,,,,,,,,,,1,7.0,7.0,6.0,7.0,7.0,6.0,2.0,7.0,5.0,5.0,7.0,5.0,6.0,5.0,6.0,7.0,5.0,6.0,6.0,6.0,4.0,7.0,7.0,6.0,6.0,6.0,4.0,6.0,6.0,6.0,7.0,3.0,8,,,,,,,,,,,,,,,,,,,,,,,,,,,,,,,,,11,,,,,,,,,,,,,,,,,,,,,,,,,,,,,,,,,14,,,,,,,,,,,,,,,,,,,,,,,,,,,,,,,,,13,,,,,,,,,,,,,,,,,,,,,,,,,,,,,,,,,7,,,,,,,,,,,,,,,,,,,,,,,,,,,,,,,,,3,,,,,,,,,,,,,,,,,,,,,,,,,,,,,,,,,4,,,,,,,,,,,,,,,,,,,,,,,,,,,,,,,,,10,,,,,,,,,,,,,,,,,,,,,,,,,,,,,,,,,6,,,,,,,,,,,,,,,,,,,,,,,,,,,,,,,,,5,,,,,,,,,,,,,,,,,,,,,,,,,,,,,,,,,9,,,,,,,,,,,,,,,,,,,,,,,,,,,,,,,,,2,5.0,7.0,7.0,4.0,6.0,4.0,5.0,3.0,6.0,5.0,6.0,6.0,6.0,4.0,5.0,2.0,6.0,5.0,6.0,6.0,5.0,6.0,2.0,6.0,6.0,4.0,6.0,6.0,5.0,4.0,2.0,1.0,,267.62,16.39,,,,13.31,,27.34,,68.67,,,,,,65.9,,,,,,,,,,,,,,,,,,,,,,,,,,,,,,,,,,,,72.07,,,3.94,,APPROVED,Male,26.0,FALSE
1135,2022-03-22 03:10:45,19,en,1470574503,2022-03-22 02:57:29,2022-03-22 03:10:45,Y,Y,A1,,,4,,,,,,,,,,,,,,,,,,,,,,,,,,,,,,,,,12,,,,,,,,,,,,,,,,,,,,,,,,,,,,,,,,,1,5.0,2.0,5.0,3.0,4.0,7.0,1.0,6.0,2.0,4.0,5.0,5.0,5.0,6.0,5.0,5.0,3.0,5.0,5.0,3.0,5.0,6.0,3.0,6.0,5.0,5.0,5.0,6.0,7.0,4.0,5.0,3.0,6,,,,,,,,,,,,,,,,,,,,,,,,,,,,,,,,,0,6.0,7.0,7.0,6.0,7.0,1.0,4.0,3.0,7.0,5.0,6.0,4.0,6.0,6.0,6.0,2.0,7.0,4.0,6.0,4.0,6.0,6.0,3.0,4.0,6.0,3.0,4.0,6.0,1.0,4.0,3.0,5.0,5,,,,,,,,,,,,,,,,,,,,,,,,,,,,,,,,,3,,,,,,,,,,,,,,,,,,,,,,,,,,,,,,,,,13,,,,,,,,,,,,,,,,,,,,,,,,,,,,,,,,,11,,,,,,,,,,,,,,,,,,,,,,,,,,,,,,,,,8,,,,,,,,,,,,,,,,,,,,,,,,,,,,,,,,,2,5.0,5.0,5.0,1.0,2.0,3.0,7.0,6.0,6.0,4.0,1.0,1.0,3.0,1.0,2.0,5.0,7.0,5.0,1.0,4.0,4.0,3.0,2.0,4.0,1.0,2.0,6.0,1.0,1.0,1.0,1.0,4.0,10,,,,,,,,,,,,,,,,,,,,,,,,,,,,,,,,,9,,,,,,,,,,,,,,,,,,,,,,,,,,,,,,,,,7,,,,,,,,,,,,,,,,,,,,,,,,,,,,,,,,,14,,,,,,,,,,,,,,,,,,,,,,,,,,,,,,,,,,799.94,166.31,,,,35.56,,92.46,,,,,,,,162.03,,,,,,217.67,,,,,,,,,,,,,,,,,,121.67,,,,,,,,,,,,,,,4.24,,APPROVED,Male,20.0,FALSE
1136,2022-03-22 03:28:31,19,en,1983362891,2022-03-22 02:57:30,2022-03-22 03:28:31,Y,Y,A2,,,13,,,,,,,,,,,,,,,,,,,,,,,,,,,,,,,,,7,,,,,,,,,,,,,,,,,,,,,,,,,,,,,,,,,9,,,,,,,,,,,,,,,,,,,,,,,,,,,,,,,,,1,2.0,2.0,2.0,2.0,2.0,2.0,6.0,2.0,6.0,3.0,5.0,2.0,2.0,2.0,2.0,2.0,2.0,6.0,2.0,2.0,2.0,2.0,3.0,2.0,2.0,2.0,2.0,2.0,2.0,5.0,2.0,4.0,3,,,,,,,,,,,,,,,,,,,,,,,,,,,,,,,,,5,,,,,,,,,,,,,,,,,,,,,,,,,,,,,,,,,10,,,,,,,,,,,,,,,,,,,,,,,,,,,,,,,,,11,,,,,,,,,,,,,,,,,,,,,,,,,,,,,,,,,1,2.0,4.0,4.0,3.0,2.0,3.0,2.0,5.0,5.0,5.0,4.0,2.0,3.0,4.0,4.0,4.0,2.0,4.0,2.0,2.0,3.0,3.0,2.0,2.0,2.0,5.0,2.0,4.0,5.0,5.0,4.0,2.0,14,,,,,,,,,,,,,,,,,,,,,,,,,,,,,,,,,12,,,,,,,,,,,,,,,,,,,,,,,,,,,,,,,,,2,2.0,2.0,3.0,3.0,2.0,2.0,2.0,3.0,2.0,2.0,2.0,2.0,3.0,2.0,3.0,3.0,2.0,2.0,2.0,2.0,2.0,2.0,2.0,2.0,3.0,2.0,5.0,2.0,3.0,2.0,2.0,5.0,8,,,,,,,,,,,,,,,,,,,,,,,,,,,,,,,,,6,,,,,,,,,,,,,,,,,,,,,,,,,,,,,,,,,4,,,,,,,,,,,,,,,,,,,,,,,,,,,,,,,,,,1867.22,1737.72,,,,6.17,,8.46,,,,,,,,,,,36.62,,,,,,,,,,,,,,,46.61,,,,,,,,,28.75,,,,,,,,,,,,2.89,,APPROVED,Male,29.0,FALSE
1138,2022-03-22 03:11:16,19,en,549113575,2022-03-22 02:57:32,2022-03-22 03:11:16,Y,Y,A1,,,6,,,,,,,,,,,,,,,,,,,,,,,,,,,,,,,,,10,,,,,,,,,,,,,,,,,,,,,,,,,,,,,,,,,3,,,,,,,,,,,,,,,,,,,,,,,,,,,,,,,,,4,,,,,,,,,,,,,,,,,,,,,,,,,,,,,,,,,11,,,,,,,,,,,,,,,,,,,,,,,,,,,,,,,,,14,,,,,,,,,,,,,,,,,,,,,,,,,,,,,,,,,2,4.0,4.0,7.0,3.0,6.0,2.0,3.0,3.0,6.0,5.0,7.0,7.0,6.0,7.0,7.0,6.0,7.0,2.0,6.0,2.0,3.0,3.0,6.0,3.0,3.0,6.0,6.0,5.0,3.0,3.0,3.0,7.0,1,6.0,7.0,5.0,3.0,4.0,2.0,3.0,4.0,7.0,7.0,2.0,7.0,6.0,7.0,5.0,5.0,7.0,7.0,4.0,5.0,4.0,6.0,3.0,6.0,4.0,2.0,7.0,5.0,3.0,6.0,3.0,1.0,12,,,,,,,,,,,,,,,,,,,,,,,,,,,,,,,,,0,5.0,7.0,5.0,3.0,2.0,4.0,3.0,2.0,4.0,2.0,2.0,5.0,2.0,6.0,5.0,3.0,5.0,2.0,6.0,4.0,4.0,4.0,2.0,6.0,5.0,4.0,5.0,2.0,6.0,6.0,3.0,3.0,5,,,,,,,,,,,,,,,,,,,,,,,,,,,,,,,,,9,,,,,,,,,,,,,,,,,,,,,,,,,,,,,,,,,8,,,,,,,,,,,,,,,,,,,,,,,,,,,,,,,,,7,,,,,,,,,,,,,,,,,,,,,,,,,,,,,,,,,13,,,,,,,,,,,,,,,,,,,,,,,,,,,,,,,,,,828.42,32.4,,,,5.77,,58.57,,,,,,,,,,,,,,,,,,,,44.51,,,44.68,,,,,,267.5,,,,,,,,,,,,,,,,,,374.99,,APPROVED,Male,31.0,FALSE
1139,2022-03-22 03:06:03,19,en,2082589876,2022-03-22 02:57:34,2022-03-22 03:06:03,Y,Y,A1,,,13,,,,,,,,,,,,,,,,,,,,,,,,,,,,,,,,,9,,,,,,,,,,,,,,,,,,,,,,,,,,,,,,,,,3,,,,,,,,,,,,,,,,,,,,,,,,,,,,,,,,,10,,,,,,,,,,,,,,,,,,,,,,,,,,,,,,,,,12,,,,,,,,,,,,,,,,,,,,,,,,,,,,,,,,,11,,,,,,,,,,,,,,,,,,,,,,,,,,,,,,,,,0,1.0,6.0,3.0,5.0,4.0,1.0,5.0,7.0,6.0,4.0,1.0,5.0,3.0,3.0,4.0,3.0,2.0,5.0,1.0,4.0,3.0,2.0,1.0,1.0,5.0,2.0,5.0,1.0,5.0,1.0,6.0,7.0,5,,,,,,,,,,,,,,,,,,,,,,,,,,,,,,,,,7,,,,,,,,,,,,,,,,,,,,,,,,,,,,,,,,,8,,,,,,,,,,,,,,,,,,,,,,,,,,,,,,,,,4,,,,,,,,,,,,,,,,,,,,,,,,,,,,,,,,,6,,,,,,,,,,,,,,,,,,,,,,,,,,,,,,,,,1,6.0,6.0,7.0,6.0,5.0,7.0,6.0,5.0,6.0,6.0,7.0,7.0,5.0,6.0,6.0,7.0,6.0,6.0,7.0,6.0,6.0,7.0,7.0,6.0,6.0,7.0,6.0,6.0,7.0,6.0,7.0,6.0,2,5.0,6.0,6.0,6.0,6.0,7.0,6.0,6.0,7.0,5.0,7.0,6.0,6.0,6.0,5.0,5.0,7.0,5.0,7.0,5.0,6.0,6.0,5.0,5.0,5.0,7.0,5.0,5.0,7.0,5.0,7.0,7.0,14,,,,,,,,,,,,,,,,,,,,,,,,,,,,,,,,,,512.11,105.7,,,,7.28,,48.02,,,,,,,,,,,,,,,,,,,,134.96,,,,,,,,,,,,,,,,,,92.93,,,119.35,,,,,,3.87,,APPROVED,Male,24.0,FALSE
1140,2022-03-22 03:01:40,19,en,452308329,2022-03-22 02:57:34,2022-03-22 03:01:40,Y,Y,A1,,,13,,,,,,,,,,,,,,,,,,,,,,,,,,,,,,,,,6,,,,,,,,,,,,,,,,,,,,,,,,,,,,,,,,,1,5.0,6.0,5.0,6.0,5.0,6.0,2.0,6.0,6.0,5.0,5.0,5.0,5.0,4.0,5.0,5.0,6.0,5.0,5.0,5.0,4.0,5.0,5.0,5.0,5.0,5.0,4.0,5.0,5.0,5.0,5.0,3.0,10,,,,,,,,,,,,,,,,,,,,,,,,,,,,,,,,,3,,,,,,,,,,,,,,,,,,,,,,,,,,,,,,,,,2,4.0,5.0,4.0,4.0,5.0,4.0,6.0,5.0,6.0,4.0,3.0,3.0,5.0,4.0,5.0,5.0,5.0,3.0,5.0,4.0,3.0,4.0,3.0,5.0,6.0,4.0,3.0,5.0,4.0,5.0,4.0,6.0,0,6.0,6.0,6.0,6.0,6.0,5.0,2.0,6.0,6.0,4.0,3.0,6.0,6.0,5.0,6.0,6.0,6.0,6.0,6.0,5.0,5.0,6.0,5.0,6.0,6.0,4.0,4.0,6.0,3.0,6.0,6.0,7.0,4,,,,,,,,,,,,,,,,,,,,,,,,,,,,,,,,,7,,,,,,,,,,,,,,,,,,,,,,,,,,,,,,,,,14,,,,,,,,,,,,,,,,,,,,,,,,,,,,,,,,,12,,,,,,,,,,,,,,,,,,,,,,,,,,,,,,,,,5,,,,,,,,,,,,,,,,,,,,,,,,,,,,,,,,,9,,,,,,,,,,,,,,,,,,,,,,,,,,,,,,,,,8,,,,,,,,,,,,,,,,,,,,,,,,,,,,,,,,,11,,,,,,,,,,,,,,,,,,,,,,,,,,,,,,,,,,247.82,12.07,,,,3.27,,23.71,,,,,,,,72.81,,,,,,,,,68.56,,,64.04,,,,,,,,,,,,,,,,,,,,,,,,,,,3.36,,APPROVED,Female,47.0,FALSE
1141,2022-03-22 03:03:47,19,en,588110561,2022-03-22 02:57:34,2022-03-22 03:03:47,Y,Y,A1,,,2,5.0,6.0,5.0,2.0,6.0,2.0,5.0,5.0,5.0,5.0,3.0,3.0,5.0,5.0,5.0,5.0,5.0,4.0,4.0,4.0,2.0,4.0,3.0,5.0,4.0,4.0,4.0,5.0,5.0,5.0,4.0,1.0,10,,,,,,,,,,,,,,,,,,,,,,,,,,,,,,,,,5,,,,,,,,,,,,,,,,,,,,,,,,,,,,,,,,,7,,,,,,,,,,,,,,,,,,,,,,,,,,,,,,,,,13,,,,,,,,,,,,,,,,,,,,,,,,,,,,,,,,,4,,,,,,,,,,,,,,,,,,,,,,,,,,,,,,,,,6,,,,,,,,,,,,,,,,,,,,,,,,,,,,,,,,,14,,,,,,,,,,,,,,,,,,,,,,,,,,,,,,,,,9,,,,,,,,,,,,,,,,,,,,,,,,,,,,,,,,,0,2.0,4.0,1.0,1.0,4.0,1.0,6.0,4.0,5.0,2.0,1.0,2.0,2.0,1.0,5.0,1.0,5.0,1.0,2.0,1.0,1.0,2.0,2.0,3.0,2.0,2.0,4.0,1.0,1.0,2.0,3.0,3.0,3,,,,,,,,,,,,,,,,,,,,,,,,,,,,,,,,,11,,,,,,,,,,,,,,,,,,,,,,,,,,,,,,,,,12,,,,,,,,,,,,,,,,,,,,,,,,,,,,,,,,,1,4.0,5.0,4.0,4.0,4.0,5.0,4.0,6.0,5.0,4.0,3.0,6.0,4.0,5.0,6.0,5.0,6.0,4.0,4.0,4.0,4.0,4.0,5.0,4.0,4.0,5.0,5.0,5.0,4.0,4.0,5.0,7.0,8,,,,,,,,,,,,,,,,,,,,,,,,,,,,,,,,,,375.97,60.41,,,,6.72,,54.29,,84.76,,,,,,,,,,,,,,,,,,,,,,,,,,,86.01,,,,,,,,,,,,78.35,,,,,,5.43,,APPROVED,Female,28.0,FALSE
1142,2022-03-22 03:00:31,19,en,2051471953,2022-03-22 02:57:36,2022-03-22 03:00:31,Y,Y,A1,,,7,,,,,,,,,,,,,,,,,,,,,,,,,,,,,,,,,3,,,,,,,,,,,,,,,,,,,,,,,,,,,,,,,,,10,,,,,,,,,,,,,,,,,,,,,,,,,,,,,,,,,6,,,,,,,,,,,,,,,,,,,,,,,,,,,,,,,,,5,,,,,,,,,,,,,,,,,,,,,,,,,,,,,,,,,14,,,,,,,,,,,,,,,,,,,,,,,,,,,,,,,,,0,1.0,6.0,1.0,1.0,1.0,1.0,1.0,1.0,6.0,1.0,1.0,1.0,1.0,1.0,3.0,1.0,6.0,1.0,1.0,1.0,1.0,1.0,1.0,1.0,1.0,1.0,5.0,1.0,1.0,1.0,1.0,7.0,4,,,,,,,,,,,,,,,,,,,,,,,,,,,,,,,,,11,,,,,,,,,,,,,,,,,,,,,,,,,,,,,,,,,13,,,,,,,,,,,,,,,,,,,,,,,,,,,,,,,,,12,,,,,,,,,,,,,,,,,,,,,,,,,,,,,,,,,2,1.0,2.0,2.0,1.0,2.0,2.0,1.0,4.0,3.0,2.0,1.0,1.0,1.0,1.0,5.0,1.0,1.0,1.0,1.0,1.0,1.0,1.0,1.0,1.0,2.0,1.0,1.0,3.0,3.0,1.0,1.0,5.0,9,,,,,,,,,,,,,,,,,,,,,,,,,,,,,,,,,8,,,,,,,,,,,,,,,,,,,,,,,,,,,,,,,,,1,1.0,1.0,4.0,1.0,1.0,4.0,1.0,1.0,6.0,1.0,4.0,1.0,1.0,1.0,1.0,1.0,6.0,1.0,1.0,1.0,1.0,1.0,1.0,1.0,1.0,1.0,1.0,1.0,1.0,1.0,1.0,1.0,,177.95,9.44,,,,12.19,,15.89,,,,,,,,,,,,,,,,,,,,52.24,,,,,,,,,,,,,,,53.07,,,,,,,,,32.57,,,2.55,,APPROVED,Male,32.0,FALSE
1143,2022-03-22 03:07:10,19,en,1587965470,2022-03-22 02:57:38,2022-03-22 03:07:10,Y,Y,-oth-,high school diploma,,6,,,,,,,,,,,,,,,,,,,,,,,,,,,,,,,,,9,,,,,,,,,,,,,,,,,,,,,,,,,,,,,,,,,5,,,,,,,,,,,,,,,,,,,,,,,,,,,,,,,,,14,,,,,,,,,,,,,,,,,,,,,,,,,,,,,,,,,12,,,,,,,,,,,,,,,,,,,,,,,,,,,,,,,,,8,,,,,,,,,,,,,,,,,,,,,,,,,,,,,,,,,13,,,,,,,,,,,,,,,,,,,,,,,,,,,,,,,,,7,,,,,,,,,,,,,,,,,,,,,,,,,,,,,,,,,10,,,,,,,,,,,,,,,,,,,,,,,,,,,,,,,,,0,3.0,5.0,2.0,3.0,2.0,2.0,7.0,1.0,4.0,2.0,3.0,2.0,3.0,2.0,2.0,2.0,5.0,2.0,2.0,2.0,3.0,3.0,2.0,3.0,2.0,4.0,4.0,3.0,3.0,3.0,3.0,3.0,1,5.0,5.0,4.0,4.0,3.0,5.0,4.0,5.0,5.0,4.0,3.0,3.0,4.0,4.0,4.0,3.0,5.0,3.0,4.0,4.0,3.0,5.0,4.0,4.0,4.0,5.0,3.0,4.0,4.0,4.0,4.0,4.0,4,,,,,,,,,,,,,,,,,,,,,,,,,,,,,,,,,11,,,,,,,,,,,,,,,,,,,,,,,,,,,,,,,,,3,,,,,,,,,,,,,,,,,,,,,,,,,,,,,,,,,2,4.0,5.0,3.0,4.0,4.0,4.0,5.0,5.0,5.0,3.0,5.0,4.0,4.0,3.0,5.0,4.0,5.0,4.0,4.0,3.0,4.0,5.0,4.0,4.0,3.0,5.0,5.0,3.0,4.0,3.0,3.0,1.0,,575.79,58.44,,,,76.28,,60.68,,,,,,,,,,,,,,,,,,,,,,,,,,,,,110.87,,,98.5,,,,,,,,,,,,145.64,,,25.38,,APPROVED,Male,55.0,FALSE
1144,2022-03-22 03:03:17,19,en,170353971,2022-03-22 02:57:39,2022-03-22 03:03:17,Y,Y,A1,,,0,4.0,5.0,4.0,2.0,4.0,3.0,4.0,4.0,5.0,4.0,2.0,4.0,4.0,5.0,5.0,3.0,5.0,3.0,4.0,4.0,3.0,4.0,2.0,4.0,3.0,3.0,4.0,4.0,2.0,4.0,4.0,1.0,13,,,,,,,,,,,,,,,,,,,,,,,,,,,,,,,,,7,,,,,,,,,,,,,,,,,,,,,,,,,,,,,,,,,6,,,,,,,,,,,,,,,,,,,,,,,,,,,,,,,,,1,4.0,4.0,4.0,4.0,4.0,4.0,4.0,4.0,4.0,4.0,4.0,5.0,4.0,4.0,4.0,4.0,5.0,4.0,4.0,4.0,4.0,4.0,4.0,4.0,3.0,4.0,5.0,4.0,4.0,4.0,4.0,5.0,2,4.0,4.0,4.0,4.0,4.0,3.0,4.0,5.0,5.0,4.0,4.0,5.0,4.0,4.0,4.0,4.0,5.0,4.0,4.0,4.0,4.0,4.0,4.0,4.0,4.0,4.0,4.0,4.0,3.0,5.0,4.0,6.0,12,,,,,,,,,,,,,,,,,,,,,,,,,,,,,,,,,4,,,,,,,,,,,,,,,,,,,,,,,,,,,,,,,,,8,,,,,,,,,,,,,,,,,,,,,,,,,,,,,,,,,11,,,,,,,,,,,,,,,,,,,,,,,,,,,,,,,,,9,,,,,,,,,,,,,,,,,,,,,,,,,,,,,,,,,3,,,,,,,,,,,,,,,,,,,,,,,,,,,,,,,,,10,,,,,,,,,,,,,,,,,,,,,,,,,,,,,,,,,5,,,,,,,,,,,,,,,,,,,,,,,,,,,,,,,,,14,,,,,,,,,,,,,,,,,,,,,,,,,,,,,,,,,,340.79,169.07,,,,5.49,,24.39,,51.46,,,,,,,,,,,,40.96,,,46.55,,,,,,,,,,,,,,,,,,,,,,,,,,,,,,2.87,,APPROVED,Female,20.0,FALSE
1145,2022-03-22 03:00:11,19,en,2040440034,2022-03-22 02:57:40,2022-03-22 03:00:11,Y,Y,A1,,,4,,,,,,,,,,,,,,,,,,,,,,,,,,,,,,,,,12,,,,,,,,,,,,,,,,,,,,,,,,,,,,,,,,,1,6.0,6.0,5.0,6.0,5.0,5.0,3.0,6.0,5.0,5.0,6.0,5.0,5.0,5.0,5.0,5.0,6.0,5.0,5.0,5.0,6.0,5.0,5.0,6.0,5.0,5.0,4.0,6.0,6.0,6.0,5.0,3.0,11,,,,,,,,,,,,,,,,,,,,,,,,,,,,,,,,,3,,,,,,,,,,,,,,,,,,,,,,,,,,,,,,,,,5,,,,,,,,,,,,,,,,,,,,,,,,,,,,,,,,,6,,,,,,,,,,,,,,,,,,,,,,,,,,,,,,,,,13,,,,,,,,,,,,,,,,,,,,,,,,,,,,,,,,,8,,,,,,,,,,,,,,,,,,,,,,,,,,,,,,,,,9,,,,,,,,,,,,,,,,,,,,,,,,,,,,,,,,,7,,,,,,,,,,,,,,,,,,,,,,,,,,,,,,,,,14,,,,,,,,,,,,,,,,,,,,,,,,,,,,,,,,,0,3.0,4.0,3.0,2.0,3.0,2.0,5.0,4.0,5.0,3.0,2.0,3.0,3.0,3.0,3.0,3.0,3.0,3.0,3.0,3.0,3.0,3.0,3.0,3.0,3.0,3.0,3.0,3.0,3.0,2.0,3.0,6.0,10,,,,,,,,,,,,,,,,,,,,,,,,,,,,,,,,,2,1.0,1.0,1.0,1.0,2.0,1.0,7.0,1.0,2.0,1.0,1.0,1.0,1.0,1.0,1.0,1.0,1.0,1.0,1.0,1.0,1.0,1.0,1.0,1.0,1.0,1.0,1.0,1.0,1.0,1.0,1.0,1.0,,153.3,14.68,,,,5.96,,10.04,,,,,,,,32.61,,,,,,,,,,,,,,,,,,,,,,,,,,,,,,40.68,,,,,,45.58,,,3.75,,APPROVED,Male,41.0,FALSE
1146,2022-03-22 03:05:01,19,en,1455291659,2022-03-22 02:57:40,2022-03-22 03:05:01,Y,Y,A1,,,2,6.0,7.0,6.0,3.0,6.0,1.0,7.0,5.0,5.0,4.0,5.0,6.0,4.0,4.0,6.0,3.0,7.0,3.0,3.0,5.0,2.0,3.0,1.0,6.0,5.0,2.0,6.0,3.0,6.0,5.0,2.0,1.0,3,,,,,,,,,,,,,,,,,,,,,,,,,,,,,,,,,5,,,,,,,,,,,,,,,,,,,,,,,,,,,,,,,,,7,,,,,,,,,,,,,,,,,,,,,,,,,,,,,,,,,6,,,,,,,,,,,,,,,,,,,,,,,,,,,,,,,,,8,,,,,,,,,,,,,,,,,,,,,,,,,,,,,,,,,9,,,,,,,,,,,,,,,,,,,,,,,,,,,,,,,,,4,,,,,,,,,,,,,,,,,,,,,,,,,,,,,,,,,12,,,,,,,,,,,,,,,,,,,,,,,,,,,,,,,,,13,,,,,,,,,,,,,,,,,,,,,,,,,,,,,,,,,11,,,,,,,,,,,,,,,,,,,,,,,,,,,,,,,,,10,,,,,,,,,,,,,,,,,,,,,,,,,,,,,,,,,14,,,,,,,,,,,,,,,,,,,,,,,,,,,,,,,,,1,5.0,5.0,2.0,6.0,2.0,6.0,3.0,6.0,4.0,3.0,4.0,3.0,3.0,4.0,5.0,5.0,5.0,2.0,5.0,3.0,2.0,4.0,7.0,5.0,2.0,5.0,3.0,3.0,3.0,5.0,5.0,7.0,0,4.0,5.0,4.0,4.0,3.0,4.0,6.0,6.0,5.0,3.0,6.0,4.0,2.0,5.0,5.0,4.0,5.0,4.0,4.0,4.0,3.0,4.0,3.0,3.0,6.0,6.0,5.0,4.0,5.0,6.0,4.0,1.0,,443.14,18.81,,,,8.89,,40.34,,140.27,,,,,,,,,,,,,,,,,,,,,,,,,,,,,,,,,,,,,,,102.08,,,128.98,,,3.77,,APPROVED,Male,24.0,FALSE
1147,2022-03-22 03:03:41,19,en,1565830582,2022-03-22 02:57:44,2022-03-22 03:03:41,Y,Y,A1,,,7,,,,,,,,,,,,,,,,,,,,,,,,,,,,,,,,,2,4.0,3.0,4.0,4.0,4.0,5.0,4.0,5.0,3.0,4.0,4.0,4.0,4.0,4.0,3.0,4.0,5.0,4.0,4.0,4.0,4.0,4.0,6.0,4.0,4.0,5.0,4.0,4.0,5.0,5.0,4.0,2.0,9,,,,,,,,,,,,,,,,,,,,,,,,,,,,,,,,,11,,,,,,,,,,,,,,,,,,,,,,,,,,,,,,,,,4,,,,,,,,,,,,,,,,,,,,,,,,,,,,,,,,,6,,,,,,,,,,,,,,,,,,,,,,,,,,,,,,,,,1,6.0,6.0,6.0,6.0,6.0,6.0,4.0,6.0,6.0,5.0,5.0,6.0,6.0,5.0,5.0,6.0,6.0,6.0,6.0,5.0,4.0,6.0,6.0,6.0,6.0,6.0,5.0,6.0,6.0,6.0,6.0,7.0,8,,,,,,,,,,,,,,,,,,,,,,,,,,,,,,,,,3,,,,,,,,,,,,,,,,,,,,,,,,,,,,,,,,,0,5.0,6.0,5.0,5.0,5.0,5.0,5.0,6.0,6.0,4.0,5.0,5.0,5.0,5.0,5.0,4.0,5.0,5.0,5.0,5.0,4.0,5.0,5.0,5.0,5.0,5.0,5.0,5.0,5.0,5.0,5.0,3.0,14,,,,,,,,,,,,,,,,,,,,,,,,,,,,,,,,,5,,,,,,,,,,,,,,,,,,,,,,,,,,,,,,,,,12,,,,,,,,,,,,,,,,,,,,,,,,,,,,,,,,,13,,,,,,,,,,,,,,,,,,,,,,,,,,,,,,,,,10,,,,,,,,,,,,,,,,,,,,,,,,,,,,,,,,,none,359.43,63.71,,,,6.7,,58.22,,,,,74.34,,,,,,,,,,,,,,,71.8,,,,,,,,,78.5,,,,,,,,,,,,,,,,,,6.16,,APPROVED,Male,34.0,FALSE
1148,2022-03-22 03:11:25,19,en,1195777986,2022-03-22 02:57:45,2022-03-22 03:11:25,Y,Y,A2,,,12,,,,,,,,,,,,,,,,,,,,,,,,,,,,,,,,,10,,,,,,,,,,,,,,,,,,,,,,,,,,,,,,,,,4,,,,,,,,,,,,,,,,,,,,,,,,,,,,,,,,,6,,,,,,,,,,,,,,,,,,,,,,,,,,,,,,,,,14,,,,,,,,,,,,,,,,,,,,,,,,,,,,,,,,,9,,,,,,,,,,,,,,,,,,,,,,,,,,,,,,,,,5,,,,,,,,,,,,,,,,,,,,,,,,,,,,,,,,,13,,,,,,,,,,,,,,,,,,,,,,,,,,,,,,,,,8,,,,,,,,,,,,,,,,,,,,,,,,,,,,,,,,,2,5.0,5.0,5.0,6.0,4.0,3.0,5.0,5.0,5.0,4.0,3.0,5.0,4.0,6.0,5.0,2.0,4.0,4.0,5.0,3.0,4.0,4.0,6.0,4.0,3.0,6.0,7.0,5.0,7.0,4.0,5.0,3.0,3,,,,,,,,,,,,,,,,,,,,,,,,,,,,,,,,,0,7.0,7.0,6.0,6.0,7.0,4.0,2.0,7.0,6.0,7.0,6.0,5.0,6.0,4.0,7.0,7.0,7.0,6.0,6.0,5.0,6.0,6.0,6.0,6.0,6.0,7.0,4.0,6.0,6.0,6.0,6.0,5.0,7,,,,,,,,,,,,,,,,,,,,,,,,,,,,,,,,,1,4.0,4.0,4.0,4.0,2.0,6.0,5.0,4.0,2.0,2.0,4.0,4.0,3.0,3.0,5.0,4.0,5.0,2.0,4.0,2.0,4.0,4.0,6.0,3.0,3.0,7.0,5.0,4.0,5.0,4.0,5.0,7.0,11,,,,,,,,,,,,,,,,,,,,,,,,,,,,,,,,,,824.91,25.72,,,,7.88,,91.94,,,,,,,,,,,,,,,,,,,,,,,,,,,,,390.27,,,,,,199.37,,,,,,104.87,,,,,,4.86,,APPROVED,Male,53.0,FALSE
1149,2022-03-22 03:04:39,19,en,431594315,2022-03-22 02:57:49,2022-03-22 03:04:39,Y,Y,A1,,,2,6.0,6.0,4.0,4.0,5.0,5.0,2.0,6.0,6.0,4.0,3.0,5.0,5.0,6.0,6.0,2.0,5.0,5.0,5.0,2.0,2.0,5.0,4.0,4.0,5.0,4.0,2.0,5.0,2.0,6.0,4.0,1.0,5,,,,,,,,,,,,,,,,,,,,,,,,,,,,,,,,,14,,,,,,,,,,,,,,,,,,,,,,,,,,,,,,,,,0,4.0,6.0,3.0,5.0,3.0,5.0,2.0,7.0,6.0,5.0,2.0,5.0,5.0,5.0,5.0,6.0,6.0,2.0,5.0,4.0,4.0,4.0,4.0,3.0,3.0,4.0,5.0,4.0,4.0,4.0,5.0,4.0,1,2.0,2.0,1.0,1.0,2.0,1.0,6.0,2.0,2.0,2.0,1.0,3.0,2.0,1.0,2.0,2.0,2.0,4.0,2.0,2.0,2.0,2.0,1.0,2.0,1.0,2.0,2.0,2.0,1.0,2.0,2.0,5.0,3,,,,,,,,,,,,,,,,,,,,,,,,,,,,,,,,,8,,,,,,,,,,,,,,,,,,,,,,,,,,,,,,,,,12,,,,,,,,,,,,,,,,,,,,,,,,,,,,,,,,,7,,,,,,,,,,,,,,,,,,,,,,,,,,,,,,,,,4,,,,,,,,,,,,,,,,,,,,,,,,,,,,,,,,,11,,,,,,,,,,,,,,,,,,,,,,,,,,,,,,,,,13,,,,,,,,,,,,,,,,,,,,,,,,,,,,,,,,,6,,,,,,,,,,,,,,,,,,,,,,,,,,,,,,,,,10,,,,,,,,,,,,,,,,,,,,,,,,,,,,,,,,,9,,,,,,,,,,,,,,,,,,,,,,,,,,,,,,,,,,412.09,20.3,,,,7.99,,40.07,,96.46,,,,,,,,,134.51,,,109.34,,,,,,,,,,,,,,,,,,,,,,,,,,,,,,,,,3.42,,APPROVED,Male,28.0,FALSE
1150,2022-03-22 03:00:27,19,en,576969503,2022-03-22 02:57:55,2022-03-22 03:00:27,Y,Y,A2,,,8,,,,,,,,,,,,,,,,,,,,,,,,,,,,,,,,,12,,,,,,,,,,,,,,,,,,,,,,,,,,,,,,,,,5,,,,,,,,,,,,,,,,,,,,,,,,,,,,,,,,,4,,,,,,,,,,,,,,,,,,,,,,,,,,,,,,,,,13,,,,,,,,,,,,,,,,,,,,,,,,,,,,,,,,,14,,,,,,,,,,,,,,,,,,,,,,,,,,,,,,,,,3,,,,,,,,,,,,,,,,,,,,,,,,,,,,,,,,,6,,,,,,,,,,,,,,,,,,,,,,,,,,,,,,,,,10,,,,,,,,,,,,,,,,,,,,,,,,,,,,,,,,,0,2.0,3.0,2.0,5.0,2.0,1.0,6.0,4.0,4.0,2.0,3.0,2.0,2.0,2.0,3.0,3.0,3.0,2.0,2.0,2.0,3.0,2.0,1.0,2.0,3.0,2.0,5.0,2.0,2.0,2.0,2.0,3.0,2,5.0,5.0,6.0,6.0,5.0,4.0,5.0,5.0,5.0,6.0,5.0,5.0,5.0,6.0,6.0,4.0,5.0,6.0,5.0,4.0,5.0,5.0,5.0,5.0,4.0,5.0,5.0,6.0,4.0,6.0,4.0,4.0,9,,,,,,,,,,,,,,,,,,,,,,,,,,,,,,,,,11,,,,,,,,,,,,,,,,,,,,,,,,,,,,,,,,,7,,,,,,,,,,,,,,,,,,,,,,,,,,,,,,,,,1,6.0,5.0,6.0,5.0,6.0,5.0,2.0,7.0,5.0,5.0,5.0,5.0,5.0,6.0,5.0,4.0,5.0,6.0,5.0,6.0,6.0,6.0,5.0,6.0,5.0,6.0,4.0,6.0,5.0,6.0,5.0,1.0,,153.18,11.94,,,,12.1,,16.24,,,,,,,,,,,,,,,,,,,,,,,,,,,,,39.44,,,38.28,,,,,,,,,,,,32.54,,,2.64,,APPROVED,Male,34.0,FALSE
1151,2022-03-22 03:03:21,19,en,1094552907,2022-03-22 02:57:55,2022-03-22 03:03:21,Y,Y,A1,,,0,5.0,6.0,5.0,4.0,5.0,2.0,7.0,4.0,4.0,2.0,3.0,5.0,5.0,5.0,5.0,5.0,7.0,4.0,5.0,5.0,2.0,5.0,2.0,4.0,6.0,5.0,6.0,3.0,5.0,4.0,4.0,1.0,5,,,,,,,,,,,,,,,,,,,,,,,,,,,,,,,,,13,,,,,,,,,,,,,,,,,,,,,,,,,,,,,,,,,4,,,,,,,,,,,,,,,,,,,,,,,,,,,,,,,,,2,7.0,4.0,7.0,7.0,6.0,7.0,4.0,7.0,6.0,6.0,6.0,7.0,7.0,7.0,6.0,7.0,7.0,7.0,7.0,6.0,7.0,7.0,7.0,7.0,5.0,7.0,5.0,7.0,5.0,7.0,7.0,5.0,14,,,,,,,,,,,,,,,,,,,,,,,,,,,,,,,,,1,4.0,5.0,4.0,5.0,4.0,6.0,3.0,7.0,5.0,4.0,4.0,5.0,5.0,5.0,5.0,4.0,6.0,3.0,5.0,4.0,4.0,4.0,4.0,4.0,4.0,5.0,3.0,5.0,5.0,4.0,4.0,7.0,8,,,,,,,,,,,,,,,,,,,,,,,,,,,,,,,,,7,,,,,,,,,,,,,,,,,,,,,,,,,,,,,,,,,10,,,,,,,,,,,,,,,,,,,,,,,,,,,,,,,,,9,,,,,,,,,,,,,,,,,,,,,,,,,,,,,,,,,3,,,,,,,,,,,,,,,,,,,,,,,,,,,,,,,,,6,,,,,,,,,,,,,,,,,,,,,,,,,,,,,,,,,11,,,,,,,,,,,,,,,,,,,,,,,,,,,,,,,,,12,,,,,,,,,,,,,,,,,,,,,,,,,,,,,,,,,,327.84,19.57,,,,7.28,,25.82,,104.58,,,,,,,,,,,,72.13,,,,,,93.81,,,,,,,,,,,,,,,,,,,,,,,,,,,4.65,,APPROVED,Female,47.0,FALSE
1152,2022-03-22 03:17:45,19,en,151792528,2022-03-22 02:57:56,2022-03-22 03:17:45,Y,Y,A1,,,14,,,,,,,,,,,,,,,,,,,,,,,,,,,,,,,,,4,,,,,,,,,,,,,,,,,,,,,,,,,,,,,,,,,1,5.0,7.0,5.0,7.0,5.0,7.0,2.0,7.0,7.0,5.0,6.0,7.0,6.0,6.0,7.0,6.0,7.0,5.0,5.0,5.0,4.0,5.0,7.0,6.0,6.0,7.0,7.0,6.0,7.0,6.0,7.0,3.0,9,,,,,,,,,,,,,,,,,,,,,,,,,,,,,,,,,10,,,,,,,,,,,,,,,,,,,,,,,,,,,,,,,,,3,,,,,,,,,,,,,,,,,,,,,,,,,,,,,,,,,12,,,,,,,,,,,,,,,,,,,,,,,,,,,,,,,,,13,,,,,,,,,,,,,,,,,,,,,,,,,,,,,,,,,8,,,,,,,,,,,,,,,,,,,,,,,,,,,,,,,,,7,,,,,,,,,,,,,,,,,,,,,,,,,,,,,,,,,5,,,,,,,,,,,,,,,,,,,,,,,,,,,,,,,,,0,7.0,7.0,7.0,5.0,7.0,7.0,1.0,7.0,7.0,7.0,7.0,7.0,7.0,7.0,7.0,7.0,7.0,7.0,7.0,7.0,5.0,7.0,5.0,7.0,7.0,7.0,7.0,7.0,7.0,7.0,6.0,5.0,6,,,,,,,,,,,,,,,,,,,,,,,,,,,,,,,,,2,1.0,6.0,1.0,6.0,1.0,5.0,2.0,7.0,7.0,1.0,4.0,5.0,1.0,1.0,5.0,4.0,5.0,2.0,1.0,1.0,2.0,1.0,7.0,1.0,1.0,7.0,6.0,1.0,6.0,5.0,7.0,7.0,11,,,,,,,,,,,,,,,,,,,,,,,,,,,,,,,,,Thank you,1192.39,345.45,,,,9.87,,222.45,,,,,,,,218.3,,,,,,,,,,,,,,,,,,,,,,,,,,,163.27,,,,,,216.12,,,,,,16.93,,APPROVED,Female,33.0,FALSE
1153,2022-03-22 03:11:05,19,en,1385400481,2022-03-22 02:57:57,2022-03-22 03:11:05,Y,Y,A1,,,1,6.0,7.0,6.0,5.0,6.0,6.0,6.0,6.0,4.0,5.0,6.0,5.0,5.0,7.0,6.0,5.0,7.0,7.0,6.0,4.0,6.0,6.0,6.0,6.0,6.0,6.0,4.0,6.0,5.0,5.0,6.0,1.0,3,,,,,,,,,,,,,,,,,,,,,,,,,,,,,,,,,12,,,,,,,,,,,,,,,,,,,,,,,,,,,,,,,,,4,,,,,,,,,,,,,,,,,,,,,,,,,,,,,,,,,7,,,,,,,,,,,,,,,,,,,,,,,,,,,,,,,,,14,,,,,,,,,,,,,,,,,,,,,,,,,,,,,,,,,6,,,,,,,,,,,,,,,,,,,,,,,,,,,,,,,,,9,,,,,,,,,,,,,,,,,,,,,,,,,,,,,,,,,13,,,,,,,,,,,,,,,,,,,,,,,,,,,,,,,,,0,4.0,2.0,3.0,2.0,2.0,3.0,6.0,1.0,2.0,4.0,2.0,3.0,4.0,4.0,5.0,1.0,2.0,2.0,4.0,2.0,2.0,2.0,3.0,2.0,3.0,2.0,6.0,3.0,3.0,3.0,3.0,3.0,8,,,,,,,,,,,,,,,,,,,,,,,,,,,,,,,,,11,,,,,,,,,,,,,,,,,,,,,,,,,,,,,,,,,2,6.0,6.0,5.0,7.0,6.0,7.0,2.0,6.0,5.0,5.0,6.0,6.0,5.0,6.0,5.0,6.0,5.0,6.0,6.0,4.0,6.0,6.0,7.0,6.0,6.0,7.0,2.0,7.0,5.0,6.0,6.0,6.0,5,,,,,,,,,,,,,,,,,,,,,,,,,,,,,,,,,10,,,,,,,,,,,,,,,,,,,,,,,,,,,,,,,,,,792.41,129.95,,,,8.44,,176.42,,185.78,,,,,,,,,,,,,,,,,,,,,,,,,,,177.56,,,,,,,,,102.94,,,,,,,,,11.32,,APPROVED,Male,28.0,FALSE
1154,2022-03-22 03:05:24,19,en,1857971326,2022-03-22 02:57:57,2022-03-22 03:05:24,Y,Y,A1,,,1,6.0,6.0,6.0,6.0,5.0,6.0,4.0,5.0,6.0,6.0,5.0,6.0,6.0,5.0,5.0,5.0,6.0,6.0,6.0,6.0,6.0,6.0,4.0,6.0,5.0,6.0,4.0,6.0,6.0,5.0,6.0,1.0,14,,,,,,,,,,,,,,,,,,,,,,,,,,,,,,,,,3,,,,,,,,,,,,,,,,,,,,,,,,,,,,,,,,,2,5.0,4.0,5.0,5.0,4.0,5.0,6.0,3.0,6.0,4.0,4.0,5.0,5.0,5.0,5.0,5.0,5.0,5.0,5.0,5.0,4.0,5.0,6.0,5.0,5.0,6.0,4.0,5.0,7.0,4.0,4.0,4.0,12,,,,,,,,,,,,,,,,,,,,,,,,,,,,,,,,,8,,,,,,,,,,,,,,,,,,,,,,,,,,,,,,,,,11,,,,,,,,,,,,,,,,,,,,,,,,,,,,,,,,,5,,,,,,,,,,,,,,,,,,,,,,,,,,,,,,,,,0,3.0,3.0,3.0,4.0,3.0,4.0,4.0,4.0,4.0,3.0,3.0,3.0,3.0,2.0,3.0,5.0,4.0,3.0,4.0,3.0,3.0,4.0,4.0,4.0,3.0,4.0,4.0,4.0,4.0,4.0,3.0,2.0,10,,,,,,,,,,,,,,,,,,,,,,,,,,,,,,,,,6,,,,,,,,,,,,,,,,,,,,,,,,,,,,,,,,,9,,,,,,,,,,,,,,,,,,,,,,,,,,,,,,,,,4,,,,,,,,,,,,,,,,,,,,,,,,,,,,,,,,,7,,,,,,,,,,,,,,,,,,,,,,,,,,,,,,,,,13,,,,,,,,,,,,,,,,,,,,,,,,,,,,,,,,,,449.21,50.73,,,,9.32,,38.63,,87.02,,,,,,,,,108.54,,,,,,,,,,,,,,,150.35,,,,,,,,,,,,,,,,,,,,,4.62,,APPROVED,Male,25.0,FALSE
1155,2022-03-22 03:09:35,19,en,539156258,2022-03-22 02:57:58,2022-03-22 03:09:35,Y,Y,A1,,,11,,,,,,,,,,,,,,,,,,,,,,,,,,,,,,,,,14,,,,,,,,,,,,,,,,,,,,,,,,,,,,,,,,,2,5.0,5.0,6.0,3.0,6.0,5.0,4.0,6.0,7.0,6.0,5.0,5.0,5.0,5.0,5.0,6.0,5.0,5.0,6.0,5.0,4.0,5.0,5.0,5.0,6.0,4.0,4.0,5.0,6.0,5.0,5.0,3.0,7,,,,,,,,,,,,,,,,,,,,,,,,,,,,,,,,,9,,,,,,,,,,,,,,,,,,,,,,,,,,,,,,,,,3,,,,,,,,,,,,,,,,,,,,,,,,,,,,,,,,,5,,,,,,,,,,,,,,,,,,,,,,,,,,,,,,,,,1,5.0,7.0,5.0,5.0,6.0,5.0,6.0,4.0,6.0,4.0,3.0,5.0,4.0,5.0,5.0,5.0,5.0,3.0,4.0,5.0,3.0,5.0,5.0,5.0,5.0,3.0,2.0,4.0,3.0,5.0,3.0,1.0,8,,,,,,,,,,,,,,,,,,,,,,,,,,,,,,,,,10,,,,,,,,,,,,,,,,,,,,,,,,,,,,,,,,,13,,,,,,,,,,,,,,,,,,,,,,,,,,,,,,,,,4,,,,,,,,,,,,,,,,,,,,,,,,,,,,,,,,,0,4.0,5.0,4.0,3.0,6.0,3.0,7.0,1.0,7.0,4.0,5.0,5.0,3.0,4.0,5.0,6.0,5.0,4.0,2.0,4.0,3.0,5.0,2.0,3.0,5.0,2.0,3.0,4.0,5.0,4.0,2.0,6.0,6,,,,,,,,,,,,,,,,,,,,,,,,,,,,,,,,,12,,,,,,,,,,,,,,,,,,,,,,,,,,,,,,,,,,700.26,23.7,,,,16.46,,99.38,,,,,,,,72.62,,,,,,,,,,,,,,,352.62,,,,,,,,,,,,,,,131.24,,,,,,,,,4.24,,APPROVED,Male,25.0,FALSE
1156,2022-03-22 03:02:08,19,en,2105212511,2022-03-22 02:57:59,2022-03-22 03:02:08,Y,Y,A2,,,0,1.0,2.0,1.0,1.0,1.0,1.0,7.0,2.0,1.0,1.0,1.0,1.0,1.0,1.0,2.0,1.0,3.0,1.0,1.0,1.0,1.0,1.0,1.0,1.0,1.0,1.0,4.0,2.0,1.0,6.0,1.0,1.0,3,,,,,,,,,,,,,,,,,,,,,,,,,,,,,,,,,5,,,,,,,,,,,,,,,,,,,,,,,,,,,,,,,,,2,3.0,2.0,2.0,2.0,2.0,3.0,4.0,5.0,5.0,5.0,2.0,5.0,3.0,4.0,5.0,4.0,5.0,3.0,3.0,1.0,4.0,3.0,5.0,5.0,2.0,3.0,5.0,5.0,4.0,2.0,3.0,4.0,12,,,,,,,,,,,,,,,,,,,,,,,,,,,,,,,,,8,,,,,,,,,,,,,,,,,,,,,,,,,,,,,,,,,7,,,,,,,,,,,,,,,,,,,,,,,,,,,,,,,,,11,,,,,,,,,,,,,,,,,,,,,,,,,,,,,,,,,9,,,,,,,,,,,,,,,,,,,,,,,,,,,,,,,,,14,,,,,,,,,,,,,,,,,,,,,,,,,,,,,,,,,13,,,,,,,,,,,,,,,,,,,,,,,,,,,,,,,,,6,,,,,,,,,,,,,,,,,,,,,,,,,,,,,,,,,1,1.0,2.0,1.0,1.0,1.0,1.0,5.0,1.0,2.0,1.0,1.0,1.0,1.0,3.0,1.0,1.0,1.0,2.0,2.0,1.0,2.0,1.0,1.0,1.0,1.0,2.0,1.0,1.0,1.0,1.0,1.0,6.0,4,,,,,,,,,,,,,,,,,,,,,,,,,,,,,,,,,10,,,,,,,,,,,,,,,,,,,,,,,,,,,,,,,,,,251.33,29.59,,,,12.13,,37.03,,67.53,,,,,,,,,57.15,,,,,,,,,,,,,,,,,,,,,,,,,,,44.68,,,,,,,,,3.22,,APPROVED,Female,29.0,FALSE
1157,2022-03-22 03:04:17,19,en,650833089,2022-03-22 02:58:00,2022-03-22 03:04:17,Y,Y,A1,,,1,5.0,6.0,5.0,4.0,4.0,4.0,4.0,5.0,5.0,4.0,5.0,5.0,4.0,4.0,5.0,5.0,5.0,5.0,5.0,3.0,4.0,4.0,4.0,4.0,5.0,4.0,3.0,5.0,5.0,4.0,5.0,1.0,14,,,,,,,,,,,,,,,,,,,,,,,,,,,,,,,,,8,,,,,,,,,,,,,,,,,,,,,,,,,,,,,,,,,5,,,,,,,,,,,,,,,,,,,,,,,,,,,,,,,,,10,,,,,,,,,,,,,,,,,,,,,,,,,,,,,,,,,9,,,,,,,,,,,,,,,,,,,,,,,,,,,,,,,,,13,,,,,,,,,,,,,,,,,,,,,,,,,,,,,,,,,0,2.0,4.0,3.0,3.0,2.0,1.0,6.0,3.0,3.0,3.0,1.0,4.0,3.0,4.0,5.0,1.0,5.0,2.0,3.0,2.0,4.0,3.0,4.0,2.0,3.0,1.0,5.0,3.0,1.0,3.0,2.0,1.0,12,,,,,,,,,,,,,,,,,,,,,,,,,,,,,,,,,3,,,,,,,,,,,,,,,,,,,,,,,,,,,,,,,,,11,,,,,,,,,,,,,,,,,,,,,,,,,,,,,,,,,7,,,,,,,,,,,,,,,,,,,,,,,,,,,,,,,,,2,7.0,6.0,7.0,5.0,7.0,6.0,3.0,5.0,6.0,6.0,7.0,6.0,7.0,6.0,7.0,6.0,6.0,6.0,6.0,6.0,6.0,6.0,6.0,6.0,7.0,6.0,2.0,7.0,7.0,6.0,7.0,6.0,6,,,,,,,,,,,,,,,,,,,,,,,,,,,,,,,,,4,,,,,,,,,,,,,,,,,,,,,,,,,,,,,,,,,,370.52,12.17,,,,9.03,,44.29,,101.51,,,,,,,,,,,,,,,,,,,,,126.59,,,,,,,,,,,,,,,71.25,,,,,,,,,5.68,,APPROVED,Male,29.0,FALSE
1158,2022-03-22 03:07:55,19,en,359631166,2022-03-22 02:58:05,2022-03-22 03:07:55,Y,Y,A1,,,7,,,,,,,,,,,,,,,,,,,,,,,,,,,,,,,,,12,,,,,,,,,,,,,,,,,,,,,,,,,,,,,,,,,9,,,,,,,,,,,,,,,,,,,,,,,,,,,,,,,,,5,,,,,,,,,,,,,,,,,,,,,,,,,,,,,,,,,8,,,,,,,,,,,,,,,,,,,,,,,,,,,,,,,,,2,5.0,5.0,4.0,4.0,4.0,2.0,4.0,5.0,6.0,4.0,4.0,4.0,5.0,4.0,6.0,4.0,6.0,4.0,4.0,3.0,4.0,5.0,4.0,6.0,4.0,3.0,2.0,5.0,6.0,3.0,4.0,6.0,10,,,,,,,,,,,,,,,,,,,,,,,,,,,,,,,,,14,,,,,,,,,,,,,,,,,,,,,,,,,,,,,,,,,6,,,,,,,,,,,,,,,,,,,,,,,,,,,,,,,,,11,,,,,,,,,,,,,,,,,,,,,,,,,,,,,,,,,0,5.0,7.0,6.0,4.0,7.0,4.0,5.0,6.0,7.0,5.0,5.0,6.0,5.0,5.0,6.0,6.0,7.0,6.0,6.0,5.0,6.0,7.0,2.0,6.0,5.0,6.0,2.0,6.0,7.0,6.0,6.0,4.0,13,,,,,,,,,,,,,,,,,,,,,,,,,,,,,,,,,3,,,,,,,,,,,,,,,,,,,,,,,,,,,,,,,,,4,,,,,,,,,,,,,,,,,,,,,,,,,,,,,,,,,1,2.0,5.0,2.0,2.0,3.0,1.0,7.0,2.0,4.0,2.0,3.0,2.0,3.0,1.0,2.0,3.0,3.0,2.0,3.0,2.0,2.0,2.0,2.0,2.0,2.0,3.0,4.0,2.0,2.0,3.0,1.0,1.0,,592.96,64.12,,,,5.91,,87.43,,,,,,,,,,,,,,,,,130.5,,,,,,,,,,,,,,,162.77,,,,,,,,,,,,138.39,,,3.84,,APPROVED,Male,45.0,FALSE
1159,2022-03-22 03:07:12,19,en,1402704096,2022-03-22 02:58:08,2022-03-22 03:07:12,Y,Y,A1,,,4,,,,,,,,,,,,,,,,,,,,,,,,,,,,,,,,,3,,,,,,,,,,,,,,,,,,,,,,,,,,,,,,,,,13,,,,,,,,,,,,,,,,,,,,,,,,,,,,,,,,,14,,,,,,,,,,,,,,,,,,,,,,,,,,,,,,,,,0,3.0,6.0,4.0,1.0,5.0,1.0,7.0,3.0,6.0,2.0,2.0,2.0,2.0,4.0,6.0,2.0,5.0,2.0,4.0,4.0,3.0,4.0,1.0,2.0,6.0,1.0,5.0,3.0,1.0,2.0,1.0,5.0,11,,,,,,,,,,,,,,,,,,,,,,,,,,,,,,,,,9,,,,,,,,,,,,,,,,,,,,,,,,,,,,,,,,,12,,,,,,,,,,,,,,,,,,,,,,,,,,,,,,,,,5,,,,,,,,,,,,,,,,,,,,,,,,,,,,,,,,,1,5.0,4.0,5.0,2.0,6.0,1.0,6.0,2.0,5.0,4.0,2.0,2.0,4.0,4.0,5.0,2.0,6.0,2.0,4.0,4.0,4.0,4.0,2.0,4.0,6.0,2.0,5.0,3.0,2.0,4.0,2.0,3.0,2,2.0,3.0,2.0,3.0,3.0,4.0,5.0,5.0,3.0,3.0,2.0,3.0,2.0,2.0,5.0,2.0,5.0,2.0,2.0,3.0,2.0,2.0,3.0,2.0,3.0,4.0,5.0,2.0,4.0,2.0,3.0,4.0,10,,,,,,,,,,,,,,,,,,,,,,,,,,,,,,,,,6,,,,,,,,,,,,,,,,,,,,,,,,,,,,,,,,,8,,,,,,,,,,,,,,,,,,,,,,,,,,,,,,,,,7,,,,,,,,,,,,,,,,,,,,,,,,,,,,,,,,,,547.13,145.3,,,,14.79,,60.2,,,,,,,,,,,,,,120.15,,,,,,,,,,,,,,,96.86,,,104.34,,,,,,,,,,,,,,,5.49,,APPROVED,Female,21.0,FALSE
1160,2022-03-22 03:05:03,19,en,1660558864,2022-03-22 02:58:08,2022-03-22 03:05:03,Y,Y,A1,,,0,4.0,7.0,7.0,6.0,7.0,7.0,2.0,7.0,6.0,6.0,4.0,7.0,7.0,6.0,7.0,4.0,7.0,6.0,4.0,7.0,4.0,6.0,6.0,7.0,4.0,4.0,4.0,7.0,4.0,4.0,4.0,1.0,1,5.0,4.0,4.0,6.0,4.0,6.0,3.0,5.0,5.0,5.0,4.0,4.0,4.0,4.0,4.0,5.0,5.0,5.0,5.0,5.0,4.0,6.0,6.0,4.0,4.0,6.0,3.0,6.0,4.0,4.0,5.0,2.0,12,,,,,,,,,,,,,,,,,,,,,,,,,,,,,,,,,6,,,,,,,,,,,,,,,,,,,,,,,,,,,,,,,,,7,,,,,,,,,,,,,,,,,,,,,,,,,,,,,,,,,4,,,,,,,,,,,,,,,,,,,,,,,,,,,,,,,,,10,,,,,,,,,,,,,,,,,,,,,,,,,,,,,,,,,14,,,,,,,,,,,,,,,,,,,,,,,,,,,,,,,,,11,,,,,,,,,,,,,,,,,,,,,,,,,,,,,,,,,2,2.0,2.0,2.0,2.0,2.0,2.0,5.0,2.0,2.0,2.0,2.0,2.0,2.0,2.0,2.0,2.0,2.0,5.0,2.0,2.0,2.0,2.0,2.0,2.0,2.0,2.0,5.0,2.0,2.0,2.0,2.0,3.0,5,,,,,,,,,,,,,,,,,,,,,,,,,,,,,,,,,13,,,,,,,,,,,,,,,,,,,,,,,,,,,,,,,,,9,,,,,,,,,,,,,,,,,,,,,,,,,,,,,,,,,8,,,,,,,,,,,,,,,,,,,,,,,,,,,,,,,,,3,,,,,,,,,,,,,,,,,,,,,,,,,,,,,,,,,,417.85,30.42,,,,10.33,,39.14,,132.07,,,110.13,,,,,,,,,,,,,,,,,,,,,,,,90.3,,,,,,,,,,,,,,,,,,5.46,,APPROVED,Female,26.0,FALSE
1161,2022-03-22 03:17:47,19,en,871118907,2022-03-22 02:58:08,2022-03-22 03:17:47,Y,Y,A2,,,14,,,,,,,,,,,,,,,,,,,,,,,,,,,,,,,,,0,6.0,5.0,6.0,5.0,5.0,6.0,4.0,6.0,4.0,5.0,5.0,6.0,4.0,5.0,4.0,5.0,6.0,5.0,6.0,5.0,5.0,5.0,6.0,5.0,5.0,6.0,4.0,6.0,4.0,6.0,5.0,2.0,7,,,,,,,,,,,,,,,,,,,,,,,,,,,,,,,,,13,,,,,,,,,,,,,,,,,,,,,,,,,,,,,,,,,12,,,,,,,,,,,,,,,,,,,,,,,,,,,,,,,,,8,,,,,,,,,,,,,,,,,,,,,,,,,,,,,,,,,1,2.0,3.0,2.0,4.0,2.0,5.0,2.0,5.0,4.0,2.0,2.0,4.0,2.0,3.0,2.0,3.0,5.0,2.0,2.0,2.0,3.0,3.0,4.0,3.0,3.0,5.0,3.0,2.0,4.0,4.0,5.0,7.0,6,,,,,,,,,,,,,,,,,,,,,,,,,,,,,,,,,9,,,,,,,,,,,,,,,,,,,,,,,,,,,,,,,,,10,,,,,,,,,,,,,,,,,,,,,,,,,,,,,,,,,5,,,,,,,,,,,,,,,,,,,,,,,,,,,,,,,,,4,,,,,,,,,,,,,,,,,,,,,,,,,,,,,,,,,2,4.0,3.0,4.0,4.0,3.0,3.0,7.0,6.0,6.0,3.0,3.0,5.0,4.0,4.0,5.0,4.0,5.0,3.0,3.0,2.0,5.0,4.0,5.0,4.0,3.0,5.0,5.0,4.0,5.0,4.0,2.0,6.0,3,,,,,,,,,,,,,,,,,,,,,,,,,,,,,,,,,11,,,,,,,,,,,,,,,,,,,,,,,,,,,,,,,,,,1181.21,22.99,,,,5.57,,83.45,,,,,929.97,,,,,,,,,,,,,,,70.95,,,,,,,,,,,,,,,,,,65.22,,,,,,,,,3.06,,APPROVED,Male,39.0,FALSE
1162,2022-03-22 03:02:58,19,en,743150911,2022-03-22 02:58:09,2022-03-22 03:02:58,Y,Y,A1,,,10,,,,,,,,,,,,,,,,,,,,,,,,,,,,,,,,,7,,,,,,,,,,,,,,,,,,,,,,,,,,,,,,,,,14,,,,,,,,,,,,,,,,,,,,,,,,,,,,,,,,,9,,,,,,,,,,,,,,,,,,,,,,,,,,,,,,,,,5,,,,,,,,,,,,,,,,,,,,,,,,,,,,,,,,,8,,,,,,,,,,,,,,,,,,,,,,,,,,,,,,,,,4,,,,,,,,,,,,,,,,,,,,,,,,,,,,,,,,,12,,,,,,,,,,,,,,,,,,,,,,,,,,,,,,,,,13,,,,,,,,,,,,,,,,,,,,,,,,,,,,,,,,,2,2.0,3.0,2.0,2.0,2.0,1.0,7.0,1.0,2.0,2.0,2.0,2.0,2.0,2.0,5.0,2.0,3.0,2.0,2.0,2.0,2.0,2.0,2.0,2.0,1.0,4.0,2.0,2.0,2.0,4.0,2.0,3.0,3,,,,,,,,,,,,,,,,,,,,,,,,,,,,,,,,,1,6.0,5.0,6.0,6.0,6.0,7.0,2.0,7.0,3.0,5.0,6.0,3.0,6.0,5.0,5.0,6.0,6.0,6.0,5.0,6.0,3.0,6.0,6.0,6.0,6.0,6.0,5.0,6.0,6.0,6.0,4.0,5.0,6,,,,,,,,,,,,,,,,,,,,,,,,,,,,,,,,,0,3.0,5.0,3.0,3.0,3.0,5.0,3.0,6.0,6.0,3.0,5.0,6.0,6.0,5.0,6.0,4.0,6.0,3.0,5.0,2.0,6.0,3.0,5.0,3.0,3.0,5.0,6.0,5.0,6.0,3.0,5.0,7.0,11,,,,,,,,,,,,,,,,,,,,,,,,,,,,,,,,,,289.79,24.2,,,,14.73,,25.07,,,,,,,,,,,,,,,,,,,,,,,,,,,,,75.06,,,,,,77.99,,,,,,69.73,,,,,,3.01,,APPROVED,Female,24.0,FALSE
1163,2022-03-22 03:05:13,19,en,1767167567,2022-03-22 02:58:36,2022-03-22 03:05:13,Y,Y,A1,,,3,,,,,,,,,,,,,,,,,,,,,,,,,,,,,,,,,11,,,,,,,,,,,,,,,,,,,,,,,,,,,,,,,,,5,,,,,,,,,,,,,,,,,,,,,,,,,,,,,,,,,6,,,,,,,,,,,,,,,,,,,,,,,,,,,,,,,,,14,,,,,,,,,,,,,,,,,,,,,,,,,,,,,,,,,7,,,,,,,,,,,,,,,,,,,,,,,,,,,,,,,,,10,,,,,,,,,,,,,,,,,,,,,,,,,,,,,,,,,12,,,,,,,,,,,,,,,,,,,,,,,,,,,,,,,,,8,,,,,,,,,,,,,,,,,,,,,,,,,,,,,,,,,4,,,,,,,,,,,,,,,,,,,,,,,,,,,,,,,,,13,,,,,,,,,,,,,,,,,,,,,,,,,,,,,,,,,9,,,,,,,,,,,,,,,,,,,,,,,,,,,,,,,,,0,5.0,6.0,4.0,4.0,5.0,3.0,5.0,6.0,6.0,4.0,6.0,5.0,6.0,5.0,4.0,5.0,6.0,5.0,5.0,2.0,4.0,6.0,5.0,5.0,4.0,6.0,4.0,5.0,6.0,6.0,5.0,6.0,1,4.0,5.0,2.0,5.0,2.0,6.0,5.0,5.0,3.0,4.0,3.0,6.0,4.0,4.0,5.0,5.0,6.0,4.0,3.0,4.0,3.0,3.0,6.0,2.0,3.0,7.0,6.0,5.0,4.0,3.0,6.0,7.0,2,6.0,6.0,6.0,6.0,6.0,4.0,5.0,5.0,5.0,6.0,6.0,4.0,6.0,4.0,6.0,6.0,6.0,6.0,5.0,3.0,4.0,6.0,6.0,6.0,6.0,6.0,4.0,6.0,6.0,6.0,6.0,1.0,I think it is interesting to what extent the data can be expressed.,400.11,36.6,,,,18.23,,47.46,,,,,,,,,,,,,,,,,,,,,,,,,,,,,,,,,,,,,,67.97,,,77.27,,,90.68,,,61.9,,APPROVED,Male,44.0,FALSE
1164,2022-03-22 03:07:01,19,en,1234415156,2022-03-22 02:58:38,2022-03-22 03:07:01,Y,Y,A1,,,13,,,,,,,,,,,,,,,,,,,,,,,,,,,,,,,,,9,,,,,,,,,,,,,,,,,,,,,,,,,,,,,,,,,2,5.0,3.0,6.0,7.0,5.0,6.0,2.0,7.0,5.0,3.0,5.0,2.0,5.0,3.0,5.0,3.0,5.0,3.0,5.0,5.0,3.0,6.0,6.0,5.0,6.0,6.0,3.0,6.0,5.0,5.0,6.0,3.0,5,,,,,,,,,,,,,,,,,,,,,,,,,,,,,,,,,3,,,,,,,,,,,,,,,,,,,,,,,,,,,,,,,,,1,3.0,5.0,3.0,5.0,3.0,3.0,5.0,5.0,6.0,3.0,2.0,3.0,3.0,2.0,5.0,3.0,6.0,2.0,3.0,3.0,3.0,3.0,2.0,3.0,3.0,2.0,3.0,3.0,2.0,2.0,5.0,6.0,4,,,,,,,,,,,,,,,,,,,,,,,,,,,,,,,,,12,,,,,,,,,,,,,,,,,,,,,,,,,,,,,,,,,0,2.0,3.0,2.0,2.0,2.0,2.0,6.0,3.0,1.0,2.0,2.0,2.0,2.0,2.0,3.0,2.0,3.0,2.0,2.0,2.0,2.0,2.0,2.0,2.0,2.0,4.0,2.0,2.0,3.0,2.0,3.0,2.0,10,,,,,,,,,,,,,,,,,,,,,,,,,,,,,,,,,7,,,,,,,,,,,,,,,,,,,,,,,,,,,,,,,,,6,,,,,,,,,,,,,,,,,,,,,,,,,,,,,,,,,8,,,,,,,,,,,,,,,,,,,,,,,,,,,,,,,,,11,,,,,,,,,,,,,,,,,,,,,,,,,,,,,,,,,14,,,,,,,,,,,,,,,,,,,,,,,,,,,,,,,,,,506.24,120.97,,,,12.16,,69.56,,,,,,,,97.27,,,,,,,,,83.32,,,,,,,,,118.68,,,,,,,,,,,,,,,,,,,,,4.28,,APPROVED,Female,22.0,FALSE
1165,2022-03-22 03:10:09,19,en,9280089,2022-03-22 02:58:55,2022-03-22 03:10:09,Y,Y,A2,,,9,,,,,,,,,,,,,,,,,,,,,,,,,,,,,,,,,2,4.0,2.0,5.0,6.0,4.0,6.0,2.0,6.0,2.0,4.0,3.0,3.0,5.0,2.0,3.0,5.0,3.0,3.0,4.0,5.0,3.0,5.0,6.0,5.0,5.0,6.0,1.0,4.0,3.0,5.0,6.0,2.0,10,,,,,,,,,,,,,,,,,,,,,,,,,,,,,,,,,0,6.0,6.0,7.0,2.0,7.0,3.0,7.0,6.0,7.0,6.0,6.0,4.0,7.0,6.0,7.0,3.0,7.0,4.0,6.0,6.0,5.0,6.0,5.0,6.0,7.0,5.0,4.0,5.0,7.0,5.0,3.0,4.0,3,,,,,,,,,,,,,,,,,,,,,,,,,,,,,,,,,1,7.0,6.0,5.0,2.0,5.0,1.0,7.0,5.0,7.0,5.0,5.0,5.0,6.0,5.0,7.0,3.0,7.0,2.0,7.0,5.0,3.0,7.0,6.0,5.0,6.0,3.0,5.0,3.0,7.0,3.0,3.0,6.0,12,,,,,,,,,,,,,,,,,,,,,,,,,,,,,,,,,6,,,,,,,,,,,,,,,,,,,,,,,,,,,,,,,,,11,,,,,,,,,,,,,,,,,,,,,,,,,,,,,,,,,13,,,,,,,,,,,,,,,,,,,,,,,,,,,,,,,,,4,,,,,,,,,,,,,,,,,,,,,,,,,,,,,,,,,14,,,,,,,,,,,,,,,,,,,,,,,,,,,,,,,,,5,,,,,,,,,,,,,,,,,,,,,,,,,,,,,,,,,8,,,,,,,,,,,,,,,,,,,,,,,,,,,,,,,,,7,,,,,,,,,,,,,,,,,,,,,,,,,,,,,,,,,,676.34,6.75,,,,5.76,,474.19,,,,,56.12,,,,,,59.3,,,,,,70.99,,,,,,,,,,,,,,,,,,,,,,,,,,,,,,3.23,,APPROVED,Male,39.0,FALSE
1166,2022-03-22 03:05:41,19,en,514503416,2022-03-22 02:58:56,2022-03-22 03:05:41,Y,Y,A1,,,13,,,,,,,,,,,,,,,,,,,,,,,,,,,,,,,,,14,,,,,,,,,,,,,,,,,,,,,,,,,,,,,,,,,11,,,,,,,,,,,,,,,,,,,,,,,,,,,,,,,,,7,,,,,,,,,,,,,,,,,,,,,,,,,,,,,,,,,6,,,,,,,,,,,,,,,,,,,,,,,,,,,,,,,,,2,3.0,5.0,4.0,4.0,5.0,4.0,5.0,6.0,5.0,4.0,5.0,3.0,3.0,2.0,3.0,5.0,4.0,4.0,5.0,4.0,3.0,3.0,4.0,5.0,5.0,5.0,4.0,3.0,5.0,5.0,4.0,6.0,4,,,,,,,,,,,,,,,,,,,,,,,,,,,,,,,,,8,,,,,,,,,,,,,,,,,,,,,,,,,,,,,,,,,1,1.0,1.0,1.0,2.0,2.0,2.0,6.0,2.0,1.0,2.0,1.0,2.0,4.0,2.0,1.0,1.0,3.0,2.0,1.0,1.0,1.0,1.0,1.0,1.0,1.0,1.0,1.0,2.0,2.0,2.0,2.0,2.0,5,,,,,,,,,,,,,,,,,,,,,,,,,,,,,,,,,3,,,,,,,,,,,,,,,,,,,,,,,,,,,,,,,,,9,,,,,,,,,,,,,,,,,,,,,,,,,,,,,,,,,12,,,,,,,,,,,,,,,,,,,,,,,,,,,,,,,,,0,3.0,2.0,3.0,3.0,2.0,3.0,3.0,3.0,4.0,3.0,2.0,4.0,4.0,2.0,2.0,3.0,6.0,4.0,3.0,1.0,2.0,3.0,3.0,4.0,2.0,2.0,3.0,4.0,3.0,3.0,4.0,7.0,10,,,,,,,,,,,,,,,,,,,,,,,,,,,,,,,,,,408.52,87.94,,,,6.48,,32.52,,,,,,,,,,,,,,,,,100.59,,,,,,,,,73.01,,,,,,,,,,,,,,,104.88,,,,,,3.1,,APPROVED,Female,18.0,FALSE
1167,2022-03-22 03:05:42,19,en,1852982070,2022-03-22 02:59:09,2022-03-22 03:05:42,Y,Y,A2,,,2,1.0,1.0,1.0,1.0,1.0,1.0,1.0,5.0,1.0,1.0,1.0,1.0,1.0,1.0,1.0,1.0,1.0,1.0,1.0,1.0,1.0,1.0,1.0,1.0,1.0,1.0,7.0,1.0,1.0,1.0,1.0,1.0,10,,,,,,,,,,,,,,,,,,,,,,,,,,,,,,,,,3,,,,,,,,,,,,,,,,,,,,,,,,,,,,,,,,,5,,,,,,,,,,,,,,,,,,,,,,,,,,,,,,,,,11,,,,,,,,,,,,,,,,,,,,,,,,,,,,,,,,,4,,,,,,,,,,,,,,,,,,,,,,,,,,,,,,,,,1,5.0,7.0,6.0,7.0,7.0,7.0,4.0,7.0,7.0,5.0,6.0,7.0,7.0,6.0,7.0,7.0,7.0,7.0,5.0,5.0,7.0,7.0,6.0,5.0,7.0,7.0,1.0,7.0,7.0,7.0,7.0,7.0,9,,,,,,,,,,,,,,,,,,,,,,,,,,,,,,,,,14,,,,,,,,,,,,,,,,,,,,,,,,,,,,,,,,,6,,,,,,,,,,,,,,,,,,,,,,,,,,,,,,,,,0,7.0,7.0,6.0,2.0,6.0,4.0,7.0,6.0,7.0,2.0,2.0,2.0,4.0,6.0,2.0,2.0,7.0,2.0,1.0,6.0,6.0,6.0,2.0,2.0,6.0,7.0,7.0,2.0,4.0,2.0,4.0,4.0,7,,,,,,,,,,,,,,,,,,,,,,,,,,,,,,,,,12,,,,,,,,,,,,,,,,,,,,,,,,,,,,,,,,,13,,,,,,,,,,,,,,,,,,,,,,,,,,,,,,,,,8,,,,,,,,,,,,,,,,,,,,,,,,,,,,,,,,,Thank you.,395.62,21.52,,,,10.11,,55.04,,57.31,,,,,,,,,,,,,,,,,,106.72,,,,,,,,,,,,128.46,,,,,,,,,,,,,,,16.46,,APPROVED,Male,35.0,FALSE
1168,2022-03-22 03:09:19,19,en,1923681073,2022-03-22 02:59:27,2022-03-22 03:09:19,Y,Y,A1,,,3,,,,,,,,,,,,,,,,,,,,,,,,,,,,,,,,,14,,,,,,,,,,,,,,,,,,,,,,,,,,,,,,,,,2,6.0,5.0,6.0,6.0,5.0,6.0,2.0,7.0,6.0,6.0,6.0,4.0,5.0,5.0,3.0,6.0,6.0,1.0,5.0,2.0,1.0,6.0,6.0,5.0,6.0,3.0,2.0,6.0,5.0,6.0,6.0,3.0,4,,,,,,,,,,,,,,,,,,,,,,,,,,,,,,,,,13,,,,,,,,,,,,,,,,,,,,,,,,,,,,,,,,,10,,,,,,,,,,,,,,,,,,,,,,,,,,,,,,,,,6,,,,,,,,,,,,,,,,,,,,,,,,,,,,,,,,,12,,,,,,,,,,,,,,,,,,,,,,,,,,,,,,,,,5,,,,,,,,,,,,,,,,,,,,,,,,,,,,,,,,,7,,,,,,,,,,,,,,,,,,,,,,,,,,,,,,,,,11,,,,,,,,,,,,,,,,,,,,,,,,,,,,,,,,,1,6.0,2.0,6.0,6.0,2.0,6.0,2.0,3.0,2.0,2.0,2.0,6.0,5.0,6.0,5.0,3.0,7.0,4.0,6.0,2.0,2.0,6.0,5.0,4.0,6.0,6.0,2.0,5.0,2.0,2.0,7.0,5.0,0,3.0,5.0,6.0,5.0,3.0,6.0,6.0,3.0,7.0,5.0,5.0,5.0,5.0,5.0,6.0,5.0,6.0,2.0,3.0,3.0,4.0,5.0,3.0,6.0,3.0,5.0,5.0,5.0,7.0,3.0,4.0,6.0,8,,,,,,,,,,,,,,,,,,,,,,,,,,,,,,,,,9,,,,,,,,,,,,,,,,,,,,,,,,,,,,,,,,,,594.65,106.41,,,,27.51,,44.53,,,,,,,,152.34,,,,,,,,,,,,,,,,,,,,,,,,,,,149.28,,,107.12,,,,,,,,,7.46,,APPROVED,Male,25.0,FALSE
1169,2022-03-22 03:06:50,19,en,857464548,2022-03-22 02:59:49,2022-03-22 03:06:50,Y,Y,A1,,,11,,,,,,,,,,,,,,,,,,,,,,,,,,,,,,,,,0,4.0,3.0,5.0,6.0,4.0,6.0,4.0,7.0,2.0,5.0,6.0,6.0,4.0,4.0,4.0,7.0,6.0,4.0,4.0,2.0,4.0,6.0,7.0,5.0,6.0,7.0,4.0,6.0,7.0,5.0,6.0,2.0,3,,,,,,,,,,,,,,,,,,,,,,,,,,,,,,,,,5,,,,,,,,,,,,,,,,,,,,,,,,,,,,,,,,,9,,,,,,,,,,,,,,,,,,,,,,,,,,,,,,,,,12,,,,,,,,,,,,,,,,,,,,,,,,,,,,,,,,,8,,,,,,,,,,,,,,,,,,,,,,,,,,,,,,,,,13,,,,,,,,,,,,,,,,,,,,,,,,,,,,,,,,,10,,,,,,,,,,,,,,,,,,,,,,,,,,,,,,,,,7,,,,,,,,,,,,,,,,,,,,,,,,,,,,,,,,,6,,,,,,,,,,,,,,,,,,,,,,,,,,,,,,,,,1,6.0,7.0,7.0,4.0,6.0,4.0,4.0,6.0,6.0,4.0,7.0,6.0,6.0,6.0,6.0,4.0,7.0,7.0,6.0,4.0,4.0,4.0,6.0,6.0,6.0,6.0,6.0,7.0,6.0,6.0,7.0,5.0,4,,,,,,,,,,,,,,,,,,,,,,,,,,,,,,,,,14,,,,,,,,,,,,,,,,,,,,,,,,,,,,,,,,,2,4.0,5.0,4.0,4.0,3.0,5.0,4.0,3.0,5.0,4.0,3.0,4.0,4.0,6.0,5.0,3.0,5.0,4.0,4.0,4.0,3.0,3.0,4.0,3.0,4.0,4.0,4.0,3.0,5.0,4.0,4.0,1.0,,424.95,62.36,,,,9.15,,53.83,,,,,91.47,,,,,,,,,,,,,,,,,,,,,,,,,,,,,,78.82,,,,,,,,,115.79,,,13.53,,APPROVED,Female,21.0,FALSE
1172,2022-03-22 03:11:36,19,en,1007322080,2022-03-22 03:06:47,2022-03-22 03:11:36,Y,Y,A1,,,4,,,,,,,,,,,,,,,,,,,,,,,,,,,,,,,,,1,2.0,2.0,5.0,5.0,4.0,5.0,4.0,4.0,2.0,5.0,5.0,5.0,5.0,2.0,4.0,5.0,5.0,5.0,5.0,6.0,3.0,5.0,6.0,6.0,5.0,6.0,3.0,5.0,5.0,3.0,6.0,2.0,12,,,,,,,,,,,,,,,,,,,,,,,,,,,,,,,,,14,,,,,,,,,,,,,,,,,,,,,,,,,,,,,,,,,9,,,,,,,,,,,,,,,,,,,,,,,,,,,,,,,,,5,,,,,,,,,,,,,,,,,,,,,,,,,,,,,,,,,13,,,,,,,,,,,,,,,,,,,,,,,,,,,,,,,,,7,,,,,,,,,,,,,,,,,,,,,,,,,,,,,,,,,8,,,,,,,,,,,,,,,,,,,,,,,,,,,,,,,,,0,6.0,5.0,5.0,5.0,5.0,3.0,5.0,2.0,5.0,5.0,5.0,6.0,5.0,6.0,6.0,6.0,6.0,4.0,5.0,5.0,2.0,5.0,3.0,6.0,5.0,2.0,2.0,5.0,5.0,3.0,5.0,3.0,11,,,,,,,,,,,,,,,,,,,,,,,,,,,,,,,,,2,2.0,6.0,5.0,2.0,5.0,5.0,5.0,3.0,5.0,5.0,6.0,5.0,6.0,6.0,6.0,3.0,5.0,5.0,5.0,6.0,2.0,3.0,2.0,4.0,6.0,5.0,2.0,6.0,5.0,5.0,5.0,5.0,10,,,,,,,,,,,,,,,,,,,,,,,,,,,,,,,,,6,,,,,,,,,,,,,,,,,,,,,,,,,,,,,,,,,3,,,,,,,,,,,,,,,,,,,,,,,,,,,,,,,,,,292.37,10.51,,,,6.14,,23.27,,,,,86.98,,,,,,,,,,,,,,,,,,,,,,,,75.67,,,,,,86.85,,,,,,,,,,,,2.95,,APPROVED,Male,24.0,FALSE
1173,2022-03-22 03:11:29,19,en,68341239,2022-03-22 03:06:50,2022-03-22 03:11:29,Y,Y,A1,,,3,,,,,,,,,,,,,,,,,,,,,,,,,,,,,,,,,7,,,,,,,,,,,,,,,,,,,,,,,,,,,,,,,,,1,7.0,5.0,7.0,6.0,7.0,5.0,6.0,6.0,7.0,6.0,6.0,5.0,6.0,6.0,5.0,4.0,6.0,4.0,5.0,5.0,4.0,6.0,6.0,6.0,4.0,5.0,4.0,5.0,6.0,7.0,7.0,3.0,10,,,,,,,,,,,,,,,,,,,,,,,,,,,,,,,,,0,6.0,6.0,6.0,7.0,6.0,2.0,2.0,4.0,6.0,7.0,7.0,7.0,5.0,5.0,6.0,6.0,7.0,7.0,6.0,5.0,3.0,6.0,2.0,6.0,5.0,6.0,7.0,6.0,6.0,7.0,4.0,5.0,9,,,,,,,,,,,,,,,,,,,,,,,,,,,,,,,,,12,,,,,,,,,,,,,,,,,,,,,,,,,,,,,,,,,13,,,,,,,,,,,,,,,,,,,,,,,,,,,,,,,,,8,,,,,,,,,,,,,,,,,,,,,,,,,,,,,,,,,11,,,,,,,,,,,,,,,,,,,,,,,,,,,,,,,,,5,,,,,,,,,,,,,,,,,,,,,,,,,,,,,,,,,14,,,,,,,,,,,,,,,,,,,,,,,,,,,,,,,,,4,,,,,,,,,,,,,,,,,,,,,,,,,,,,,,,,,6,,,,,,,,,,,,,,,,,,,,,,,,,,,,,,,,,2,5.0,2.0,5.0,5.0,5.0,2.0,3.0,4.0,1.0,5.0,3.0,2.0,2.0,4.0,6.0,5.0,5.0,4.0,3.0,2.0,1.0,5.0,3.0,2.0,3.0,5.0,5.0,4.0,3.0,3.0,2.0,1.0,good and unique survey to evaluate these illustrations,280.64,29.7,,,,4.69,,18.38,,,,,,,,40.36,,,,,,45.83,,,,,,,,,,,,,,,,,,,,,,,,,,,,,,85.34,,,56.34,,APPROVED,Male,25.0,FALSE
1174,2022-03-22 03:11:14,19,en,1350401752,2022-03-22 03:06:54,2022-03-22 03:11:14,Y,Y,-oth-,"High School Diploma, Working towards Bachelor ",,9,,,,,,,,,,,,,,,,,,,,,,,,,,,,,,,,,14,,,,,,,,,,,,,,,,,,,,,,,,,,,,,,,,,8,,,,,,,,,,,,,,,,,,,,,,,,,,,,,,,,,10,,,,,,,,,,,,,,,,,,,,,,,,,,,,,,,,,1,5.0,6.0,5.0,2.0,6.0,3.0,6.0,5.0,6.0,5.0,3.0,5.0,5.0,6.0,5.0,3.0,6.0,5.0,6.0,6.0,4.0,5.0,3.0,5.0,6.0,3.0,6.0,5.0,6.0,5.0,5.0,5.0,5,,,,,,,,,,,,,,,,,,,,,,,,,,,,,,,,,13,,,,,,,,,,,,,,,,,,,,,,,,,,,,,,,,,4,,,,,,,,,,,,,,,,,,,,,,,,,,,,,,,,,11,,,,,,,,,,,,,,,,,,,,,,,,,,,,,,,,,7,,,,,,,,,,,,,,,,,,,,,,,,,,,,,,,,,2,6.0,6.0,6.0,5.0,6.0,6.0,5.0,6.0,6.0,5.0,6.0,6.0,6.0,6.0,6.0,6.0,6.0,5.0,5.0,5.0,5.0,6.0,6.0,6.0,6.0,3.0,6.0,6.0,5.0,6.0,5.0,4.0,12,,,,,,,,,,,,,,,,,,,,,,,,,,,,,,,,,0,6.0,7.0,6.0,3.0,6.0,3.0,5.0,2.0,7.0,5.0,4.0,6.0,6.0,5.0,6.0,6.0,7.0,5.0,6.0,4.0,4.0,6.0,6.0,6.0,6.0,6.0,6.0,6.0,6.0,5.0,6.0,6.0,6,,,,,,,,,,,,,,,,,,,,,,,,,,,,,,,,,3,,,,,,,,,,,,,,,,,,,,,,,,,,,,,,,,,,263.37,13.05,,,,50.37,,31.88,,,,,,,,,,,,,,65.18,,,,,,,,,,,,,,,,,,46.09,,,,,,53.9,,,,,,,,,2.9,,APPROVED,Female,20.0,FALSE
1176,2022-03-22 03:14:27,19,en,1649787871,2022-03-22 03:07:01,2022-03-22 03:14:27,Y,Y,A1,,,8,,,,,,,,,,,,,,,,,,,,,,,,,,,,,,,,,4,,,,,,,,,,,,,,,,,,,,,,,,,,,,,,,,,12,,,,,,,,,,,,,,,,,,,,,,,,,,,,,,,,,6,,,,,,,,,,,,,,,,,,,,,,,,,,,,,,,,,14,,,,,,,,,,,,,,,,,,,,,,,,,,,,,,,,,1,3.0,3.0,3.0,2.0,3.0,2.0,6.0,4.0,4.0,2.0,2.0,2.0,2.0,2.0,2.0,3.0,3.0,3.0,2.0,2.0,2.0,3.0,4.0,3.0,2.0,4.0,1.0,2.0,2.0,2.0,4.0,6.0,11,,,,,,,,,,,,,,,,,,,,,,,,,,,,,,,,,2,1.0,1.0,1.0,1.0,1.0,2.0,4.0,1.0,1.0,1.0,1.0,1.0,1.0,1.0,1.0,1.0,1.0,1.0,1.0,1.0,1.0,1.0,5.0,1.0,1.0,2.0,1.0,1.0,1.0,1.0,2.0,7.0,3,,,,,,,,,,,,,,,,,,,,,,,,,,,,,,,,,10,,,,,,,,,,,,,,,,,,,,,,,,,,,,,,,,,9,,,,,,,,,,,,,,,,,,,,,,,,,,,,,,,,,5,,,,,,,,,,,,,,,,,,,,,,,,,,,,,,,,,13,,,,,,,,,,,,,,,,,,,,,,,,,,,,,,,,,0,4.0,4.0,2.0,3.0,2.0,2.0,6.0,2.0,4.0,2.0,2.0,4.0,3.0,4.0,4.0,1.0,4.0,2.0,2.0,2.0,3.0,4.0,3.0,1.0,2.0,4.0,5.0,2.0,2.0,2.0,2.0,7.0,7,,,,,,,,,,,,,,,,,,,,,,,,,,,,,,,,,No.,447.14,19.65,,,,23.27,,50.35,,,,,,,,,,,,,,,,,115.2,,,,,,93.14,,,,,,,,,,,,,,,,,,137.96,,,,,,7.57,,APPROVED,Female,30.0,FALSE
1177,2022-03-22 03:22:17,19,en,1934574533,2022-03-22 03:07:02,2022-03-22 03:22:17,Y,Y,A1,,,13,,,,,,,,,,,,,,,,,,,,,,,,,,,,,,,,,10,,,,,,,,,,,,,,,,,,,,,,,,,,,,,,,,,0,5.0,6.0,3.0,4.0,5.0,5.0,3.0,5.0,5.0,5.0,3.0,4.0,6.0,5.0,5.0,4.0,5.0,5.0,5.0,4.0,6.0,4.0,4.0,6.0,5.0,7.0,2.0,3.0,5.0,5.0,5.0,3.0,1,6.0,6.0,5.0,6.0,6.0,4.0,3.0,7.0,5.0,5.0,6.0,5.0,6.0,5.0,5.0,6.0,6.0,5.0,6.0,5.0,6.0,5.0,6.0,6.0,6.0,5.0,3.0,6.0,6.0,5.0,5.0,4.0,6,,,,,,,,,,,,,,,,,,,,,,,,,,,,,,,,,2,4.0,4.0,6.0,5.0,5.0,5.0,5.0,4.0,4.0,4.0,4.0,5.0,5.0,5.0,5.0,4.0,4.0,4.0,4.0,5.0,4.0,4.0,4.0,5.0,5.0,5.0,3.0,7.0,5.0,5.0,3.0,6.0,3,,,,,,,,,,,,,,,,,,,,,,,,,,,,,,,,,9,,,,,,,,,,,,,,,,,,,,,,,,,,,,,,,,,14,,,,,,,,,,,,,,,,,,,,,,,,,,,,,,,,,12,,,,,,,,,,,,,,,,,,,,,,,,,,,,,,,,,8,,,,,,,,,,,,,,,,,,,,,,,,,,,,,,,,,11,,,,,,,,,,,,,,,,,,,,,,,,,,,,,,,,,4,,,,,,,,,,,,,,,,,,,,,,,,,,,,,,,,,5,,,,,,,,,,,,,,,,,,,,,,,,,,,,,,,,,7,,,,,,,,,,,,,,,,,,,,,,,,,,,,,,,,,,918.62,38.47,,,,29.69,,396.4,,,,,,,,218.69,,,66.68,,,,,,166.1,,,,,,,,,,,,,,,,,,,,,,,,,,,,,,2.59,,APPROVED,Male,22.0,FALSE
1178,2022-03-22 03:17:51,19,en,1385881426,2022-03-22 03:07:05,2022-03-22 03:17:51,Y,Y,-oth-,technical college,,3,,,,,,,,,,,,,,,,,,,,,,,,,,,,,,,,,2,6.0,6.0,6.0,6.0,4.0,6.0,3.0,7.0,5.0,5.0,5.0,6.0,6.0,4.0,4.0,6.0,6.0,6.0,6.0,5.0,6.0,6.0,6.0,6.0,4.0,6.0,4.0,6.0,6.0,5.0,6.0,2.0,6,,,,,,,,,,,,,,,,,,,,,,,,,,,,,,,,,4,,,,,,,,,,,,,,,,,,,,,,,,,,,,,,,,,9,,,,,,,,,,,,,,,,,,,,,,,,,,,,,,,,,8,,,,,,,,,,,,,,,,,,,,,,,,,,,,,,,,,13,,,,,,,,,,,,,,,,,,,,,,,,,,,,,,,,,1,3.0,3.0,3.0,3.0,2.0,4.0,6.0,6.0,4.0,3.0,3.0,5.0,3.0,3.0,2.0,5.0,5.0,4.0,4.0,3.0,2.0,2.0,5.0,4.0,2.0,4.0,3.0,3.0,2.0,4.0,3.0,1.0,14,,,,,,,,,,,,,,,,,,,,,,,,,,,,,,,,,11,,,,,,,,,,,,,,,,,,,,,,,,,,,,,,,,,5,,,,,,,,,,,,,,,,,,,,,,,,,,,,,,,,,12,,,,,,,,,,,,,,,,,,,,,,,,,,,,,,,,,10,,,,,,,,,,,,,,,,,,,,,,,,,,,,,,,,,7,,,,,,,,,,,,,,,,,,,,,,,,,,,,,,,,,0,6.0,5.0,5.0,5.0,4.0,6.0,3.0,6.0,6.0,4.0,5.0,5.0,5.0,4.0,4.0,5.0,5.0,4.0,5.0,5.0,4.0,5.0,5.0,6.0,3.0,6.0,5.0,5.0,6.0,5.0,6.0,1.0,,647.65,59.65,,,,30.14,,53.01,,,,,143.49,,,,,,,,,,,,,,,,,,161.9,,,,,,,,,,,,,,,,,,,,,195.2,,,4.26,,APPROVED,Male,52.0,FALSE
1179,2022-03-22 03:13:14,19,en,100727262,2022-03-22 03:07:07,2022-03-22 03:13:14,Y,Y,A1,,,2,6.0,7.0,6.0,5.0,6.0,3.0,6.0,6.0,5.0,5.0,6.0,4.0,4.0,4.0,4.0,6.0,5.0,4.0,5.0,4.0,4.0,5.0,4.0,6.0,6.0,4.0,4.0,6.0,5.0,5.0,6.0,1.0,4,,,,,,,,,,,,,,,,,,,,,,,,,,,,,,,,,5,,,,,,,,,,,,,,,,,,,,,,,,,,,,,,,,,9,,,,,,,,,,,,,,,,,,,,,,,,,,,,,,,,,7,,,,,,,,,,,,,,,,,,,,,,,,,,,,,,,,,10,,,,,,,,,,,,,,,,,,,,,,,,,,,,,,,,,6,,,,,,,,,,,,,,,,,,,,,,,,,,,,,,,,,12,,,,,,,,,,,,,,,,,,,,,,,,,,,,,,,,,0,2.0,3.0,2.0,5.0,2.0,2.0,6.0,4.0,2.0,2.0,2.0,4.0,2.0,1.0,3.0,3.0,3.0,1.0,3.0,3.0,2.0,3.0,6.0,3.0,2.0,5.0,4.0,2.0,4.0,3.0,3.0,2.0,14,,,,,,,,,,,,,,,,,,,,,,,,,,,,,,,,,13,,,,,,,,,,,,,,,,,,,,,,,,,,,,,,,,,8,,,,,,,,,,,,,,,,,,,,,,,,,,,,,,,,,3,,,,,,,,,,,,,,,,,,,,,,,,,,,,,,,,,1,6.0,6.0,6.0,5.0,5.0,6.0,4.0,5.0,6.0,3.0,5.0,7.0,6.0,6.0,6.0,5.0,6.0,6.0,6.0,4.0,4.0,6.0,6.0,4.0,5.0,6.0,5.0,5.0,4.0,4.0,7.0,7.0,11,,,,,,,,,,,,,,,,,,,,,,,,,,,,,,,,,,369.9,62.83,,,,9.18,,39.08,,74.59,,,,,,,,,,,,,,,,,,,,,,,,107.53,,,,,,,,,,,,,,,73.07,,,,,,3.62,,APPROVED,Male,23.0,FALSE
1181,2022-03-22 03:17:15,19,en,1660135235,2022-03-22 03:07:08,2022-03-22 03:17:15,Y,Y,A2,,,5,,,,,,,,,,,,,,,,,,,,,,,,,,,,,,,,,0,6.0,2.0,4.0,7.0,3.0,6.0,1.0,6.0,3.0,4.0,7.0,3.0,3.0,2.0,3.0,4.0,4.0,4.0,6.0,4.0,2.0,5.0,7.0,5.0,4.0,7.0,1.0,3.0,4.0,6.0,7.0,2.0,2,7.0,7.0,7.0,6.0,7.0,7.0,2.0,6.0,5.0,7.0,2.0,6.0,7.0,4.0,4.0,6.0,7.0,4.0,5.0,7.0,1.0,6.0,6.0,7.0,7.0,6.0,4.0,5.0,4.0,6.0,3.0,3.0,8,,,,,,,,,,,,,,,,,,,,,,,,,,,,,,,,,13,,,,,,,,,,,,,,,,,,,,,,,,,,,,,,,,,14,,,,,,,,,,,,,,,,,,,,,,,,,,,,,,,,,9,,,,,,,,,,,,,,,,,,,,,,,,,,,,,,,,,1,5.0,6.0,5.0,6.0,4.0,1.0,6.0,5.0,6.0,5.0,6.0,6.0,5.0,4.0,5.0,2.0,6.0,3.0,5.0,2.0,1.0,5.0,6.0,6.0,5.0,2.0,2.0,2.0,2.0,4.0,2.0,1.0,12,,,,,,,,,,,,,,,,,,,,,,,,,,,,,,,,,3,,,,,,,,,,,,,,,,,,,,,,,,,,,,,,,,,11,,,,,,,,,,,,,,,,,,,,,,,,,,,,,,,,,6,,,,,,,,,,,,,,,,,,,,,,,,,,,,,,,,,4,,,,,,,,,,,,,,,,,,,,,,,,,,,,,,,,,7,,,,,,,,,,,,,,,,,,,,,,,,,,,,,,,,,10,,,,,,,,,,,,,,,,,,,,,,,,,,,,,,,,,"I think I recognized one of the graphs from XKCD. I tried to separate out any bias I may have had. While I have previously enjoyed the XKCD comic strips, I recognize that in terms of a graph, the one presented was... far from optimal (the y-axis being completely arbitrary and meaningless without any additional info). ",611.64,147.23,,,,4.92,,44.74,,,,,104.84,,,93.89,,,,,,,,,,,,,,,160.17,,,,,,,,,,,,,,,,,,,,,,,,55.85,,APPROVED,Male,32.0,FALSE
1182,2022-03-22 03:16:25,19,en,1050776802,2022-03-22 03:07:08,2022-03-22 03:16:25,Y,Y,A1,,,13,,,,,,,,,,,,,,,,,,,,,,,,,,,,,,,,,7,,,,,,,,,,,,,,,,,,,,,,,,,,,,,,,,,9,,,,,,,,,,,,,,,,,,,,,,,,,,,,,,,,,2,5.0,5.0,5.0,5.0,5.0,4.0,5.0,5.0,5.0,5.0,2.0,5.0,6.0,6.0,6.0,5.0,7.0,3.0,6.0,4.0,2.0,5.0,5.0,6.0,5.0,5.0,6.0,6.0,5.0,4.0,4.0,4.0,11,,,,,,,,,,,,,,,,,,,,,,,,,,,,,,,,,6,,,,,,,,,,,,,,,,,,,,,,,,,,,,,,,,,3,,,,,,,,,,,,,,,,,,,,,,,,,,,,,,,,,1,5.0,3.0,5.0,3.0,5.0,5.0,6.0,4.0,4.0,4.0,3.0,6.0,6.0,5.0,6.0,5.0,6.0,5.0,3.0,3.0,4.0,6.0,5.0,5.0,3.0,3.0,4.0,5.0,5.0,6.0,5.0,1.0,12,,,,,,,,,,,,,,,,,,,,,,,,,,,,,,,,,10,,,,,,,,,,,,,,,,,,,,,,,,,,,,,,,,,14,,,,,,,,,,,,,,,,,,,,,,,,,,,,,,,,,4,,,,,,,,,,,,,,,,,,,,,,,,,,,,,,,,,8,,,,,,,,,,,,,,,,,,,,,,,,,,,,,,,,,5,,,,,,,,,,,,,,,,,,,,,,,,,,,,,,,,,0,3.0,3.0,2.0,3.0,2.0,3.0,3.0,5.0,4.0,2.0,2.0,5.0,2.0,4.0,6.0,4.0,6.0,4.0,5.0,2.0,4.0,3.0,4.0,3.0,2.0,6.0,3.0,5.0,5.0,2.0,3.0,1.0,,552.19,16.94,,,,14.14,,78.16,,,,,,,,,,,129.39,,,,,,,,,,,,130.49,,,,,,,,,,,,,,,,,,,,,173.43,,,9.64,,APPROVED,Female,18.0,FALSE
1183,2022-03-22 03:11:22,19,en,2045674413,2022-03-22 03:07:10,2022-03-22 03:11:22,Y,Y,A1,,,11,,,,,,,,,,,,,,,,,,,,,,,,,,,,,,,,,7,,,,,,,,,,,,,,,,,,,,,,,,,,,,,,,,,9,,,,,,,,,,,,,,,,,,,,,,,,,,,,,,,,,12,,,,,,,,,,,,,,,,,,,,,,,,,,,,,,,,,5,,,,,,,,,,,,,,,,,,,,,,,,,,,,,,,,,8,,,,,,,,,,,,,,,,,,,,,,,,,,,,,,,,,3,,,,,,,,,,,,,,,,,,,,,,,,,,,,,,,,,10,,,,,,,,,,,,,,,,,,,,,,,,,,,,,,,,,2,4.0,4.0,4.0,5.0,3.0,4.0,3.0,3.0,5.0,3.0,4.0,4.0,4.0,3.0,4.0,4.0,5.0,5.0,4.0,4.0,2.0,4.0,5.0,3.0,3.0,6.0,4.0,3.0,6.0,4.0,5.0,2.0,0,2.0,5.0,1.0,3.0,2.0,6.0,4.0,1.0,2.0,2.0,2.0,3.0,3.0,4.0,6.0,2.0,5.0,3.0,2.0,1.0,3.0,4.0,3.0,2.0,3.0,4.0,2.0,2.0,4.0,2.0,5.0,3.0,1,5.0,6.0,5.0,4.0,5.0,6.0,2.0,6.0,6.0,5.0,5.0,5.0,5.0,4.0,5.0,5.0,6.0,5.0,5.0,5.0,3.0,5.0,6.0,5.0,4.0,6.0,2.0,4.0,4.0,5.0,6.0,4.0,14,,,,,,,,,,,,,,,,,,,,,,,,,,,,,,,,,4,,,,,,,,,,,,,,,,,,,,,,,,,,,,,,,,,6,,,,,,,,,,,,,,,,,,,,,,,,,,,,,,,,,13,,,,,,,,,,,,,,,,,,,,,,,,,,,,,,,,,,254.6,12.97,,,,3.67,,17.04,,,,,,,,,,,,,,,,,,,,,,,,,,84.71,,,72.98,,,60.43,,,,,,,,,,,,,,,2.8,,APPROVED,Male,33.0,FALSE
1184,2022-03-22 03:15:45,19,en,1032234571,2022-03-22 03:07:10,2022-03-22 03:15:45,Y,Y,A1,,,11,,,,,,,,,,,,,,,,,,,,,,,,,,,,,,,,,10,,,,,,,,,,,,,,,,,,,,,,,,,,,,,,,,,4,,,,,,,,,,,,,,,,,,,,,,,,,,,,,,,,,7,,,,,,,,,,,,,,,,,,,,,,,,,,,,,,,,,9,,,,,,,,,,,,,,,,,,,,,,,,,,,,,,,,,8,,,,,,,,,,,,,,,,,,,,,,,,,,,,,,,,,5,,,,,,,,,,,,,,,,,,,,,,,,,,,,,,,,,2,6.0,3.0,4.0,6.0,2.0,5.0,3.0,6.0,4.0,4.0,4.0,5.0,4.0,4.0,3.0,5.0,5.0,6.0,6.0,3.0,5.0,4.0,6.0,5.0,2.0,4.0,4.0,6.0,2.0,6.0,5.0,1.0,3,,,,,,,,,,,,,,,,,,,,,,,,,,,,,,,,,6,,,,,,,,,,,,,,,,,,,,,,,,,,,,,,,,,0,2.0,5.0,3.0,3.0,4.0,2.0,7.0,6.0,5.0,2.0,2.0,4.0,3.0,2.0,3.0,4.0,3.0,2.0,2.0,2.0,2.0,2.0,2.0,2.0,2.0,3.0,2.0,2.0,2.0,4.0,2.0,4.0,12,,,,,,,,,,,,,,,,,,,,,,,,,,,,,,,,,13,,,,,,,,,,,,,,,,,,,,,,,,,,,,,,,,,1,2.0,1.0,1.0,1.0,1.0,1.0,6.0,2.0,3.0,1.0,1.0,3.0,2.0,5.0,4.0,2.0,4.0,2.0,2.0,1.0,1.0,1.0,5.0,2.0,1.0,1.0,3.0,2.0,1.0,4.0,1.0,7.0,14,,,,,,,,,,,,,,,,,,,,,,,,,,,,,,,,,,516.22,21.35,,,,12.27,,31.99,,,,,,,,,,,,,,,,,,,,,,,173.28,,,,,,,,,138.39,,,,,,,,,135.54,,,,,,3.4,,APPROVED,Female,41.0,FALSE
1186,2022-03-22 03:11:08,19,en,1929562160,2022-03-22 03:07:11,2022-03-22 03:11:08,Y,Y,-oth-,High School,,2,1.0,7.0,2.0,1.0,2.0,1.0,7.0,3.0,5.0,2.0,3.0,2.0,2.0,5.0,5.0,6.0,5.0,1.0,3.0,1.0,2.0,3.0,1.0,1.0,2.0,1.0,1.0,7.0,6.0,3.0,4.0,1.0,9,,,,,,,,,,,,,,,,,,,,,,,,,,,,,,,,,3,,,,,,,,,,,,,,,,,,,,,,,,,,,,,,,,,5,,,,,,,,,,,,,,,,,,,,,,,,,,,,,,,,,6,,,,,,,,,,,,,,,,,,,,,,,,,,,,,,,,,0,5.0,5.0,5.0,2.0,3.0,4.0,3.0,6.0,5.0,5.0,3.0,6.0,5.0,5.0,6.0,5.0,6.0,3.0,6.0,2.0,3.0,5.0,4.0,6.0,6.0,3.0,1.0,6.0,3.0,5.0,4.0,6.0,13,,,,,,,,,,,,,,,,,,,,,,,,,,,,,,,,,14,,,,,,,,,,,,,,,,,,,,,,,,,,,,,,,,,12,,,,,,,,,,,,,,,,,,,,,,,,,,,,,,,,,8,,,,,,,,,,,,,,,,,,,,,,,,,,,,,,,,,1,2.0,5.0,2.0,2.0,2.0,2.0,6.0,2.0,2.0,1.0,3.0,2.0,2.0,2.0,2.0,1.0,2.0,2.0,1.0,2.0,2.0,2.0,2.0,1.0,2.0,6.0,1.0,3.0,3.0,2.0,3.0,4.0,11,,,,,,,,,,,,,,,,,,,,,,,,,,,,,,,,,10,,,,,,,,,,,,,,,,,,,,,,,,,,,,,,,,,7,,,,,,,,,,,,,,,,,,,,,,,,,,,,,,,,,4,,,,,,,,,,,,,,,,,,,,,,,,,,,,,,,,,,239.21,10.82,,,,13.19,,29.97,,57.3,,,,,,,,,,,,,,,67.32,,,,,,,,,,,,,,,58.72,,,,,,,,,,,,,,,1.89,,APPROVED,Male,22.0,FALSE
1187,2022-03-22 03:15:57,19,en,1577403364,2022-03-22 03:07:12,2022-03-22 03:15:57,Y,Y,A1,,,8,,,,,,,,,,,,,,,,,,,,,,,,,,,,,,,,,4,,,,,,,,,,,,,,,,,,,,,,,,,,,,,,,,,9,,,,,,,,,,,,,,,,,,,,,,,,,,,,,,,,,1,3.0,4.0,1.0,1.0,1.0,1.0,3.0,4.0,5.0,3.0,1.0,2.0,2.0,1.0,2.0,2.0,4.0,4.0,1.0,1.0,1.0,3.0,1.0,1.0,2.0,1.0,4.0,1.0,6.0,1.0,3.0,4.0,2,4.0,1.0,1.0,1.0,4.0,3.0,4.0,4.0,2.0,5.0,2.0,4.0,2.0,2.0,5.0,1.0,6.0,4.0,5.0,3.0,2.0,4.0,3.0,2.0,4.0,1.0,3.0,2.0,7.0,1.0,4.0,5.0,0,6.0,7.0,6.0,4.0,6.0,2.0,4.0,5.0,7.0,6.0,3.0,5.0,6.0,6.0,6.0,4.0,7.0,4.0,5.0,5.0,3.0,6.0,1.0,4.0,6.0,4.0,4.0,5.0,6.0,5.0,5.0,6.0,10,,,,,,,,,,,,,,,,,,,,,,,,,,,,,,,,,5,,,,,,,,,,,,,,,,,,,,,,,,,,,,,,,,,12,,,,,,,,,,,,,,,,,,,,,,,,,,,,,,,,,14,,,,,,,,,,,,,,,,,,,,,,,,,,,,,,,,,11,,,,,,,,,,,,,,,,,,,,,,,,,,,,,,,,,13,,,,,,,,,,,,,,,,,,,,,,,,,,,,,,,,,6,,,,,,,,,,,,,,,,,,,,,,,,,,,,,,,,,7,,,,,,,,,,,,,,,,,,,,,,,,,,,,,,,,,3,,,,,,,,,,,,,,,,,,,,,,,,,,,,,,,,,It was an interesting survey!,527.39,70.06,,,,12.82,,67.13,,,,,,,,,,,96.48,,,109.22,,,153.39,,,,,,,,,,,,,,,,,,,,,,,,,,,,,,18.29,,APPROVED,Female,23.0,FALSE
1188,2022-03-22 03:13:51,19,en,670932857,2022-03-22 03:07:15,2022-03-22 03:13:51,Y,Y,A2,,,1,6.0,6.0,7.0,3.0,6.0,6.0,2.0,6.0,6.0,6.0,7.0,6.0,6.0,6.0,6.0,6.0,5.0,6.0,6.0,5.0,6.0,6.0,7.0,6.0,7.0,2.0,6.0,6.0,5.0,6.0,6.0,1.0,6,,,,,,,,,,,,,,,,,,,,,,,,,,,,,,,,,7,,,,,,,,,,,,,,,,,,,,,,,,,,,,,,,,,8,,,,,,,,,,,,,,,,,,,,,,,,,,,,,,,,,0,5.0,5.0,5.0,6.0,5.0,6.0,2.0,5.0,5.0,3.0,5.0,5.0,6.0,3.0,4.0,4.0,6.0,4.0,5.0,5.0,3.0,5.0,6.0,5.0,5.0,5.0,3.0,5.0,6.0,6.0,6.0,5.0,3,,,,,,,,,,,,,,,,,,,,,,,,,,,,,,,,,5,,,,,,,,,,,,,,,,,,,,,,,,,,,,,,,,,11,,,,,,,,,,,,,,,,,,,,,,,,,,,,,,,,,2,2.0,4.0,2.0,4.0,1.0,2.0,6.0,1.0,3.0,2.0,2.0,3.0,2.0,2.0,3.0,2.0,3.0,2.0,2.0,2.0,3.0,2.0,2.0,3.0,2.0,2.0,2.0,2.0,5.0,2.0,3.0,2.0,10,,,,,,,,,,,,,,,,,,,,,,,,,,,,,,,,,14,,,,,,,,,,,,,,,,,,,,,,,,,,,,,,,,,13,,,,,,,,,,,,,,,,,,,,,,,,,,,,,,,,,4,,,,,,,,,,,,,,,,,,,,,,,,,,,,,,,,,9,,,,,,,,,,,,,,,,,,,,,,,,,,,,,,,,,12,,,,,,,,,,,,,,,,,,,,,,,,,,,,,,,,,,397.39,40.62,,,,29.49,,14.92,,49.72,,,,,,,,,,,,51.98,,,,,,,,,,,,39.48,,,,,,,,,,,,,,,,,,,,,171.18,,APPROVED,Male,28.0,FALSE
1189,2022-03-22 03:11:59,19,en,310495564,2022-03-22 03:07:17,2022-03-22 03:11:59,Y,Y,-oth-,College certificate ,,14,,,,,,,,,,,,,,,,,,,,,,,,,,,,,,,,,7,,,,,,,,,,,,,,,,,,,,,,,,,,,,,,,,,6,,,,,,,,,,,,,,,,,,,,,,,,,,,,,,,,,11,,,,,,,,,,,,,,,,,,,,,,,,,,,,,,,,,12,,,,,,,,,,,,,,,,,,,,,,,,,,,,,,,,,4,,,,,,,,,,,,,,,,,,,,,,,,,,,,,,,,,8,,,,,,,,,,,,,,,,,,,,,,,,,,,,,,,,,2,5.0,6.0,5.0,5.0,4.0,5.0,5.0,2.0,5.0,5.0,4.0,5.0,5.0,5.0,6.0,5.0,5.0,4.0,5.0,4.0,5.0,4.0,5.0,5.0,5.0,5.0,5.0,5.0,6.0,5.0,5.0,1.0,0,6.0,2.0,3.0,4.0,1.0,4.0,6.0,1.0,1.0,2.0,4.0,2.0,4.0,2.0,3.0,3.0,5.0,2.0,2.0,1.0,3.0,3.0,4.0,1.0,2.0,4.0,3.0,3.0,4.0,4.0,2.0,2.0,3,,,,,,,,,,,,,,,,,,,,,,,,,,,,,,,,,5,,,,,,,,,,,,,,,,,,,,,,,,,,,,,,,,,10,,,,,,,,,,,,,,,,,,,,,,,,,,,,,,,,,9,,,,,,,,,,,,,,,,,,,,,,,,,,,,,,,,,1,4.0,5.0,5.0,5.0,3.0,5.0,4.0,4.0,4.0,3.0,4.0,5.0,3.0,3.0,5.0,3.0,5.0,4.0,4.0,3.0,3.0,4.0,4.0,5.0,5.0,5.0,6.0,4.0,5.0,5.0,4.0,7.0,13,,,,,,,,,,,,,,,,,,,,,,,,,,,,,,,,,,285.78,15.37,,,,16.94,,84.93,,,,,,,,,,,,,,,,,,,,,,,44.13,,,75.2,,,,,,,,,,,,,,,45.55,,,,,,3.66,,APPROVED,Male,35.0,FALSE
1190,2022-03-22 03:11:44,19,en,9080162,2022-03-22 03:07:17,2022-03-22 03:11:44,Y,Y,A1,,,13,,,,,,,,,,,,,,,,,,,,,,,,,,,,,,,,,2,7.0,2.0,6.0,7.0,5.0,7.0,2.0,7.0,2.0,6.0,7.0,6.0,6.0,6.0,4.0,7.0,7.0,6.0,6.0,5.0,5.0,7.0,7.0,6.0,6.0,7.0,6.0,6.0,7.0,6.0,7.0,2.0,9,,,,,,,,,,,,,,,,,,,,,,,,,,,,,,,,,12,,,,,,,,,,,,,,,,,,,,,,,,,,,,,,,,,4,,,,,,,,,,,,,,,,,,,,,,,,,,,,,,,,,8,,,,,,,,,,,,,,,,,,,,,,,,,,,,,,,,,1,2.0,3.0,2.0,2.0,1.0,2.0,7.0,5.0,6.0,1.0,2.0,2.0,1.0,2.0,5.0,1.0,5.0,2.0,3.0,1.0,3.0,2.0,1.0,2.0,1.0,5.0,6.0,1.0,1.0,2.0,4.0,7.0,10,,,,,,,,,,,,,,,,,,,,,,,,,,,,,,,,,14,,,,,,,,,,,,,,,,,,,,,,,,,,,,,,,,,3,,,,,,,,,,,,,,,,,,,,,,,,,,,,,,,,,7,,,,,,,,,,,,,,,,,,,,,,,,,,,,,,,,,6,,,,,,,,,,,,,,,,,,,,,,,,,,,,,,,,,5,,,,,,,,,,,,,,,,,,,,,,,,,,,,,,,,,11,,,,,,,,,,,,,,,,,,,,,,,,,,,,,,,,,0,6.0,4.0,6.0,7.0,4.0,7.0,7.0,7.0,5.0,6.0,7.0,6.0,5.0,5.0,7.0,6.0,6.0,6.0,6.0,4.0,3.0,5.0,4.0,6.0,4.0,6.0,5.0,6.0,7.0,5.0,7.0,1.0,,269.04,21.95,,,,13.18,,28.69,,,,,56.16,,,,,,,,,,,,,,,74.77,,,,,,,,,,,,,,,,,,,,,,,,71.16,,,3.13,,APPROVED,Female,22.0,FALSE
1191,2022-03-22 03:15:31,19,en,1766075349,2022-03-22 03:07:18,2022-03-22 03:15:31,Y,Y,A1,,,8,,,,,,,,,,,,,,,,,,,,,,,,,,,,,,,,,13,,,,,,,,,,,,,,,,,,,,,,,,,,,,,,,,,2,4.0,6.0,4.0,6.0,5.0,3.0,6.0,5.0,2.0,3.0,4.0,5.0,5.0,5.0,4.0,6.0,4.0,5.0,5.0,4.0,4.0,3.0,6.0,3.0,4.0,5.0,4.0,6.0,3.0,4.0,6.0,3.0,14,,,,,,,,,,,,,,,,,,,,,,,,,,,,,,,,,12,,,,,,,,,,,,,,,,,,,,,,,,,,,,,,,,,3,,,,,,,,,,,,,,,,,,,,,,,,,,,,,,,,,11,,,,,,,,,,,,,,,,,,,,,,,,,,,,,,,,,6,,,,,,,,,,,,,,,,,,,,,,,,,,,,,,,,,7,,,,,,,,,,,,,,,,,,,,,,,,,,,,,,,,,5,,,,,,,,,,,,,,,,,,,,,,,,,,,,,,,,,9,,,,,,,,,,,,,,,,,,,,,,,,,,,,,,,,,1,6.0,6.0,7.0,7.0,6.0,7.0,1.0,7.0,6.0,6.0,7.0,7.0,7.0,7.0,7.0,7.0,7.0,5.0,5.0,6.0,6.0,7.0,6.0,7.0,7.0,7.0,2.0,7.0,6.0,6.0,7.0,5.0,4,,,,,,,,,,,,,,,,,,,,,,,,,,,,,,,,,10,,,,,,,,,,,,,,,,,,,,,,,,,,,,,,,,,0,3.0,5.0,5.0,3.0,3.0,3.0,7.0,1.0,6.0,3.0,4.0,4.0,3.0,5.0,5.0,4.0,5.0,3.0,4.0,2.0,2.0,4.0,5.0,3.0,3.0,6.0,4.0,4.0,5.0,3.0,4.0,1.0,,494.73,25.75,,,,12.05,,32.22,,,,,,,,198.9,,,,,,,,,,,,,,,,,,,,,,,,,,,94.99,,,,,,,,,123.5,,,7.32,,APPROVED,Male,22.0,FALSE
1192,2022-03-22 03:12:01,19,en,423769573,2022-03-22 03:07:18,2022-03-22 03:12:01,Y,Y,-oth-,HND,,7,,,,,,,,,,,,,,,,,,,,,,,,,,,,,,,,,0,5.0,5.0,5.0,4.0,5.0,6.0,2.0,2.0,4.0,4.0,5.0,5.0,4.0,3.0,4.0,4.0,5.0,4.0,5.0,4.0,4.0,5.0,6.0,5.0,4.0,6.0,4.0,5.0,5.0,5.0,5.0,2.0,10,,,,,,,,,,,,,,,,,,,,,,,,,,,,,,,,,9,,,,,,,,,,,,,,,,,,,,,,,,,,,,,,,,,2,5.0,5.0,5.0,4.0,4.0,5.0,4.0,4.0,4.0,5.0,5.0,5.0,5.0,4.0,6.0,5.0,5.0,6.0,5.0,5.0,5.0,5.0,6.0,5.0,4.0,6.0,5.0,5.0,5.0,5.0,6.0,5.0,13,,,,,,,,,,,,,,,,,,,,,,,,,,,,,,,,,6,,,,,,,,,,,,,,,,,,,,,,,,,,,,,,,,,5,,,,,,,,,,,,,,,,,,,,,,,,,,,,,,,,,8,,,,,,,,,,,,,,,,,,,,,,,,,,,,,,,,,3,,,,,,,,,,,,,,,,,,,,,,,,,,,,,,,,,12,,,,,,,,,,,,,,,,,,,,,,,,,,,,,,,,,14,,,,,,,,,,,,,,,,,,,,,,,,,,,,,,,,,4,,,,,,,,,,,,,,,,,,,,,,,,,,,,,,,,,11,,,,,,,,,,,,,,,,,,,,,,,,,,,,,,,,,1,6.0,6.0,6.0,4.0,5.0,5.0,2.0,5.0,5.0,5.0,5.0,4.0,5.0,5.0,5.0,4.0,4.0,2.0,6.0,5.0,4.0,5.0,4.0,5.0,6.0,6.0,4.0,6.0,4.0,5.0,5.0,1.0,,284.4,25.25,,,,10.54,,67.99,,,,,61.57,,,,,,,,,52.54,,,,,,,,,,,,,,,,,,,,,,,,,,,,,,63.1,,,3.41,,APPROVED,Female,37.0,FALSE
1193,2022-03-22 03:15:10,19,en,937263190,2022-03-22 03:07:19,2022-03-22 03:15:10,Y,Y,A1,,,9,,,,,,,,,,,,,,,,,,,,,,,,,,,,,,,,,10,,,,,,,,,,,,,,,,,,,,,,,,,,,,,,,,,7,,,,,,,,,,,,,,,,,,,,,,,,,,,,,,,,,3,,,,,,,,,,,,,,,,,,,,,,,,,,,,,,,,,0,6.0,6.0,6.0,6.0,5.0,4.0,6.0,5.0,6.0,4.0,7.0,5.0,6.0,4.0,4.0,6.0,5.0,3.0,7.0,6.0,4.0,7.0,6.0,5.0,6.0,7.0,4.0,4.0,4.0,5.0,6.0,5.0,4,,,,,,,,,,,,,,,,,,,,,,,,,,,,,,,,,6,,,,,,,,,,,,,,,,,,,,,,,,,,,,,,,,,2,5.0,5.0,4.0,5.0,4.0,3.0,4.0,4.0,6.0,5.0,4.0,5.0,4.0,6.0,3.0,4.0,7.0,7.0,6.0,4.0,5.0,6.0,4.0,4.0,5.0,6.0,6.0,5.0,4.0,5.0,6.0,1.0,1,2.0,1.0,1.0,2.0,2.0,4.0,1.0,1.0,2.0,2.0,1.0,3.0,3.0,1.0,2.0,1.0,3.0,2.0,2.0,2.0,2.0,3.0,2.0,1.0,1.0,2.0,2.0,2.0,1.0,2.0,2.0,2.0,11,,,,,,,,,,,,,,,,,,,,,,,,,,,,,,,,,13,,,,,,,,,,,,,,,,,,,,,,,,,,,,,,,,,12,,,,,,,,,,,,,,,,,,,,,,,,,,,,,,,,,5,,,,,,,,,,,,,,,,,,,,,,,,,,,,,,,,,14,,,,,,,,,,,,,,,,,,,,,,,,,,,,,,,,,8,,,,,,,,,,,,,,,,,,,,,,,,,,,,,,,,,,474.33,27.26,,,,8.06,,33.78,,,,,,,,,,,,,,123.12,,,,,,,,,129.75,,,143.46,,,,,,,,,,,,,,,,,,,,,8.9,,APPROVED,Prefer not to say,33.0,FALSE
1194,2022-03-22 03:14:13,19,en,244476398,2022-03-22 03:07:20,2022-03-22 03:14:13,Y,Y,A1,,,6,,,,,,,,,,,,,,,,,,,,,,,,,,,,,,,,,2,5.0,5.0,5.0,6.0,6.0,7.0,5.0,7.0,3.0,4.0,3.0,5.0,3.0,5.0,5.0,7.0,7.0,3.0,6.0,5.0,4.0,5.0,5.0,6.0,6.0,7.0,4.0,4.0,3.0,3.0,4.0,2.0,9,,,,,,,,,,,,,,,,,,,,,,,,,,,,,,,,,13,,,,,,,,,,,,,,,,,,,,,,,,,,,,,,,,,12,,,,,,,,,,,,,,,,,,,,,,,,,,,,,,,,,8,,,,,,,,,,,,,,,,,,,,,,,,,,,,,,,,,14,,,,,,,,,,,,,,,,,,,,,,,,,,,,,,,,,5,,,,,,,,,,,,,,,,,,,,,,,,,,,,,,,,,4,,,,,,,,,,,,,,,,,,,,,,,,,,,,,,,,,7,,,,,,,,,,,,,,,,,,,,,,,,,,,,,,,,,3,,,,,,,,,,,,,,,,,,,,,,,,,,,,,,,,,1,5.0,7.0,7.0,6.0,6.0,6.0,6.0,7.0,6.0,6.0,5.0,6.0,7.0,7.0,6.0,6.0,5.0,6.0,6.0,5.0,5.0,6.0,6.0,7.0,6.0,5.0,6.0,7.0,7.0,7.0,6.0,5.0,10,,,,,,,,,,,,,,,,,,,,,,,,,,,,,,,,,11,,,,,,,,,,,,,,,,,,,,,,,,,,,,,,,,,0,4.0,6.0,6.0,5.0,5.0,6.0,6.0,6.0,6.0,6.0,7.0,6.0,6.0,6.0,5.0,6.0,6.0,5.0,6.0,4.0,5.0,5.0,6.0,6.0,5.0,6.0,5.0,6.0,7.0,5.0,5.0,1.0,"I like so much the images one and two, the map is good but a little serious ",418.2,28.49,,,,12.23,,42.2,,,,,81.86,,,,,,,,,,,,,,,,,,,,,,,,,,,,,,89.87,,,,,,,,,119.91,,,43.64,,APPROVED,Female,20.0,FALSE
1195,2022-03-22 03:12:48,19,en,1748036389,2022-03-22 03:07:22,2022-03-22 03:12:48,Y,Y,-oth-,none,,9,,,,,,,,,,,,,,,,,,,,,,,,,,,,,,,,,13,,,,,,,,,,,,,,,,,,,,,,,,,,,,,,,,,11,,,,,,,,,,,,,,,,,,,,,,,,,,,,,,,,,14,,,,,,,,,,,,,,,,,,,,,,,,,,,,,,,,,12,,,,,,,,,,,,,,,,,,,,,,,,,,,,,,,,,4,,,,,,,,,,,,,,,,,,,,,,,,,,,,,,,,,3,,,,,,,,,,,,,,,,,,,,,,,,,,,,,,,,,8,,,,,,,,,,,,,,,,,,,,,,,,,,,,,,,,,10,,,,,,,,,,,,,,,,,,,,,,,,,,,,,,,,,1,1.0,2.0,1.0,1.0,1.0,1.0,7.0,1.0,1.0,1.0,1.0,1.0,1.0,3.0,1.0,1.0,1.0,1.0,1.0,1.0,1.0,1.0,1.0,1.0,1.0,1.0,5.0,1.0,1.0,1.0,1.0,3.0,0,1.0,6.0,3.0,4.0,1.0,1.0,6.0,2.0,5.0,4.0,1.0,3.0,4.0,6.0,6.0,5.0,5.0,3.0,3.0,4.0,2.0,2.0,1.0,3.0,5.0,1.0,7.0,3.0,2.0,4.0,1.0,4.0,7,,,,,,,,,,,,,,,,,,,,,,,,,,,,,,,,,6,,,,,,,,,,,,,,,,,,,,,,,,,,,,,,,,,2,7.0,7.0,5.0,5.0,7.0,7.0,5.0,5.0,5.0,4.0,6.0,7.0,6.0,6.0,7.0,5.0,7.0,6.0,5.0,6.0,6.0,6.0,5.0,7.0,7.0,6.0,2.0,7.0,7.0,4.0,7.0,7.0,5,,,,,,,,,,,,,,,,,,,,,,,,,,,,,,,,,,328.76,56.6,,,,13.16,,38.37,,,,,,,,,,,,,,,,,,,,,,,,,,,,,65.3,,,85.42,,,,,,,,,67.97,,,,,,1.94,,APPROVED,Male,27.0,FALSE
1196,2022-03-22 03:12:09,19,en,1298691845,2022-03-22 03:07:22,2022-03-22 03:12:09,Y,Y,-oth-,Part of Bachelor,,13,,,,,,,,,,,,,,,,,,,,,,,,,,,,,,,,,8,,,,,,,,,,,,,,,,,,,,,,,,,,,,,,,,,14,,,,,,,,,,,,,,,,,,,,,,,,,,,,,,,,,10,,,,,,,,,,,,,,,,,,,,,,,,,,,,,,,,,5,,,,,,,,,,,,,,,,,,,,,,,,,,,,,,,,,7,,,,,,,,,,,,,,,,,,,,,,,,,,,,,,,,,12,,,,,,,,,,,,,,,,,,,,,,,,,,,,,,,,,1,1.0,1.0,1.0,1.0,1.0,1.0,7.0,1.0,1.0,1.0,1.0,1.0,1.0,1.0,1.0,1.0,1.0,1.0,1.0,1.0,1.0,1.0,1.0,1.0,1.0,1.0,1.0,1.0,1.0,1.0,1.0,1.0,4,,,,,,,,,,,,,,,,,,,,,,,,,,,,,,,,,3,,,,,,,,,,,,,,,,,,,,,,,,,,,,,,,,,2,6.0,7.0,6.0,6.0,6.0,1.0,7.0,7.0,7.0,6.0,1.0,7.0,6.0,6.0,6.0,6.0,7.0,1.0,4.0,6.0,2.0,6.0,1.0,6.0,6.0,1.0,6.0,6.0,1.0,5.0,1.0,4.0,0,5.0,6.0,6.0,2.0,6.0,2.0,1.0,2.0,2.0,5.0,5.0,5.0,5.0,2.0,5.0,2.0,5.0,2.0,4.0,5.0,2.0,5.0,2.0,5.0,6.0,2.0,2.0,2.0,2.0,5.0,2.0,5.0,9,,,,,,,,,,,,,,,,,,,,,,,,,,,,,,,,,11,,,,,,,,,,,,,,,,,,,,,,,,,,,,,,,,,6,,,,,,,,,,,,,,,,,,,,,,,,,,,,,,,,,,290.89,30.77,,,,16.38,,36.34,,,,,,,,,,,,,,,,,,,,,,,40.14,,,,,,,,,58.78,,,104.74,,,,,,,,,,,,3.74,,APPROVED,Female,19.0,FALSE
1197,2022-03-22 03:12:18,19,en,1034140147,2022-03-22 03:07:23,2022-03-22 03:12:18,Y,Y,-oth-,Certificate,,2,6.0,6.0,5.0,2.0,6.0,4.0,5.0,6.0,7.0,5.0,3.0,5.0,5.0,7.0,6.0,4.0,6.0,4.0,6.0,6.0,3.0,6.0,2.0,4.0,6.0,4.0,6.0,5.0,3.0,3.0,6.0,1.0,14,,,,,,,,,,,,,,,,,,,,,,,,,,,,,,,,,12,,,,,,,,,,,,,,,,,,,,,,,,,,,,,,,,,7,,,,,,,,,,,,,,,,,,,,,,,,,,,,,,,,,6,,,,,,,,,,,,,,,,,,,,,,,,,,,,,,,,,4,,,,,,,,,,,,,,,,,,,,,,,,,,,,,,,,,10,,,,,,,,,,,,,,,,,,,,,,,,,,,,,,,,,3,,,,,,,,,,,,,,,,,,,,,,,,,,,,,,,,,0,3.0,6.0,3.0,2.0,3.0,2.0,6.0,2.0,5.0,3.0,3.0,6.0,3.0,5.0,4.0,3.0,5.0,2.0,3.0,3.0,3.0,3.0,2.0,3.0,3.0,4.0,6.0,4.0,5.0,4.0,3.0,2.0,13,,,,,,,,,,,,,,,,,,,,,,,,,,,,,,,,,9,,,,,,,,,,,,,,,,,,,,,,,,,,,,,,,,,1,6.0,6.0,5.0,3.0,6.0,4.0,2.0,6.0,6.0,4.0,5.0,6.0,6.0,5.0,6.0,4.0,5.0,3.0,6.0,6.0,3.0,6.0,4.0,6.0,6.0,4.0,6.0,5.0,6.0,5.0,5.0,5.0,11,,,,,,,,,,,,,,,,,,,,,,,,,,,,,,,,,5,,,,,,,,,,,,,,,,,,,,,,,,,,,,,,,,,8,,,,,,,,,,,,,,,,,,,,,,,,,,,,,,,,,,298.27,12.21,,,,15.84,,25.61,,80.87,,,,,,,,,,,,,,,,,,,,,,,,82.72,,,,,,,,,76.62,,,,,,,,,,,,4.4,,APPROVED,Female,20.0,FALSE
1198,2022-03-22 03:14:50,19,en,1477276586,2022-03-22 03:07:25,2022-03-22 03:14:50,Y,Y,-oth-,High school,,14,,,,,,,,,,,,,,,,,,,,,,,,,,,,,,,,,11,,,,,,,,,,,,,,,,,,,,,,,,,,,,,,,,,12,,,,,,,,,,,,,,,,,,,,,,,,,,,,,,,,,1,6.0,7.0,7.0,4.0,6.0,3.0,4.0,6.0,7.0,6.0,7.0,4.0,4.0,4.0,6.0,6.0,6.0,6.0,6.0,6.0,4.0,7.0,4.0,4.0,7.0,6.0,4.0,4.0,5.0,7.0,7.0,4.0,9,,,,,,,,,,,,,,,,,,,,,,,,,,,,,,,,,0,2.0,6.0,5.0,2.0,6.0,2.0,7.0,5.0,5.0,4.0,4.0,4.0,3.0,2.0,2.0,4.0,4.0,2.0,3.0,4.0,2.0,5.0,2.0,5.0,6.0,2.0,4.0,2.0,2.0,4.0,2.0,6.0,10,,,,,,,,,,,,,,,,,,,,,,,,,,,,,,,,,2,4.0,2.0,2.0,5.0,3.0,5.0,4.0,2.0,3.0,4.0,3.0,2.0,4.0,2.0,4.0,5.0,4.0,3.0,4.0,3.0,5.0,3.0,6.0,3.0,2.0,3.0,3.0,4.0,2.0,5.0,4.0,1.0,5,,,,,,,,,,,,,,,,,,,,,,,,,,,,,,,,,13,,,,,,,,,,,,,,,,,,,,,,,,,,,,,,,,,8,,,,,,,,,,,,,,,,,,,,,,,,,,,,,,,,,4,,,,,,,,,,,,,,,,,,,,,,,,,,,,,,,,,7,,,,,,,,,,,,,,,,,,,,,,,,,,,,,,,,,6,,,,,,,,,,,,,,,,,,,,,,,,,,,,,,,,,3,,,,,,,,,,,,,,,,,,,,,,,,,,,,,,,,,,447.92,43.6,,,,18.98,,42.11,,,,,,,,,,,87.11,,,,,,136.79,,,,,,110.36,,,,,,,,,,,,,,,,,,,,,,,,8.97,,APPROVED,Female,66.0,FALSE
1199,2022-03-22 03:14:31,19,en,1561428203,2022-03-22 03:07:26,2022-03-22 03:14:31,Y,Y,-oth-,Diploma,,13,,,,,,,,,,,,,,,,,,,,,,,,,,,,,,,,,7,,,,,,,,,,,,,,,,,,,,,,,,,,,,,,,,,9,,,,,,,,,,,,,,,,,,,,,,,,,,,,,,,,,0,3.0,6.0,2.0,1.0,6.0,2.0,6.0,3.0,5.0,2.0,1.0,2.0,3.0,5.0,6.0,2.0,5.0,2.0,5.0,5.0,3.0,3.0,1.0,3.0,5.0,3.0,5.0,2.0,3.0,2.0,3.0,4.0,10,,,,,,,,,,,,,,,,,,,,,,,,,,,,,,,,,12,,,,,,,,,,,,,,,,,,,,,,,,,,,,,,,,,6,,,,,,,,,,,,,,,,,,,,,,,,,,,,,,,,,3,,,,,,,,,,,,,,,,,,,,,,,,,,,,,,,,,4,,,,,,,,,,,,,,,,,,,,,,,,,,,,,,,,,14,,,,,,,,,,,,,,,,,,,,,,,,,,,,,,,,,8,,,,,,,,,,,,,,,,,,,,,,,,,,,,,,,,,5,,,,,,,,,,,,,,,,,,,,,,,,,,,,,,,,,11,,,,,,,,,,,,,,,,,,,,,,,,,,,,,,,,,1,3.0,6.0,3.0,3.0,3.0,3.0,3.0,5.0,5.0,3.0,3.0,5.0,3.0,3.0,6.0,3.0,6.0,3.0,3.0,3.0,5.0,3.0,5.0,3.0,2.0,5.0,5.0,5.0,5.0,5.0,5.0,7.0,2,2.0,6.0,3.0,2.0,5.0,3.0,7.0,2.0,6.0,3.0,3.0,3.0,3.0,5.0,6.0,2.0,6.0,3.0,2.0,2.0,3.0,2.0,2.0,3.0,3.0,3.0,5.0,3.0,5.0,5.0,3.0,1.0,,428.51,24.17,,,,13.86,,27.35,,,,,,,,,,,135.57,,,,,,,,,,,,,,,,,,,,,,,,,,,,,,114.11,,,103.97,,,9.48,,APPROVED,Female,43.0,FALSE
1200,2022-03-22 03:14:17,19,en,1416965174,2022-03-22 03:07:27,2022-03-22 03:14:17,Y,Y,A2,,,4,,,,,,,,,,,,,,,,,,,,,,,,,,,,,,,,,12,,,,,,,,,,,,,,,,,,,,,,,,,,,,,,,,,6,,,,,,,,,,,,,,,,,,,,,,,,,,,,,,,,,14,,,,,,,,,,,,,,,,,,,,,,,,,,,,,,,,,1,5.0,2.0,5.0,5.0,3.0,3.0,5.0,3.0,4.0,4.0,3.0,5.0,5.0,4.0,5.0,4.0,6.0,4.0,4.0,4.0,4.0,5.0,3.0,4.0,5.0,6.0,5.0,4.0,5.0,4.0,5.0,7.0,9,,,,,,,,,,,,,,,,,,,,,,,,,,,,,,,,,2,2.0,2.0,3.0,2.0,3.0,2.0,6.0,4.0,2.0,2.0,2.0,2.0,2.0,3.0,4.0,2.0,5.0,2.0,2.0,3.0,2.0,2.0,3.0,2.0,2.0,4.0,7.0,2.0,2.0,2.0,4.0,7.0,5,,,,,,,,,,,,,,,,,,,,,,,,,,,,,,,,,13,,,,,,,,,,,,,,,,,,,,,,,,,,,,,,,,,11,,,,,,,,,,,,,,,,,,,,,,,,,,,,,,,,,0,2.0,5.0,2.0,2.0,2.0,2.0,5.0,5.0,5.0,4.0,4.0,2.0,2.0,5.0,3.0,1.0,4.0,2.0,2.0,2.0,2.0,4.0,2.0,2.0,3.0,2.0,4.0,3.0,3.0,3.0,2.0,4.0,10,,,,,,,,,,,,,,,,,,,,,,,,,,,,,,,,,3,,,,,,,,,,,,,,,,,,,,,,,,,,,,,,,,,8,,,,,,,,,,,,,,,,,,,,,,,,,,,,,,,,,7,,,,,,,,,,,,,,,,,,,,,,,,,,,,,,,,,,413.1,19.44,,,,8.97,,26.91,,,,,,,,,,,,,,98.4,,,,,,160.81,,,,,,,,,,,,94.75,,,,,,,,,,,,,,,3.82,,APPROVED,Male,24.0,FALSE
1201,2022-03-22 03:16:50,19,en,1627696614,2022-03-22 03:07:29,2022-03-22 03:16:50,Y,Y,A1,,,11,,,,,,,,,,,,,,,,,,,,,,,,,,,,,,,,,12,,,,,,,,,,,,,,,,,,,,,,,,,,,,,,,,,9,,,,,,,,,,,,,,,,,,,,,,,,,,,,,,,,,1,6.0,7.0,6.0,6.0,6.0,7.0,6.0,7.0,7.0,6.0,6.0,6.0,7.0,6.0,6.0,7.0,6.0,7.0,7.0,7.0,6.0,6.0,7.0,7.0,7.0,7.0,6.0,6.0,6.0,5.0,7.0,4.0,4,,,,,,,,,,,,,,,,,,,,,,,,,,,,,,,,,0,6.0,6.0,6.0,5.0,6.0,5.0,6.0,6.0,6.0,5.0,6.0,5.0,5.0,5.0,6.0,5.0,6.0,5.0,6.0,6.0,5.0,6.0,5.0,6.0,6.0,5.0,5.0,6.0,5.0,6.0,6.0,6.0,2,5.0,6.0,5.0,5.0,5.0,6.0,7.0,5.0,6.0,6.0,6.0,5.0,5.0,5.0,5.0,6.0,5.0,5.0,5.0,5.0,5.0,6.0,5.0,5.0,6.0,5.0,5.0,5.0,5.0,5.0,5.0,7.0,8,,,,,,,,,,,,,,,,,,,,,,,,,,,,,,,,,14,,,,,,,,,,,,,,,,,,,,,,,,,,,,,,,,,3,,,,,,,,,,,,,,,,,,,,,,,,,,,,,,,,,10,,,,,,,,,,,,,,,,,,,,,,,,,,,,,,,,,7,,,,,,,,,,,,,,,,,,,,,,,,,,,,,,,,,5,,,,,,,,,,,,,,,,,,,,,,,,,,,,,,,,,13,,,,,,,,,,,,,,,,,,,,,,,,,,,,,,,,,6,,,,,,,,,,,,,,,,,,,,,,,,,,,,,,,,,the second looked much more appea;ing and professional then the other two.,565.14,79.71,,,,34.8,,43.24,,,,,,,,,,,79.27,,,,,,125.51,,,149.6,,,,,,,,,,,,,,,,,,,,,,,,,,,53.01,,APPROVED,Male,37.0,FALSE
1202,2022-03-22 03:15:18,19,en,443302955,2022-03-22 03:07:33,2022-03-22 03:15:18,Y,Y,-oth-,A Level ,,7,,,,,,,,,,,,,,,,,,,,,,,,,,,,,,,,,3,,,,,,,,,,,,,,,,,,,,,,,,,,,,,,,,,0,6.0,7.0,6.0,6.0,5.0,6.0,2.0,6.0,7.0,4.0,7.0,6.0,5.0,5.0,7.0,6.0,6.0,5.0,6.0,5.0,5.0,6.0,4.0,6.0,6.0,4.0,6.0,6.0,6.0,6.0,6.0,1.0,10,,,,,,,,,,,,,,,,,,,,,,,,,,,,,,,,,4,,,,,,,,,,,,,,,,,,,,,,,,,,,,,,,,,1,2.0,2.0,2.0,2.0,2.0,2.0,6.0,4.0,5.0,2.0,2.0,3.0,2.0,2.0,6.0,2.0,5.0,2.0,2.0,2.0,2.0,2.0,3.0,2.0,2.0,4.0,6.0,2.0,4.0,2.0,2.0,6.0,14,,,,,,,,,,,,,,,,,,,,,,,,,,,,,,,,,5,,,,,,,,,,,,,,,,,,,,,,,,,,,,,,,,,2,2.0,2.0,2.0,4.0,2.0,2.0,5.0,2.0,3.0,2.0,2.0,2.0,2.0,2.0,5.0,2.0,5.0,2.0,3.0,2.0,3.0,3.0,2.0,2.0,2.0,2.0,5.0,2.0,5.0,2.0,2.0,2.0,9,,,,,,,,,,,,,,,,,,,,,,,,,,,,,,,,,8,,,,,,,,,,,,,,,,,,,,,,,,,,,,,,,,,12,,,,,,,,,,,,,,,,,,,,,,,,,,,,,,,,,13,,,,,,,,,,,,,,,,,,,,,,,,,,,,,,,,,11,,,,,,,,,,,,,,,,,,,,,,,,,,,,,,,,,6,,,,,,,,,,,,,,,,,,,,,,,,,,,,,,,,,A very interesting and engaging study.,467.83,13.39,,,,17.53,,70.35,,,,,,,,128.55,,,,,,,,,117.52,,,,,,,,,104.99,,,,,,,,,,,,,,,,,,,,,15.5,,APPROVED,Male,59.0,FALSE
1203,2022-03-22 03:12:18,19,en,2010736419,2022-03-22 03:07:36,2022-03-22 03:12:18,Y,Y,A1,,,7,,,,,,,,,,,,,,,,,,,,,,,,,,,,,,,,,2,4.0,4.0,4.0,4.0,3.0,4.0,4.0,5.0,4.0,4.0,4.0,4.0,4.0,4.0,3.0,4.0,4.0,4.0,3.0,4.0,4.0,3.0,4.0,4.0,4.0,4.0,4.0,3.0,4.0,4.0,4.0,2.0,3,,,,,,,,,,,,,,,,,,,,,,,,,,,,,,,,,9,,,,,,,,,,,,,,,,,,,,,,,,,,,,,,,,,0,4.0,5.0,3.0,2.0,4.0,2.0,4.0,3.0,2.0,4.0,4.0,4.0,4.0,4.0,5.0,2.0,4.0,3.0,4.0,4.0,3.0,3.0,3.0,2.0,3.0,3.0,3.0,3.0,2.0,3.0,4.0,5.0,13,,,,,,,,,,,,,,,,,,,,,,,,,,,,,,,,,11,,,,,,,,,,,,,,,,,,,,,,,,,,,,,,,,,12,,,,,,,,,,,,,,,,,,,,,,,,,,,,,,,,,1,4.0,7.0,4.0,4.0,4.0,3.0,3.0,4.0,3.0,3.0,2.0,3.0,3.0,3.0,6.0,4.0,5.0,5.0,4.0,3.0,5.0,4.0,4.0,3.0,4.0,3.0,3.0,4.0,4.0,3.0,3.0,2.0,14,,,,,,,,,,,,,,,,,,,,,,,,,,,,,,,,,5,,,,,,,,,,,,,,,,,,,,,,,,,,,,,,,,,6,,,,,,,,,,,,,,,,,,,,,,,,,,,,,,,,,10,,,,,,,,,,,,,,,,,,,,,,,,,,,,,,,,,8,,,,,,,,,,,,,,,,,,,,,,,,,,,,,,,,,4,,,,,,,,,,,,,,,,,,,,,,,,,,,,,,,,,,285.66,55.59,,,,7.91,,35.65,,,,,46.21,,,,,,,,,85.8,,,,,,,,,,,,49.94,,,,,,,,,,,,,,,,,,,,,4.56,,APPROVED,Female,25.0,FALSE
1204,2022-03-22 03:13:51,19,en,580597617,2022-03-22 03:07:36,2022-03-22 03:13:51,Y,Y,A1,,,5,,,,,,,,,,,,,,,,,,,,,,,,,,,,,,,,,14,,,,,,,,,,,,,,,,,,,,,,,,,,,,,,,,,13,,,,,,,,,,,,,,,,,,,,,,,,,,,,,,,,,0,6.0,7.0,6.0,6.0,7.0,3.0,4.0,6.0,7.0,6.0,6.0,6.0,6.0,6.0,7.0,6.0,6.0,3.0,7.0,5.0,4.0,7.0,5.0,6.0,6.0,4.0,5.0,6.0,4.0,5.0,6.0,4.0,11,,,,,,,,,,,,,,,,,,,,,,,,,,,,,,,,,7,,,,,,,,,,,,,,,,,,,,,,,,,,,,,,,,,9,,,,,,,,,,,,,,,,,,,,,,,,,,,,,,,,,12,,,,,,,,,,,,,,,,,,,,,,,,,,,,,,,,,1,3.0,2.0,3.0,4.0,3.0,3.0,5.0,5.0,3.0,2.0,5.0,2.0,3.0,2.0,2.0,4.0,5.0,3.0,4.0,3.0,3.0,3.0,5.0,3.0,5.0,4.0,3.0,5.0,2.0,3.0,4.0,2.0,2,5.0,5.0,5.0,4.0,4.0,2.0,6.0,6.0,3.0,5.0,4.0,5.0,6.0,3.0,5.0,3.0,6.0,4.0,5.0,4.0,5.0,4.0,3.0,5.0,3.0,4.0,4.0,5.0,4.0,4.0,3.0,3.0,4,,,,,,,,,,,,,,,,,,,,,,,,,,,,,,,,,3,,,,,,,,,,,,,,,,,,,,,,,,,,,,,,,,,8,,,,,,,,,,,,,,,,,,,,,,,,,,,,,,,,,6,,,,,,,,,,,,,,,,,,,,,,,,,,,,,,,,,10,,,,,,,,,,,,,,,,,,,,,,,,,,,,,,,,,,378.57,53.77,,,,14.6,,37.5,,,,,,,,,,,97.56,,,,,,,,,,,,,,,93.42,,,77.27,,,,,,,,,,,,,,,,,,4.45,,APPROVED,Female,27.0,FALSE
1205,2022-03-22 03:14:19,19,en,1997451564,2022-03-22 03:07:39,2022-03-22 03:14:19,Y,Y,-oth-,less than high school,,3,,,,,,,,,,,,,,,,,,,,,,,,,,,,,,,,,0,5.0,1.0,5.0,5.0,3.0,6.0,2.0,6.0,2.0,3.0,5.0,2.0,6.0,2.0,3.0,5.0,3.0,3.0,5.0,3.0,2.0,7.0,7.0,5.0,3.0,6.0,2.0,5.0,2.0,5.0,6.0,2.0,11,,,,,,,,,,,,,,,,,,,,,,,,,,,,,,,,,5,,,,,,,,,,,,,,,,,,,,,,,,,,,,,,,,,1,3.0,3.0,2.0,3.0,2.0,1.0,7.0,5.0,5.0,2.0,1.0,3.0,3.0,5.0,3.0,2.0,6.0,2.0,3.0,2.0,3.0,2.0,2.0,2.0,2.0,4.0,5.0,2.0,2.0,2.0,2.0,5.0,13,,,,,,,,,,,,,,,,,,,,,,,,,,,,,,,,,12,,,,,,,,,,,,,,,,,,,,,,,,,,,,,,,,,7,,,,,,,,,,,,,,,,,,,,,,,,,,,,,,,,,4,,,,,,,,,,,,,,,,,,,,,,,,,,,,,,,,,2,5.0,7.0,6.0,5.0,2.0,2.0,5.0,5.0,7.0,2.0,6.0,3.0,5.0,5.0,5.0,4.0,6.0,2.0,5.0,5.0,2.0,5.0,2.0,6.0,5.0,5.0,5.0,5.0,5.0,6.0,2.0,3.0,8,,,,,,,,,,,,,,,,,,,,,,,,,,,,,,,,,6,,,,,,,,,,,,,,,,,,,,,,,,,,,,,,,,,14,,,,,,,,,,,,,,,,,,,,,,,,,,,,,,,,,9,,,,,,,,,,,,,,,,,,,,,,,,,,,,,,,,,10,,,,,,,,,,,,,,,,,,,,,,,,,,,,,,,,,,401.26,50.44,,,,39.08,,26.61,,,,,101.9,,,,,,,,,81.01,,,,,,,,,,,,,,,99.16,,,,,,,,,,,,,,,,,,3.06,,APPROVED,Male,32.0,FALSE
1206,2022-03-22 03:15:50,19,en,1452996352,2022-03-22 03:07:42,2022-03-22 03:15:50,Y,Y,A1,,,13,,,,,,,,,,,,,,,,,,,,,,,,,,,,,,,,,14,,,,,,,,,,,,,,,,,,,,,,,,,,,,,,,,,3,,,,,,,,,,,,,,,,,,,,,,,,,,,,,,,,,6,,,,,,,,,,,,,,,,,,,,,,,,,,,,,,,,,12,,,,,,,,,,,,,,,,,,,,,,,,,,,,,,,,,11,,,,,,,,,,,,,,,,,,,,,,,,,,,,,,,,,1,1.0,4.0,1.0,2.0,1.0,1.0,3.0,2.0,4.0,1.0,1.0,2.0,1.0,2.0,2.0,3.0,2.0,1.0,2.0,2.0,3.0,2.0,1.0,1.0,1.0,3.0,4.0,1.0,2.0,2.0,2.0,7.0,7,,,,,,,,,,,,,,,,,,,,,,,,,,,,,,,,,5,,,,,,,,,,,,,,,,,,,,,,,,,,,,,,,,,9,,,,,,,,,,,,,,,,,,,,,,,,,,,,,,,,,0,2.0,3.0,3.0,4.0,2.0,2.0,4.0,1.0,5.0,3.0,2.0,4.0,4.0,3.0,5.0,3.0,5.0,3.0,5.0,4.0,5.0,4.0,4.0,4.0,3.0,3.0,2.0,5.0,3.0,3.0,3.0,4.0,10,,,,,,,,,,,,,,,,,,,,,,,,,,,,,,,,,2,3.0,1.0,1.0,2.0,2.0,4.0,2.0,4.0,2.0,1.0,2.0,3.0,3.0,2.0,4.0,2.0,1.0,1.0,2.0,1.0,3.0,2.0,2.0,1.0,3.0,3.0,2.0,2.0,2.0,2.0,2.0,6.0,4,,,,,,,,,,,,,,,,,,,,,,,,,,,,,,,,,8,,,,,,,,,,,,,,,,,,,,,,,,,,,,,,,,,,490.07,56.05,,,,22.69,,88.03,,,,,,,,,,,,,,,,,,,,101.42,,,,,,,,,,,,135.4,,,,,,80.38,,,,,,,,,6.1,,APPROVED,Male,26.0,FALSE
1207,2022-03-22 03:11:16,19,en,104661088,2022-03-22 03:07:43,2022-03-22 03:11:16,Y,Y,A1,,,7,,,,,,,,,,,,,,,,,,,,,,,,,,,,,,,,,4,,,,,,,,,,,,,,,,,,,,,,,,,,,,,,,,,8,,,,,,,,,,,,,,,,,,,,,,,,,,,,,,,,,12,,,,,,,,,,,,,,,,,,,,,,,,,,,,,,,,,1,1.0,1.0,1.0,2.0,1.0,1.0,7.0,4.0,1.0,1.0,1.0,1.0,1.0,1.0,1.0,1.0,1.0,1.0,3.0,1.0,1.0,1.0,1.0,1.0,1.0,2.0,1.0,1.0,1.0,1.0,1.0,5.0,13,,,,,,,,,,,,,,,,,,,,,,,,,,,,,,,,,14,,,,,,,,,,,,,,,,,,,,,,,,,,,,,,,,,2,1.0,1.0,1.0,1.0,1.0,1.0,7.0,1.0,1.0,1.0,1.0,1.0,1.0,1.0,1.0,1.0,1.0,1.0,1.0,1.0,1.0,1.0,1.0,1.0,1.0,1.0,1.0,1.0,1.0,1.0,1.0,1.0,10,,,,,,,,,,,,,,,,,,,,,,,,,,,,,,,,,3,,,,,,,,,,,,,,,,,,,,,,,,,,,,,,,,,9,,,,,,,,,,,,,,,,,,,,,,,,,,,,,,,,,0,1.0,2.0,1.0,1.0,5.0,1.0,7.0,5.0,1.0,1.0,1.0,1.0,1.0,1.0,1.0,1.0,4.0,4.0,1.0,1.0,1.0,4.0,1.0,1.0,1.0,1.0,1.0,2.0,1.0,1.0,1.0,5.0,5,,,,,,,,,,,,,,,,,,,,,,,,,,,,,,,,,6,,,,,,,,,,,,,,,,,,,,,,,,,,,,,,,,,11,,,,,,,,,,,,,,,,,,,,,,,,,,,,,,,,,,216.53,26.39,,,,4.1,,47.93,,,,,,,,,,,,,,47.69,,,,,,,,,34.29,,,,,,,,,,,,51.03,,,,,,,,,,,,5.1,,APPROVED,Male,32.0,FALSE
1208,2022-03-22 03:16:55,19,en,1202678868,2022-03-22 03:07:45,2022-03-22 03:16:55,Y,Y,A1,,,3,,,,,,,,,,,,,,,,,,,,,,,,,,,,,,,,,4,,,,,,,,,,,,,,,,,,,,,,,,,,,,,,,,,5,,,,,,,,,,,,,,,,,,,,,,,,,,,,,,,,,6,,,,,,,,,,,,,,,,,,,,,,,,,,,,,,,,,13,,,,,,,,,,,,,,,,,,,,,,,,,,,,,,,,,1,4.0,6.0,6.0,4.0,6.0,4.0,4.0,6.0,6.0,5.0,4.0,4.0,5.0,6.0,6.0,5.0,6.0,6.0,6.0,5.0,5.0,6.0,5.0,5.0,6.0,5.0,5.0,5.0,5.0,5.0,5.0,6.0,11,,,,,,,,,,,,,,,,,,,,,,,,,,,,,,,,,12,,,,,,,,,,,,,,,,,,,,,,,,,,,,,,,,,2,4.0,3.0,4.0,5.0,5.0,4.0,4.0,1.0,5.0,4.0,4.0,4.0,4.0,3.0,4.0,5.0,5.0,4.0,3.0,3.0,4.0,4.0,5.0,4.0,4.0,4.0,3.0,5.0,5.0,4.0,4.0,2.0,7,,,,,,,,,,,,,,,,,,,,,,,,,,,,,,,,,8,,,,,,,,,,,,,,,,,,,,,,,,,,,,,,,,,0,4.0,6.0,5.0,4.0,6.0,4.0,4.0,5.0,5.0,5.0,4.0,5.0,5.0,6.0,5.0,5.0,5.0,4.0,4.0,4.0,5.0,6.0,3.0,4.0,6.0,3.0,4.0,6.0,4.0,5.0,5.0,5.0,14,,,,,,,,,,,,,,,,,,,,,,,,,,,,,,,,,9,,,,,,,,,,,,,,,,,,,,,,,,,,,,,,,,,10,,,,,,,,,,,,,,,,,,,,,,,,,,,,,,,,,,553.31,84.36,,,,11.61,,82.05,,,,,,,,,,,,,,,,,76.89,,,,,,,,,91.37,,,,,,,,,200.22,,,,,,,,,,,,6.81,,APPROVED,Male,26.0,FALSE
1209,2022-03-22 03:12:02,19,en,1592754536,2022-03-22 03:07:47,2022-03-22 03:12:02,Y,Y,A1,,,14,,,,,,,,,,,,,,,,,,,,,,,,,,,,,,,,,7,,,,,,,,,,,,,,,,,,,,,,,,,,,,,,,,,2,3.0,4.0,3.0,3.0,3.0,3.0,5.0,3.0,4.0,3.0,3.0,3.0,4.0,3.0,3.0,2.0,3.0,4.0,2.0,3.0,3.0,3.0,3.0,4.0,2.0,2.0,4.0,2.0,3.0,2.0,2.0,3.0,13,,,,,,,,,,,,,,,,,,,,,,,,,,,,,,,,,11,,,,,,,,,,,,,,,,,,,,,,,,,,,,,,,,,8,,,,,,,,,,,,,,,,,,,,,,,,,,,,,,,,,4,,,,,,,,,,,,,,,,,,,,,,,,,,,,,,,,,0,4.0,4.0,4.0,4.0,2.0,3.0,5.0,3.0,4.0,4.0,4.0,4.0,4.0,4.0,4.0,4.0,3.0,5.0,4.0,3.0,3.0,4.0,5.0,4.0,4.0,4.0,5.0,2.0,4.0,4.0,5.0,1.0,6,,,,,,,,,,,,,,,,,,,,,,,,,,,,,,,,,3,,,,,,,,,,,,,,,,,,,,,,,,,,,,,,,,,1,7.0,6.0,7.0,7.0,6.0,7.0,3.0,6.0,6.0,7.0,6.0,6.0,6.0,6.0,6.0,7.0,6.0,6.0,7.0,7.0,6.0,6.0,7.0,7.0,6.0,6.0,6.0,6.0,7.0,6.0,7.0,4.0,9,,,,,,,,,,,,,,,,,,,,,,,,,,,,,,,,,10,,,,,,,,,,,,,,,,,,,,,,,,,,,,,,,,,12,,,,,,,,,,,,,,,,,,,,,,,,,,,,,,,,,5,,,,,,,,,,,,,,,,,,,,,,,,,,,,,,,,,,259.12,19.25,,,,5.13,,34.82,,,,,,,,55.58,,,,,,,,,,,,,,,86.67,,,,,,,,,53.82,,,,,,,,,,,,,,,3.85,,APPROVED,Female,35.0,FALSE
1211,2022-03-22 03:24:38,19,en,1366393297,2022-03-22 03:12:44,2022-03-22 03:24:38,Y,Y,-oth-,"4 years of college, no degree, graduated from technical school with certificate of high honors",,14,,,,,,,,,,,,,,,,,,,,,,,,,,,,,,,,,8,,,,,,,,,,,,,,,,,,,,,,,,,,,,,,,,,9,,,,,,,,,,,,,,,,,,,,,,,,,,,,,,,,,4,,,,,,,,,,,,,,,,,,,,,,,,,,,,,,,,,10,,,,,,,,,,,,,,,,,,,,,,,,,,,,,,,,,11,,,,,,,,,,,,,,,,,,,,,,,,,,,,,,,,,6,,,,,,,,,,,,,,,,,,,,,,,,,,,,,,,,,12,,,,,,,,,,,,,,,,,,,,,,,,,,,,,,,,,2,6.0,6.0,4.0,6.0,6.0,5.0,5.0,6.0,6.0,4.0,5.0,6.0,6.0,6.0,6.0,6.0,6.0,5.0,6.0,5.0,4.0,4.0,6.0,6.0,5.0,2.0,6.0,6.0,5.0,6.0,5.0,2.0,1,1.0,1.0,1.0,1.0,1.0,1.0,7.0,4.0,2.0,1.0,1.0,2.0,1.0,4.0,1.0,1.0,1.0,1.0,1.0,2.0,1.0,1.0,1.0,1.0,1.0,1.0,2.0,1.0,1.0,1.0,1.0,1.0,7,,,,,,,,,,,,,,,,,,,,,,,,,,,,,,,,,13,,,,,,,,,,,,,,,,,,,,,,,,,,,,,,,,,3,,,,,,,,,,,,,,,,,,,,,,,,,,,,,,,,,5,,,,,,,,,,,,,,,,,,,,,,,,,,,,,,,,,0,3.0,6.0,3.0,3.0,3.0,4.0,6.0,3.0,6.0,2.0,3.0,6.0,3.0,2.0,5.0,2.0,6.0,2.0,4.0,2.0,2.0,2.0,2.0,2.0,3.0,2.0,6.0,2.0,3.0,4.0,4.0,1.0,Interesting study.,715.95,34.4,,,,65.26,,84.69,,,,,,,,,,,,,,,,,,,,,,,,,,94.99,,,83.42,,,,,,,,,,,,,,,328.96,,,24.23,,APPROVED,Female,45.0,FALSE
1212,2022-03-22 03:16:24,19,en,153009686,2022-03-22 03:12:55,2022-03-22 03:16:24,Y,Y,A1,,,11,,,,,,,,,,,,,,,,,,,,,,,,,,,,,,,,,4,,,,,,,,,,,,,,,,,,,,,,,,,,,,,,,,,0,6.0,5.0,5.0,5.0,4.0,5.0,4.0,6.0,5.0,5.0,5.0,3.0,5.0,4.0,5.0,6.0,5.0,2.0,5.0,5.0,3.0,5.0,5.0,5.0,5.0,5.0,3.0,5.0,3.0,5.0,6.0,1.0,7,,,,,,,,,,,,,,,,,,,,,,,,,,,,,,,,,8,,,,,,,,,,,,,,,,,,,,,,,,,,,,,,,,,10,,,,,,,,,,,,,,,,,,,,,,,,,,,,,,,,,14,,,,,,,,,,,,,,,,,,,,,,,,,,,,,,,,,12,,,,,,,,,,,,,,,,,,,,,,,,,,,,,,,,,1,2.0,5.0,3.0,1.0,2.0,1.0,3.0,6.0,5.0,4.0,2.0,6.0,3.0,3.0,1.0,4.0,1.0,1.0,2.0,3.0,2.0,3.0,4.0,2.0,2.0,6.0,5.0,1.0,4.0,2.0,2.0,2.0,3,,,,,,,,,,,,,,,,,,,,,,,,,,,,,,,,,9,,,,,,,,,,,,,,,,,,,,,,,,,,,,,,,,,2,6.0,6.0,5.0,5.0,6.0,6.0,6.0,6.0,5.0,6.0,6.0,5.0,6.0,6.0,6.0,5.0,5.0,3.0,6.0,6.0,4.0,6.0,6.0,6.0,6.0,6.0,5.0,6.0,4.0,5.0,6.0,5.0,6,,,,,,,,,,,,,,,,,,,,,,,,,,,,,,,,,5,,,,,,,,,,,,,,,,,,,,,,,,,,,,,,,,,13,,,,,,,,,,,,,,,,,,,,,,,,,,,,,,,,,,212.62,13.5,,,,5.9,,34.82,,,,,,,,53.19,,,,,,,,,,,,,,,,,,57.42,,,,,,,,,44.62,,,,,,,,,,,,3.17,,APPROVED,Male,21.0,FALSE
1214,2022-03-22 03:29:29,19,en,1151500387,2022-03-22 03:16:12,2022-03-22 03:29:29,Y,Y,-oth-,college certificate,,0,3.0,5.0,2.0,3.0,2.0,3.0,5.0,6.0,4.0,4.0,2.0,2.0,3.0,3.0,2.0,1.0,3.0,3.0,3.0,1.0,2.0,5.0,1.0,3.0,2.0,2.0,4.0,3.0,4.0,2.0,4.0,1.0,6,,,,,,,,,,,,,,,,,,,,,,,,,,,,,,,,,12,,,,,,,,,,,,,,,,,,,,,,,,,,,,,,,,,2,5.0,3.0,3.0,6.0,3.0,6.0,4.0,4.0,6.0,6.0,7.0,6.0,5.0,3.0,6.0,6.0,7.0,6.0,6.0,6.0,5.0,5.0,7.0,5.0,5.0,7.0,3.0,6.0,6.0,5.0,6.0,4.0,8,,,,,,,,,,,,,,,,,,,,,,,,,,,,,,,,,4,,,,,,,,,,,,,,,,,,,,,,,,,,,,,,,,,11,,,,,,,,,,,,,,,,,,,,,,,,,,,,,,,,,9,,,,,,,,,,,,,,,,,,,,,,,,,,,,,,,,,14,,,,,,,,,,,,,,,,,,,,,,,,,,,,,,,,,13,,,,,,,,,,,,,,,,,,,,,,,,,,,,,,,,,7,,,,,,,,,,,,,,,,,,,,,,,,,,,,,,,,,5,,,,,,,,,,,,,,,,,,,,,,,,,,,,,,,,,10,,,,,,,,,,,,,,,,,,,,,,,,,,,,,,,,,3,,,,,,,,,,,,,,,,,,,,,,,,,,,,,,,,,1,6.0,6.0,7.0,6.0,6.0,6.0,4.0,6.0,4.0,5.0,5.0,4.0,6.0,5.0,6.0,5.0,5.0,6.0,7.0,6.0,6.0,6.0,3.0,6.0,6.0,3.0,3.0,5.0,4.0,5.0,5.0,1.0,,799.46,178.97,,,,25.02,,61.08,,207.93,,,,,,,,,169.86,,,,,,,,,,,,,,,,,,,,,,,,,,,,,,,,,148.03,,,8.57,,APPROVED,Male,33.0,FALSE
1215,2022-03-22 03:25:35,19,en,1630332487,2022-03-22 03:18:09,2022-03-22 03:25:35,Y,Y,A1,,,3,,,,,,,,,,,,,,,,,,,,,,,,,,,,,,,,,10,,,,,,,,,,,,,,,,,,,,,,,,,,,,,,,,,9,,,,,,,,,,,,,,,,,,,,,,,,,,,,,,,,,1,6.0,6.0,6.0,5.0,6.0,6.0,3.0,6.0,6.0,3.0,6.0,5.0,5.0,6.0,5.0,5.0,7.0,6.0,5.0,6.0,4.0,2.0,3.0,5.0,5.0,2.0,6.0,5.0,6.0,5.0,4.0,4.0,4,,,,,,,,,,,,,,,,,,,,,,,,,,,,,,,,,12,,,,,,,,,,,,,,,,,,,,,,,,,,,,,,,,,7,,,,,,,,,,,,,,,,,,,,,,,,,,,,,,,,,6,,,,,,,,,,,,,,,,,,,,,,,,,,,,,,,,,0,1.0,1.0,1.0,1.0,1.0,1.0,7.0,4.0,1.0,1.0,1.0,1.0,1.0,1.0,1.0,1.0,1.0,1.0,1.0,1.0,1.0,1.0,1.0,1.0,1.0,5.0,1.0,1.0,1.0,2.0,1.0,2.0,8,,,,,,,,,,,,,,,,,,,,,,,,,,,,,,,,,11,,,,,,,,,,,,,,,,,,,,,,,,,,,,,,,,,5,,,,,,,,,,,,,,,,,,,,,,,,,,,,,,,,,2,4.0,5.0,4.0,4.0,3.0,3.0,5.0,6.0,6.0,1.0,3.0,5.0,1.0,5.0,5.0,2.0,6.0,2.0,2.0,3.0,5.0,4.0,1.0,4.0,4.0,1.0,6.0,3.0,5.0,1.0,2.0,6.0,14,,,,,,,,,,,,,,,,,,,,,,,,,,,,,,,,,13,,,,,,,,,,,,,,,,,,,,,,,,,,,,,,,,,,449.08,127.16,,,,6.66,,29.06,,,,,,,,,,,88.92,,,,,,,,,,,,,,,75.06,,,,,,,,,,,,119.03,,,,,,,,,3.19,,APPROVED,Female,31.0,FALSE
1216,2022-03-22 03:27:13,19,en,2023860069,2022-03-22 03:20:17,2022-03-22 03:27:13,Y,Y,A2,,,11,,,,,,,,,,,,,,,,,,,,,,,,,,,,,,,,,8,,,,,,,,,,,,,,,,,,,,,,,,,,,,,,,,,0,5.0,3.0,6.0,5.0,5.0,6.0,4.0,6.0,5.0,5.0,6.0,5.0,4.0,5.0,3.0,5.0,4.0,5.0,5.0,5.0,4.0,5.0,6.0,5.0,5.0,3.0,3.0,4.0,6.0,4.0,5.0,3.0,3,,,,,,,,,,,,,,,,,,,,,,,,,,,,,,,,,1,5.0,3.0,5.0,2.0,5.0,3.0,6.0,6.0,5.0,3.0,2.0,3.0,3.0,5.0,5.0,2.0,5.0,3.0,5.0,5.0,4.0,5.0,4.0,3.0,5.0,4.0,4.0,3.0,6.0,3.0,5.0,3.0,5,,,,,,,,,,,,,,,,,,,,,,,,,,,,,,,,,12,,,,,,,,,,,,,,,,,,,,,,,,,,,,,,,,,9,,,,,,,,,,,,,,,,,,,,,,,,,,,,,,,,,6,,,,,,,,,,,,,,,,,,,,,,,,,,,,,,,,,7,,,,,,,,,,,,,,,,,,,,,,,,,,,,,,,,,10,,,,,,,,,,,,,,,,,,,,,,,,,,,,,,,,,14,,,,,,,,,,,,,,,,,,,,,,,,,,,,,,,,,4,,,,,,,,,,,,,,,,,,,,,,,,,,,,,,,,,13,,,,,,,,,,,,,,,,,,,,,,,,,,,,,,,,,2,4.0,6.0,5.0,4.0,5.0,6.0,2.0,6.0,4.0,5.0,6.0,6.0,5.0,5.0,6.0,5.0,5.0,5.0,5.0,5.0,4.0,5.0,3.0,5.0,5.0,5.0,5.0,5.0,4.0,5.0,4.0,1.0,,419.39,27.64,,,,5.78,,37.21,,,,,,,,131.48,,,,,,113.03,,,,,,,,,,,,,,,,,,,,,,,,,,,,,,96.65,,,7.6,,APPROVED,Male,46.0,FALSE
1217,2022-03-22 03:29:50,19,en,411130720,2022-03-22 03:21:12,2022-03-22 03:29:50,Y,Y,A1,,,2,6.0,6.0,6.0,5.0,6.0,4.0,3.0,7.0,7.0,5.0,4.0,5.0,7.0,6.0,5.0,4.0,7.0,5.0,6.0,6.0,4.0,6.0,4.0,6.0,6.0,6.0,4.0,7.0,4.0,5.0,6.0,1.0,5,,,,,,,,,,,,,,,,,,,,,,,,,,,,,,,,,12,,,,,,,,,,,,,,,,,,,,,,,,,,,,,,,,,11,,,,,,,,,,,,,,,,,,,,,,,,,,,,,,,,,3,,,,,,,,,,,,,,,,,,,,,,,,,,,,,,,,,1,4.0,4.0,5.0,6.0,6.0,2.0,5.0,4.0,6.0,5.0,1.0,5.0,6.0,6.0,7.0,3.0,6.0,3.0,4.0,5.0,5.0,6.0,1.0,3.0,7.0,6.0,7.0,5.0,4.0,5.0,5.0,6.0,13,,,,,,,,,,,,,,,,,,,,,,,,,,,,,,,,,10,,,,,,,,,,,,,,,,,,,,,,,,,,,,,,,,,7,,,,,,,,,,,,,,,,,,,,,,,,,,,,,,,,,1,3.0,3.0,3.0,3.0,3.0,3.0,3.0,6.0,4.0,3.0,4.0,5.0,4.0,4.0,5.0,2.0,6.0,3.0,3.0,4.0,3.0,5.0,2.0,4.0,3.0,6.0,5.0,2.0,4.0,4.0,5.0,3.0,14,,,,,,,,,,,,,,,,,,,,,,,,,,,,,,,,,9,,,,,,,,,,,,,,,,,,,,,,,,,,,,,,,,,8,,,,,,,,,,,,,,,,,,,,,,,,,,,,,,,,,6,,,,,,,,,,,,,,,,,,,,,,,,,,,,,,,,,4,,,,,,,,,,,,,,,,,,,,,,,,,,,,,,,,,,521.25,68.14,,,,15.72,,66.22,,86.23,,,,,,,,,,,,,,,134.93,,,,,,,,,,,,146.98,,,,,,,,,,,,,,,,,,3.03,,APPROVED,Male,20.0,FALSE
1218,2022-03-22 03:28:00,19,en,6147495,2022-03-22 03:23:56,2022-03-22 03:28:00,Y,Y,A1,,,7,,,,,,,,,,,,,,,,,,,,,,,,,,,,,,,,,9,,,,,,,,,,,,,,,,,,,,,,,,,,,,,,,,,10,,,,,,,,,,,,,,,,,,,,,,,,,,,,,,,,,5,,,,,,,,,,,,,,,,,,,,,,,,,,,,,,,,,6,,,,,,,,,,,,,,,,,,,,,,,,,,,,,,,,,3,,,,,,,,,,,,,,,,,,,,,,,,,,,,,,,,,14,,,,,,,,,,,,,,,,,,,,,,,,,,,,,,,,,11,,,,,,,,,,,,,,,,,,,,,,,,,,,,,,,,,13,,,,,,,,,,,,,,,,,,,,,,,,,,,,,,,,,4,,,,,,,,,,,,,,,,,,,,,,,,,,,,,,,,,2,6.0,5.0,5.0,5.0,5.0,6.0,3.0,6.0,5.0,5.0,5.0,6.0,5.0,4.0,6.0,6.0,6.0,6.0,6.0,5.0,4.0,5.0,6.0,5.0,5.0,6.0,4.0,6.0,5.0,5.0,7.0,4.0,1,6.0,4.0,2.0,4.0,4.0,4.0,4.0,6.0,4.0,4.0,2.0,4.0,4.0,4.0,4.0,4.0,6.0,2.0,4.0,4.0,3.0,4.0,3.0,4.0,5.0,4.0,4.0,4.0,4.0,4.0,4.0,5.0,8,,,,,,,,,,,,,,,,,,,,,,,,,,,,,,,,,0,4.0,3.0,3.0,4.0,4.0,4.0,4.0,6.0,4.0,3.0,3.0,5.0,3.0,3.0,4.0,4.0,4.0,3.0,4.0,4.0,2.0,4.0,5.0,4.0,4.0,4.0,2.0,4.0,3.0,3.0,4.0,7.0,12,,,,,,,,,,,,,,,,,,,,,,,,,,,,,,,,,,246.01,23.21,,,,7.93,,18.98,,,,,,,,,,,,,,,,,,,,,,,,,,,,,,,,52.1,,,60.0,,,,,,80.26,,,,,,3.53,,APPROVED,Male,26.0,FALSE
1219,2022-03-22 03:30:34,19,en,270092744,2022-03-22 03:24:02,2022-03-22 03:30:34,Y,Y,-oth-,High-school ,,5,,,,,,,,,,,,,,,,,,,,,,,,,,,,,,,,,9,,,,,,,,,,,,,,,,,,,,,,,,,,,,,,,,,10,,,,,,,,,,,,,,,,,,,,,,,,,,,,,,,,,11,,,,,,,,,,,,,,,,,,,,,,,,,,,,,,,,,6,,,,,,,,,,,,,,,,,,,,,,,,,,,,,,,,,2,5.0,5.0,5.0,4.0,4.0,5.0,4.0,5.0,5.0,4.0,4.0,5.0,5.0,4.0,5.0,4.0,5.0,5.0,5.0,4.0,4.0,4.0,5.0,5.0,4.0,5.0,4.0,5.0,4.0,4.0,5.0,6.0,0,5.0,6.0,6.0,4.0,5.0,4.0,4.0,4.0,5.0,4.0,4.0,6.0,4.0,5.0,5.0,4.0,5.0,4.0,4.0,4.0,4.0,5.0,3.0,5.0,5.0,5.0,5.0,5.0,4.0,4.0,4.0,7.0,13,,,,,,,,,,,,,,,,,,,,,,,,,,,,,,,,,1,3.0,3.0,3.0,2.0,3.0,4.0,7.0,4.0,3.0,3.0,3.0,3.0,3.0,2.0,2.0,3.0,4.0,3.0,3.0,4.0,3.0,3.0,4.0,4.0,2.0,2.0,4.0,2.0,2.0,2.0,3.0,2.0,4,,,,,,,,,,,,,,,,,,,,,,,,,,,,,,,,,12,,,,,,,,,,,,,,,,,,,,,,,,,,,,,,,,,14,,,,,,,,,,,,,,,,,,,,,,,,,,,,,,,,,7,,,,,,,,,,,,,,,,,,,,,,,,,,,,,,,,,8,,,,,,,,,,,,,,,,,,,,,,,,,,,,,,,,,3,,,,,,,,,,,,,,,,,,,,,,,,,,,,,,,,,,394.92,14.67,,,,28.47,,53.2,,,,,,,,,,,,,,,,,83.88,,,120.01,,,,,,89.27,,,,,,,,,,,,,,,,,,,,,5.42,,APPROVED,Female,26.0,FALSE
1220,2022-03-22 03:28:54,19,en,1952269460,2022-03-22 03:24:07,2022-03-22 03:28:54,Y,Y,A1,,,8,,,,,,,,,,,,,,,,,,,,,,,,,,,,,,,,,1,6.0,6.0,6.0,6.0,6.0,6.0,2.0,7.0,5.0,6.0,6.0,6.0,6.0,6.0,6.0,6.0,6.0,6.0,6.0,6.0,5.0,6.0,7.0,6.0,6.0,6.0,6.0,6.0,6.0,6.0,6.0,2.0,5,,,,,,,,,,,,,,,,,,,,,,,,,,,,,,,,,13,,,,,,,,,,,,,,,,,,,,,,,,,,,,,,,,,0,2.0,3.0,2.0,2.0,2.0,2.0,6.0,2.0,3.0,2.0,2.0,2.0,2.0,2.0,3.0,2.0,3.0,2.0,2.0,2.0,2.0,2.0,1.0,2.0,2.0,4.0,2.0,2.0,2.0,2.0,2.0,5.0,7,,,,,,,,,,,,,,,,,,,,,,,,,,,,,,,,,6,,,,,,,,,,,,,,,,,,,,,,,,,,,,,,,,,2,3.0,5.0,4.0,3.0,3.0,3.0,5.0,2.0,4.0,4.0,4.0,3.0,4.0,3.0,3.0,4.0,4.0,3.0,4.0,3.0,4.0,4.0,4.0,3.0,4.0,2.0,4.0,4.0,3.0,4.0,3.0,1.0,12,,,,,,,,,,,,,,,,,,,,,,,,,,,,,,,,,14,,,,,,,,,,,,,,,,,,,,,,,,,,,,,,,,,9,,,,,,,,,,,,,,,,,,,,,,,,,,,,,,,,,3,,,,,,,,,,,,,,,,,,,,,,,,,,,,,,,,,11,,,,,,,,,,,,,,,,,,,,,,,,,,,,,,,,,10,,,,,,,,,,,,,,,,,,,,,,,,,,,,,,,,,4,,,,,,,,,,,,,,,,,,,,,,,,,,,,,,,,,,291.13,16.56,,,,5.9,,42.77,,,,,85.21,,,,,,,,,79.42,,,,,,,,,58.36,,,,,,,,,,,,,,,,,,,,,,,,2.91,,APPROVED,Female,24.0,FALSE
1221,2022-03-22 03:47:42,19,en,1059430430,2022-03-22 03:24:09,2022-03-22 03:47:42,Y,Y,A1,,,3,,,,,,,,,,,,,,,,,,,,,,,,,,,,,,,,,13,,,,,,,,,,,,,,,,,,,,,,,,,,,,,,,,,5,,,,,,,,,,,,,,,,,,,,,,,,,,,,,,,,,0,7.0,7.0,6.0,5.0,6.0,4.0,4.0,7.0,7.0,5.0,5.0,6.0,6.0,4.0,6.0,4.0,6.0,7.0,6.0,5.0,4.0,7.0,4.0,6.0,6.0,6.0,5.0,4.0,4.0,6.0,6.0,4.0,7,,,,,,,,,,,,,,,,,,,,,,,,,,,,,,,,,10,,,,,,,,,,,,,,,,,,,,,,,,,,,,,,,,,8,,,,,,,,,,,,,,,,,,,,,,,,,,,,,,,,,14,,,,,,,,,,,,,,,,,,,,,,,,,,,,,,,,,9,,,,,,,,,,,,,,,,,,,,,,,,,,,,,,,,,1,4.0,7.0,5.0,4.0,4.0,4.0,7.0,7.0,5.0,3.0,5.0,4.0,4.0,4.0,4.0,3.0,4.0,4.0,4.0,4.0,3.0,5.0,2.0,6.0,5.0,5.0,4.0,4.0,5.0,4.0,5.0,3.0,12,,,,,,,,,,,,,,,,,,,,,,,,,,,,,,,,,11,,,,,,,,,,,,,,,,,,,,,,,,,,,,,,,,,2,3.0,4.0,2.0,2.0,3.0,3.0,6.0,6.0,3.0,3.0,4.0,3.0,4.0,2.0,4.0,3.0,3.0,3.0,4.0,4.0,1.0,3.0,5.0,4.0,4.0,4.0,2.0,3.0,3.0,4.0,4.0,6.0,4,,,,,,,,,,,,,,,,,,,,,,,,,,,,,,,,,6,,,,,,,,,,,,,,,,,,,,,,,,,,,,,,,,,"No, none, thanks you!!",1415.73,34.47,,,,9.39,,44.73,,,,,,,,,,,137.58,,,,,,,,,,,,,,,,,,676.7,,,,,,,,,474.24,,,,,,,,,38.62,,APPROVED,Female,25.0,FALSE
1223,2022-03-22 03:29:57,19,en,2020177854,2022-03-22 03:24:20,2022-03-22 03:29:57,Y,Y,A3,,,11,,,,,,,,,,,,,,,,,,,,,,,,,,,,,,,,,14,,,,,,,,,,,,,,,,,,,,,,,,,,,,,,,,,0,5.0,6.0,6.0,6.0,7.0,5.0,5.0,4.0,5.0,5.0,6.0,5.0,6.0,6.0,5.0,6.0,6.0,6.0,6.0,6.0,6.0,6.0,6.0,5.0,6.0,3.0,6.0,1.0,6.0,6.0,6.0,3.0,13,,,,,,,,,,,,,,,,,,,,,,,,,,,,,,,,,7,,,,,,,,,,,,,,,,,,,,,,,,,,,,,,,,,4,,,,,,,,,,,,,,,,,,,,,,,,,,,,,,,,,5,,,,,,,,,,,,,,,,,,,,,,,,,,,,,,,,,10,,,,,,,,,,,,,,,,,,,,,,,,,,,,,,,,,9,,,,,,,,,,,,,,,,,,,,,,,,,,,,,,,,,2,3.0,2.0,3.0,2.0,3.0,2.0,2.0,3.0,3.0,5.0,2.0,2.0,2.0,5.0,5.0,6.0,2.0,3.0,5.0,2.0,2.0,5.0,3.0,2.0,2.0,6.0,3.0,6.0,2.0,5.0,2.0,3.0,1,2.0,5.0,7.0,6.0,5.0,4.0,6.0,6.0,5.0,6.0,3.0,5.0,6.0,6.0,5.0,4.0,6.0,6.0,6.0,4.0,5.0,5.0,3.0,2.0,4.0,2.0,6.0,5.0,3.0,7.0,5.0,4.0,12,,,,,,,,,,,,,,,,,,,,,,,,,,,,,,,,,3,,,,,,,,,,,,,,,,,,,,,,,,,,,,,,,,,8,,,,,,,,,,,,,,,,,,,,,,,,,,,,,,,,,6,,,,,,,,,,,,,,,,,,,,,,,,,,,,,,,,,,340.19,6.74,,,,9.38,,23.24,,,,,,,,214.34,,,,,,,,,,,,,,,,,,,,,35.02,,,48.89,,,,,,,,,,,,,,,2.58,,APPROVED,Male,22.0,FALSE
1224,2022-03-22 03:32:54,19,en,232736634,2022-03-22 03:24:20,2022-03-22 03:32:54,Y,Y,-oth-,highschool,,10,,,,,,,,,,,,,,,,,,,,,,,,,,,,,,,,,11,,,,,,,,,,,,,,,,,,,,,,,,,,,,,,,,,5,,,,,,,,,,,,,,,,,,,,,,,,,,,,,,,,,8,,,,,,,,,,,,,,,,,,,,,,,,,,,,,,,,,7,,,,,,,,,,,,,,,,,,,,,,,,,,,,,,,,,4,,,,,,,,,,,,,,,,,,,,,,,,,,,,,,,,,0,2.0,7.0,6.0,1.0,7.0,7.0,6.0,7.0,6.0,6.0,7.0,7.0,7.0,5.0,7.0,7.0,6.0,2.0,7.0,1.0,3.0,6.0,7.0,6.0,7.0,7.0,2.0,7.0,3.0,4.0,7.0,7.0,12,,,,,,,,,,,,,,,,,,,,,,,,,,,,,,,,,9,,,,,,,,,,,,,,,,,,,,,,,,,,,,,,,,,3,,,,,,,,,,,,,,,,,,,,,,,,,,,,,,,,,13,,,,,,,,,,,,,,,,,,,,,,,,,,,,,,,,,14,,,,,,,,,,,,,,,,,,,,,,,,,,,,,,,,,6,,,,,,,,,,,,,,,,,,,,,,,,,,,,,,,,,1,5.0,3.0,6.0,5.0,2.0,3.0,6.0,3.0,2.0,5.0,1.0,6.0,6.0,6.0,5.0,5.0,7.0,5.0,6.0,1.0,6.0,6.0,5.0,6.0,5.0,6.0,6.0,6.0,5.0,5.0,6.0,7.0,2,4.0,5.0,3.0,2.0,3.0,1.0,5.0,3.0,6.0,5.0,5.0,6.0,3.0,5.0,6.0,6.0,5.0,3.0,5.0,1.0,5.0,5.0,1.0,3.0,4.0,3.0,6.0,2.0,6.0,3.0,4.0,1.0,,517.71,39.72,,,,28.93,,34.62,,,,,,,,,,,,,,,,,,,,185.05,,,,,,,,,,,,,,,,,,,,,117.78,,,109.06,,,2.55,,APPROVED,Male,22.0,FALSE
1225,2022-03-22 03:27:06,19,en,562878739,2022-03-22 03:24:21,2022-03-22 03:27:06,Y,Y,A1,,,11,,,,,,,,,,,,,,,,,,,,,,,,,,,,,,,,,4,,,,,,,,,,,,,,,,,,,,,,,,,,,,,,,,,12,,,,,,,,,,,,,,,,,,,,,,,,,,,,,,,,,6,,,,,,,,,,,,,,,,,,,,,,,,,,,,,,,,,1,5.0,5.0,5.0,5.0,4.0,5.0,4.0,5.0,5.0,5.0,4.0,4.0,5.0,4.0,5.0,4.0,5.0,4.0,4.0,5.0,4.0,5.0,4.0,4.0,4.0,4.0,4.0,5.0,4.0,4.0,4.0,5.0,3,,,,,,,,,,,,,,,,,,,,,,,,,,,,,,,,,8,,,,,,,,,,,,,,,,,,,,,,,,,,,,,,,,,10,,,,,,,,,,,,,,,,,,,,,,,,,,,,,,,,,5,,,,,,,,,,,,,,,,,,,,,,,,,,,,,,,,,13,,,,,,,,,,,,,,,,,,,,,,,,,,,,,,,,,14,,,,,,,,,,,,,,,,,,,,,,,,,,,,,,,,,9,,,,,,,,,,,,,,,,,,,,,,,,,,,,,,,,,0,4.0,5.0,3.0,4.0,4.0,4.0,4.0,6.0,5.0,3.0,5.0,5.0,4.0,5.0,2.0,2.0,5.0,4.0,4.0,5.0,3.0,5.0,3.0,3.0,3.0,4.0,3.0,4.0,2.0,4.0,5.0,6.0,7,,,,,,,,,,,,,,,,,,,,,,,,,,,,,,,,,2,4.0,3.0,3.0,3.0,4.0,3.0,3.0,5.0,3.0,3.0,3.0,5.0,3.0,3.0,5.0,3.0,5.0,3.0,3.0,3.0,3.0,3.0,6.0,3.0,3.0,5.0,5.0,3.0,5.0,3.0,5.0,1.0,,167.73,11.96,,,,5.86,,11.19,,,,,,,,,,,,,,33.16,,,,,,,,,,,,,,,,,,,,,,,,64.98,,,,,,38.15,,,2.43,,APPROVED,Male,25.0,FALSE
1227,2022-03-22 03:31:44,19,en,1751572932,2022-03-22 03:24:24,2022-03-22 03:31:44,Y,Y,A1,,,9,,,,,,,,,,,,,,,,,,,,,,,,,,,,,,,,,13,,,,,,,,,,,,,,,,,,,,,,,,,,,,,,,,,7,,,,,,,,,,,,,,,,,,,,,,,,,,,,,,,,,5,,,,,,,,,,,,,,,,,,,,,,,,,,,,,,,,,8,,,,,,,,,,,,,,,,,,,,,,,,,,,,,,,,,4,,,,,,,,,,,,,,,,,,,,,,,,,,,,,,,,,6,,,,,,,,,,,,,,,,,,,,,,,,,,,,,,,,,2,3.0,6.0,5.0,5.0,3.0,2.0,4.0,6.0,6.0,3.0,3.0,5.0,5.0,3.0,5.0,3.0,5.0,3.0,3.0,3.0,4.0,5.0,2.0,5.0,3.0,2.0,2.0,6.0,3.0,5.0,5.0,1.0,12,,,,,,,,,,,,,,,,,,,,,,,,,,,,,,,,,10,,,,,,,,,,,,,,,,,,,,,,,,,,,,,,,,,0,3.0,5.0,6.0,6.0,5.0,2.0,6.0,6.0,7.0,5.0,3.0,4.0,5.0,3.0,5.0,2.0,2.0,3.0,6.0,5.0,2.0,4.0,2.0,4.0,4.0,1.0,7.0,5.0,2.0,5.0,1.0,4.0,3,,,,,,,,,,,,,,,,,,,,,,,,,,,,,,,,,14,,,,,,,,,,,,,,,,,,,,,,,,,,,,,,,,,1,5.0,6.0,5.0,6.0,5.0,5.0,5.0,7.0,7.0,6.0,5.0,5.0,5.0,5.0,6.0,4.0,6.0,5.0,5.0,4.0,5.0,5.0,7.0,5.0,3.0,7.0,3.0,5.0,4.0,4.0,7.0,7.0,11,,,,,,,,,,,,,,,,,,,,,,,,,,,,,,,,,,444.46,26.85,,,,9.74,,121.84,,,,,,,,,,,,,,,,,,,,,,,84.5,,,,,,,,,95.18,,,,,,,,,79.47,,,,,,26.88,,APPROVED,Male,23.0,FALSE
1228,2022-03-22 03:28:44,19,en,700874309,2022-03-22 03:24:25,2022-03-22 03:28:44,Y,Y,A1,,,2,3.0,4.0,3.0,5.0,5.0,4.0,7.0,4.0,5.0,2.0,3.0,5.0,3.0,4.0,4.0,4.0,5.0,3.0,3.0,2.0,2.0,3.0,3.0,3.0,2.0,5.0,4.0,4.0,3.0,3.0,4.0,1.0,13,,,,,,,,,,,,,,,,,,,,,,,,,,,,,,,,,6,,,,,,,,,,,,,,,,,,,,,,,,,,,,,,,,,10,,,,,,,,,,,,,,,,,,,,,,,,,,,,,,,,,11,,,,,,,,,,,,,,,,,,,,,,,,,,,,,,,,,3,,,,,,,,,,,,,,,,,,,,,,,,,,,,,,,,,7,,,,,,,,,,,,,,,,,,,,,,,,,,,,,,,,,8,,,,,,,,,,,,,,,,,,,,,,,,,,,,,,,,,14,,,,,,,,,,,,,,,,,,,,,,,,,,,,,,,,,0,2.0,1.0,2.0,4.0,2.0,2.0,6.0,1.0,1.0,1.0,4.0,1.0,2.0,4.0,4.0,2.0,5.0,1.0,2.0,1.0,1.0,2.0,2.0,3.0,1.0,6.0,3.0,1.0,2.0,2.0,1.0,3.0,9,,,,,,,,,,,,,,,,,,,,,,,,,,,,,,,,,1,5.0,5.0,5.0,5.0,5.0,4.0,3.0,7.0,2.0,5.0,6.0,5.0,5.0,4.0,6.0,5.0,5.0,6.0,5.0,5.0,2.0,5.0,5.0,5.0,5.0,5.0,3.0,5.0,5.0,4.0,5.0,5.0,5,,,,,,,,,,,,,,,,,,,,,,,,,,,,,,,,,12,,,,,,,,,,,,,,,,,,,,,,,,,,,,,,,,,4,,,,,,,,,,,,,,,,,,,,,,,,,,,,,,,,,,261.21,15.12,,,,5.45,,22.11,,76.95,,,,,,,,,,,,,,,,,,,,,,,,,,,67.81,,,,,,71.39,,,,,,,,,,,,2.38,,APPROVED,Female,26.0,FALSE
1229,2022-03-22 03:30:07,19,en,1926787340,2022-03-22 03:24:27,2022-03-22 03:30:07,Y,Y,A1,,,1,5.0,7.0,4.0,4.0,4.0,4.0,3.0,6.0,6.0,5.0,5.0,5.0,6.0,5.0,7.0,4.0,6.0,6.0,6.0,6.0,4.0,5.0,3.0,5.0,6.0,3.0,3.0,4.0,6.0,3.0,5.0,1.0,12,,,,,,,,,,,,,,,,,,,,,,,,,,,,,,,,,2,4.0,6.0,5.0,3.0,4.0,3.0,5.0,5.0,6.0,3.0,4.0,3.0,2.0,3.0,2.0,3.0,6.0,2.0,1.0,5.0,2.0,3.0,1.0,3.0,5.0,2.0,2.0,3.0,5.0,5.0,3.0,3.0,5,,,,,,,,,,,,,,,,,,,,,,,,,,,,,,,,,11,,,,,,,,,,,,,,,,,,,,,,,,,,,,,,,,,7,,,,,,,,,,,,,,,,,,,,,,,,,,,,,,,,,10,,,,,,,,,,,,,,,,,,,,,,,,,,,,,,,,,14,,,,,,,,,,,,,,,,,,,,,,,,,,,,,,,,,9,,,,,,,,,,,,,,,,,,,,,,,,,,,,,,,,,3,,,,,,,,,,,,,,,,,,,,,,,,,,,,,,,,,8,,,,,,,,,,,,,,,,,,,,,,,,,,,,,,,,,4,,,,,,,,,,,,,,,,,,,,,,,,,,,,,,,,,0,3.0,2.0,5.0,1.0,5.0,3.0,6.0,5.0,5.0,1.0,2.0,1.0,1.0,2.0,1.0,3.0,4.0,1.0,1.0,1.0,1.0,2.0,1.0,2.0,4.0,4.0,3.0,1.0,3.0,5.0,1.0,6.0,6,,,,,,,,,,,,,,,,,,,,,,,,,,,,,,,,,13,,,,,,,,,,,,,,,,,,,,,,,,,,,,,,,,,,343.41,29.55,,,,6.53,,35.83,,91.97,,,,,,73.71,,,,,,,,,,,,,,,,,,,,,,,,,,,,,,101.55,,,,,,,,,4.27,,APPROVED,Male,56.0,FALSE
1232,2022-03-22 03:30:03,19,en,1037609169,2022-03-22 03:24:39,2022-03-22 03:30:03,Y,Y,A1,,,8,,,,,,,,,,,,,,,,,,,,,,,,,,,,,,,,,13,,,,,,,,,,,,,,,,,,,,,,,,,,,,,,,,,2,6.0,7.0,7.0,7.0,6.0,6.0,2.0,7.0,7.0,6.0,6.0,6.0,6.0,6.0,6.0,7.0,6.0,6.0,6.0,6.0,5.0,6.0,6.0,6.0,6.0,6.0,5.0,7.0,4.0,5.0,7.0,3.0,11,,,,,,,,,,,,,,,,,,,,,,,,,,,,,,,,,6,,,,,,,,,,,,,,,,,,,,,,,,,,,,,,,,,12,,,,,,,,,,,,,,,,,,,,,,,,,,,,,,,,,5,,,,,,,,,,,,,,,,,,,,,,,,,,,,,,,,,9,,,,,,,,,,,,,,,,,,,,,,,,,,,,,,,,,0,5.0,5.0,5.0,6.0,4.0,5.0,3.0,5.0,5.0,4.0,3.0,3.0,4.0,4.0,3.0,5.0,4.0,3.0,4.0,3.0,4.0,4.0,6.0,4.0,4.0,5.0,3.0,4.0,5.0,5.0,6.0,2.0,3,,,,,,,,,,,,,,,,,,,,,,,,,,,,,,,,,1,6.0,7.0,6.0,6.0,5.0,5.0,4.0,6.0,6.0,5.0,5.0,6.0,5.0,5.0,5.0,6.0,6.0,6.0,5.0,5.0,5.0,5.0,5.0,6.0,6.0,5.0,5.0,6.0,5.0,5.0,6.0,4.0,14,,,,,,,,,,,,,,,,,,,,,,,,,,,,,,,,,4,,,,,,,,,,,,,,,,,,,,,,,,,,,,,,,,,10,,,,,,,,,,,,,,,,,,,,,,,,,,,,,,,,,7,,,,,,,,,,,,,,,,,,,,,,,,,,,,,,,,,,327.69,11.01,,,,4.41,,30.32,,,,,,,,75.58,,,,,,,,,,,,,,,,,,119.85,,,,,,82.59,,,,,,,,,,,,,,,3.93,,APPROVED,Male,45.0,FALSE
1233,2022-03-22 03:33:10,19,en,98795751,2022-03-22 03:24:40,2022-03-22 03:33:10,Y,Y,-oth-,GED,,7,,,,,,,,,,,,,,,,,,,,,,,,,,,,,,,,,4,,,,,,,,,,,,,,,,,,,,,,,,,,,,,,,,,6,,,,,,,,,,,,,,,,,,,,,,,,,,,,,,,,,13,,,,,,,,,,,,,,,,,,,,,,,,,,,,,,,,,12,,,,,,,,,,,,,,,,,,,,,,,,,,,,,,,,,10,,,,,,,,,,,,,,,,,,,,,,,,,,,,,,,,,14,,,,,,,,,,,,,,,,,,,,,,,,,,,,,,,,,1,2.0,2.0,2.0,2.0,2.0,2.0,6.0,3.0,3.0,2.0,3.0,2.0,2.0,3.0,2.0,3.0,2.0,2.0,2.0,3.0,3.0,2.0,3.0,2.0,2.0,3.0,6.0,2.0,3.0,2.0,2.0,1.0,11,,,,,,,,,,,,,,,,,,,,,,,,,,,,,,,,,8,,,,,,,,,,,,,,,,,,,,,,,,,,,,,,,,,9,,,,,,,,,,,,,,,,,,,,,,,,,,,,,,,,,5,,,,,,,,,,,,,,,,,,,,,,,,,,,,,,,,,0,4.0,5.0,2.0,1.0,4.0,3.0,5.0,3.0,5.0,4.0,4.0,5.0,4.0,5.0,5.0,4.0,5.0,4.0,4.0,5.0,4.0,4.0,3.0,3.0,5.0,3.0,5.0,4.0,4.0,4.0,2.0,6.0,2,1.0,1.0,1.0,1.0,1.0,1.0,1.0,1.0,1.0,1.0,1.0,1.0,1.0,1.0,1.0,1.0,1.0,1.0,1.0,1.0,1.0,1.0,1.0,1.0,1.0,1.0,1.0,1.0,1.0,1.0,1.0,7.0,3,,,,,,,,,,,,,,,,,,,,,,,,,,,,,,,,,,513.22,30.2,,,,18.68,,27.36,,,,,,,,,,,,,,,,,,,,,,,163.06,,,,,,,,,,,,,,,244.97,,,25.2,,,,,,3.75,,APPROVED,Female,30.0,FALSE
1234,2022-03-22 03:27:42,19,en,1877140095,2022-03-22 03:24:41,2022-03-22 03:27:42,Y,Y,A2,,,7,,,,,,,,,,,,,,,,,,,,,,,,,,,,,,,,,1,5.0,5.0,5.0,5.0,5.0,5.0,1.0,5.0,5.0,5.0,5.0,5.0,5.0,5.0,5.0,5.0,5.0,5.0,5.0,5.0,5.0,5.0,4.0,5.0,5.0,5.0,5.0,5.0,5.0,5.0,5.0,2.0,12,,,,,,,,,,,,,,,,,,,,,,,,,,,,,,,,,13,,,,,,,,,,,,,,,,,,,,,,,,,,,,,,,,,5,,,,,,,,,,,,,,,,,,,,,,,,,,,,,,,,,9,,,,,,,,,,,,,,,,,,,,,,,,,,,,,,,,,8,,,,,,,,,,,,,,,,,,,,,,,,,,,,,,,,,0,1.0,1.0,1.0,1.0,1.0,2.0,7.0,2.0,1.0,1.0,1.0,1.0,2.0,1.0,1.0,2.0,1.0,1.0,1.0,2.0,1.0,2.0,1.0,1.0,1.0,2.0,2.0,2.0,1.0,2.0,2.0,1.0,11,,,,,,,,,,,,,,,,,,,,,,,,,,,,,,,,,3,,,,,,,,,,,,,,,,,,,,,,,,,,,,,,,,,2,1.0,1.0,1.0,1.0,1.0,1.0,7.0,7.0,1.0,1.0,1.0,1.0,1.0,1.0,1.0,1.0,1.0,1.0,1.0,1.0,1.0,1.0,1.0,1.0,1.0,1.0,1.0,1.0,1.0,1.0,1.0,4.0,10,,,,,,,,,,,,,,,,,,,,,,,,,,,,,,,,,4,,,,,,,,,,,,,,,,,,,,,,,,,,,,,,,,,14,,,,,,,,,,,,,,,,,,,,,,,,,,,,,,,,,6,,,,,,,,,,,,,,,,,,,,,,,,,,,,,,,,,,185.32,19.88,,,,5.53,,16.31,,,,,53.25,,,,,,,,,,,,,,,,,,38.72,,,,,,,,,47.12,,,,,,,,,,,,,,,4.51,,APPROVED,Female,23.0,FALSE
1235,2022-03-22 03:29:28,19,en,524056253,2022-03-22 03:24:41,2022-03-22 03:29:28,Y,Y,A1,,,3,,,,,,,,,,,,,,,,,,,,,,,,,,,,,,,,,6,,,,,,,,,,,,,,,,,,,,,,,,,,,,,,,,,13,,,,,,,,,,,,,,,,,,,,,,,,,,,,,,,,,0,5.0,5.0,5.0,5.0,5.0,3.0,4.0,6.0,5.0,5.0,5.0,4.0,5.0,6.0,5.0,5.0,6.0,4.0,5.0,4.0,4.0,5.0,4.0,5.0,5.0,6.0,2.0,5.0,5.0,5.0,6.0,4.0,8,,,,,,,,,,,,,,,,,,,,,,,,,,,,,,,,,5,,,,,,,,,,,,,,,,,,,,,,,,,,,,,,,,,14,,,,,,,,,,,,,,,,,,,,,,,,,,,,,,,,,4,,,,,,,,,,,,,,,,,,,,,,,,,,,,,,,,,9,,,,,,,,,,,,,,,,,,,,,,,,,,,,,,,,,1,3.0,4.0,3.0,4.0,3.0,3.0,5.0,4.0,3.0,3.0,4.0,3.0,3.0,5.0,5.0,4.0,4.0,3.0,3.0,3.0,4.0,4.0,4.0,3.0,3.0,5.0,5.0,4.0,5.0,4.0,5.0,3.0,10,,,,,,,,,,,,,,,,,,,,,,,,,,,,,,,,,2,5.0,5.0,4.0,3.0,5.0,4.0,5.0,3.0,5.0,4.0,4.0,4.0,3.0,3.0,3.0,4.0,4.0,4.0,4.0,4.0,3.0,4.0,4.0,3.0,3.0,5.0,3.0,4.0,4.0,4.0,4.0,5.0,12,,,,,,,,,,,,,,,,,,,,,,,,,,,,,,,,,7,,,,,,,,,,,,,,,,,,,,,,,,,,,,,,,,,11,,,,,,,,,,,,,,,,,,,,,,,,,,,,,,,,,,288.82,27.0,,,,5.88,,40.75,,,,,,,,,,,78.47,,,,,,,,,,,,,,,,,,70.44,,,,,,62.18,,,,,,,,,,,,4.1,,APPROVED,Male,35.0,FALSE
1236,2022-03-22 03:31:04,19,en,444571898,2022-03-22 03:24:41,2022-03-22 03:31:04,Y,Y,A1,,,2,7.0,6.0,6.0,6.0,7.0,6.0,2.0,6.0,7.0,7.0,6.0,7.0,7.0,7.0,6.0,7.0,7.0,5.0,6.0,5.0,5.0,6.0,6.0,7.0,6.0,6.0,5.0,7.0,6.0,7.0,6.0,1.0,7,,,,,,,,,,,,,,,,,,,,,,,,,,,,,,,,,9,,,,,,,,,,,,,,,,,,,,,,,,,,,,,,,,,8,,,,,,,,,,,,,,,,,,,,,,,,,,,,,,,,,10,,,,,,,,,,,,,,,,,,,,,,,,,,,,,,,,,0,2.0,7.0,6.0,2.0,6.0,6.0,6.0,7.0,7.0,6.0,3.0,3.0,6.0,6.0,6.0,7.0,6.0,5.0,5.0,6.0,3.0,5.0,1.0,5.0,6.0,3.0,1.0,6.0,3.0,5.0,2.0,6.0,11,,,,,,,,,,,,,,,,,,,,,,,,,,,,,,,,,5,,,,,,,,,,,,,,,,,,,,,,,,,,,,,,,,,14,,,,,,,,,,,,,,,,,,,,,,,,,,,,,,,,,4,,,,,,,,,,,,,,,,,,,,,,,,,,,,,,,,,1,3.0,7.0,5.0,5.0,3.0,2.0,6.0,3.0,5.0,2.0,5.0,5.0,5.0,5.0,3.0,5.0,3.0,3.0,3.0,2.0,3.0,5.0,2.0,2.0,6.0,3.0,2.0,2.0,5.0,2.0,1.0,4.0,12,,,,,,,,,,,,,,,,,,,,,,,,,,,,,,,,,6,,,,,,,,,,,,,,,,,,,,,,,,,,,,,,,,,13,,,,,,,,,,,,,,,,,,,,,,,,,,,,,,,,,3,,,,,,,,,,,,,,,,,,,,,,,,,,,,,,,,,,385.06,26.56,,,,9.04,,67.81,,59.74,,,,,,,,,,,,,,,132.5,,,,,,,,,,,,,,,85.17,,,,,,,,,,,,,,,4.24,,APPROVED,Male,21.0,FALSE
1237,2022-03-22 03:28:32,19,en,1458290841,2022-03-22 03:24:41,2022-03-22 03:28:32,Y,Y,A1,,,0,6.0,6.0,6.0,5.0,6.0,6.0,5.0,7.0,7.0,6.0,6.0,6.0,6.0,6.0,6.0,6.0,6.0,6.0,6.0,6.0,2.0,6.0,6.0,6.0,6.0,6.0,2.0,6.0,6.0,6.0,7.0,1.0,10,,,,,,,,,,,,,,,,,,,,,,,,,,,,,,,,,3,,,,,,,,,,,,,,,,,,,,,,,,,,,,,,,,,11,,,,,,,,,,,,,,,,,,,,,,,,,,,,,,,,,12,,,,,,,,,,,,,,,,,,,,,,,,,,,,,,,,,5,,,,,,,,,,,,,,,,,,,,,,,,,,,,,,,,,7,,,,,,,,,,,,,,,,,,,,,,,,,,,,,,,,,13,,,,,,,,,,,,,,,,,,,,,,,,,,,,,,,,,14,,,,,,,,,,,,,,,,,,,,,,,,,,,,,,,,,9,,,,,,,,,,,,,,,,,,,,,,,,,,,,,,,,,6,,,,,,,,,,,,,,,,,,,,,,,,,,,,,,,,,1,6.0,6.0,6.0,6.0,6.0,6.0,6.0,7.0,6.0,6.0,6.0,6.0,6.0,6.0,5.0,6.0,6.0,6.0,6.0,5.0,5.0,6.0,6.0,6.0,6.0,6.0,4.0,6.0,6.0,6.0,7.0,5.0,2,6.0,6.0,4.0,5.0,6.0,6.0,6.0,7.0,5.0,6.0,7.0,6.0,6.0,6.0,5.0,6.0,6.0,4.0,6.0,6.0,6.0,6.0,6.0,6.0,5.0,6.0,5.0,6.0,6.0,6.0,5.0,6.0,8,,,,,,,,,,,,,,,,,,,,,,,,,,,,,,,,,4,,,,,,,,,,,,,,,,,,,,,,,,,,,,,,,,,,235.28,11.67,,,,5.85,,23.84,,45.49,,,,,,,,,,,,,,,,,,,,,,,,,,,,,,,,,94.71,,,50.74,,,,,,,,,2.98,,APPROVED,Male,26.0,FALSE
1238,2022-03-22 03:36:19,19,en,255947816,2022-03-22 03:24:45,2022-03-22 03:36:19,Y,Y,-oth-,"Diploma only, not yet graduate of university",,6,,,,,,,,,,,,,,,,,,,,,,,,,,,,,,,,,14,,,,,,,,,,,,,,,,,,,,,,,,,,,,,,,,,12,,,,,,,,,,,,,,,,,,,,,,,,,,,,,,,,,2,3.0,7.0,3.0,4.0,3.0,7.0,6.0,5.0,6.0,3.0,5.0,6.0,3.0,5.0,5.0,5.0,6.0,3.0,3.0,3.0,4.0,5.0,6.0,5.0,2.0,5.0,5.0,2.0,6.0,4.0,4.0,4.0,4,,,,,,,,,,,,,,,,,,,,,,,,,,,,,,,,,13,,,,,,,,,,,,,,,,,,,,,,,,,,,,,,,,,10,,,,,,,,,,,,,,,,,,,,,,,,,,,,,,,,,7,,,,,,,,,,,,,,,,,,,,,,,,,,,,,,,,,8,,,,,,,,,,,,,,,,,,,,,,,,,,,,,,,,,9,,,,,,,,,,,,,,,,,,,,,,,,,,,,,,,,,3,,,,,,,,,,,,,,,,,,,,,,,,,,,,,,,,,5,,,,,,,,,,,,,,,,,,,,,,,,,,,,,,,,,1,6.0,5.0,5.0,6.0,4.0,6.0,2.0,4.0,4.0,4.0,5.0,6.0,5.0,3.0,6.0,5.0,5.0,5.0,6.0,5.0,5.0,5.0,7.0,4.0,5.0,6.0,4.0,6.0,7.0,4.0,6.0,6.0,11,,,,,,,,,,,,,,,,,,,,,,,,,,,,,,,,,0,3.0,7.0,3.0,2.0,3.0,3.0,6.0,2.0,6.0,2.0,2.0,5.0,3.0,6.0,4.0,3.0,6.0,4.0,2.0,3.0,4.0,3.0,2.0,4.0,3.0,4.0,6.0,3.0,6.0,4.0,4.0,1.0,I've honestly never seen the categorical clusters of colour like the 3rd image. It's not really appealing to me for practical use because there's too much you need to understand in order to read the data off it. I think I have seen the 2nd one before and it is really nice to look at.,697.4,105.82,,,,36.65,,25.68,,,,,,,,,,,126.7,,,,,,,,,,,,,,,,,,,,,,,,,,,161.83,,,,,,110.33,,,130.39,,APPROVED,Female,22.0,FALSE
1240,2022-03-22 03:37:38,19,en,939281470,2022-03-22 03:24:58,2022-03-22 03:37:38,Y,Y,A1,,,2,2.0,6.0,3.0,1.0,3.0,2.0,6.0,5.0,5.0,2.0,2.0,3.0,5.0,5.0,5.0,2.0,6.0,2.0,2.0,2.0,4.0,3.0,1.0,2.0,5.0,2.0,5.0,1.0,3.0,4.0,2.0,1.0,13,,,,,,,,,,,,,,,,,,,,,,,,,,,,,,,,,9,,,,,,,,,,,,,,,,,,,,,,,,,,,,,,,,,11,,,,,,,,,,,,,,,,,,,,,,,,,,,,,,,,,8,,,,,,,,,,,,,,,,,,,,,,,,,,,,,,,,,7,,,,,,,,,,,,,,,,,,,,,,,,,,,,,,,,,1,2.0,6.0,5.0,3.0,4.0,2.0,5.0,5.0,6.0,4.0,3.0,2.0,4.0,3.0,5.0,3.0,6.0,2.0,5.0,1.0,2.0,2.0,1.0,5.0,5.0,4.0,5.0,1.0,5.0,4.0,2.0,7.0,5,,,,,,,,,,,,,,,,,,,,,,,,,,,,,,,,,12,,,,,,,,,,,,,,,,,,,,,,,,,,,,,,,,,0,1.0,1.0,1.0,1.0,1.0,1.0,7.0,1.0,2.0,1.0,1.0,1.0,1.0,1.0,2.0,1.0,3.0,1.0,1.0,1.0,1.0,1.0,1.0,1.0,1.0,2.0,3.0,1.0,1.0,1.0,1.0,3.0,14,,,,,,,,,,,,,,,,,,,,,,,,,,,,,,,,,3,,,,,,,,,,,,,,,,,,,,,,,,,,,,,,,,,10,,,,,,,,,,,,,,,,,,,,,,,,,,,,,,,,,4,,,,,,,,,,,,,,,,,,,,,,,,,,,,,,,,,6,,,,,,,,,,,,,,,,,,,,,,,,,,,,,,,,,I've never seen those before. Interesting.,762.94,102.9,,,,15.23,,92.01,,145.23,,,,,,,,,,,,,,,,,,171.44,,,,,,,,,202.12,,,,,,,,,,,,,,,,,,34.01,,APPROVED,Female,63.0,FALSE
1241,2022-03-22 03:31:27,19,en,656882908,2022-03-22 03:25:00,2022-03-22 03:31:27,Y,Y,A1,,,0,6.0,6.0,6.0,6.0,6.0,6.0,2.0,6.0,6.0,6.0,5.0,6.0,6.0,6.0,6.0,5.0,6.0,6.0,6.0,5.0,6.0,6.0,5.0,6.0,5.0,6.0,6.0,6.0,5.0,6.0,6.0,1.0,12,,,,,,,,,,,,,,,,,,,,,,,,,,,,,,,,,9,,,,,,,,,,,,,,,,,,,,,,,,,,,,,,,,,6,,,,,,,,,,,,,,,,,,,,,,,,,,,,,,,,,2,6.0,6.0,6.0,6.0,6.0,6.0,2.0,6.0,6.0,6.0,5.0,6.0,6.0,5.0,4.0,6.0,6.0,6.0,6.0,5.0,6.0,6.0,6.0,6.0,6.0,6.0,6.0,6.0,5.0,6.0,6.0,5.0,5,,,,,,,,,,,,,,,,,,,,,,,,,,,,,,,,,8,,,,,,,,,,,,,,,,,,,,,,,,,,,,,,,,,10,,,,,,,,,,,,,,,,,,,,,,,,,,,,,,,,,3,,,,,,,,,,,,,,,,,,,,,,,,,,,,,,,,,1,2.0,6.0,2.0,5.0,2.0,2.0,6.0,2.0,6.0,2.0,2.0,6.0,2.0,4.0,2.0,2.0,6.0,2.0,4.0,2.0,2.0,2.0,2.0,2.0,2.0,4.0,6.0,2.0,2.0,4.0,6.0,3.0,11,,,,,,,,,,,,,,,,,,,,,,,,,,,,,,,,,13,,,,,,,,,,,,,,,,,,,,,,,,,,,,,,,,,14,,,,,,,,,,,,,,,,,,,,,,,,,,,,,,,,,4,,,,,,,,,,,,,,,,,,,,,,,,,,,,,,,,,7,,,,,,,,,,,,,,,,,,,,,,,,,,,,,,,,,I like the subject content and the length of the survey ,390.05,17.8,,,,9.59,,105.06,,83.49,,,,,,,,,,,,68.72,,,,,,,,,,,,,,,89.59,,,,,,,,,,,,,,,,,,15.8,,APPROVED,Female,41.0,FALSE
1242,2022-03-22 03:33:13,19,en,1713539460,2022-03-22 03:25:08,2022-03-22 03:33:13,Y,Y,-oth-,Currently working on Graduation,,5,,,,,,,,,,,,,,,,,,,,,,,,,,,,,,,,,3,,,,,,,,,,,,,,,,,,,,,,,,,,,,,,,,,10,,,,,,,,,,,,,,,,,,,,,,,,,,,,,,,,,6,,,,,,,,,,,,,,,,,,,,,,,,,,,,,,,,,2,5.0,5.0,4.0,4.0,4.0,3.0,5.0,5.0,5.0,3.0,5.0,5.0,4.0,5.0,4.0,4.0,5.0,3.0,5.0,4.0,4.0,4.0,5.0,4.0,4.0,5.0,5.0,5.0,4.0,5.0,6.0,5.0,9,,,,,,,,,,,,,,,,,,,,,,,,,,,,,,,,,13,,,,,,,,,,,,,,,,,,,,,,,,,,,,,,,,,11,,,,,,,,,,,,,,,,,,,,,,,,,,,,,,,,,0,2.0,5.0,3.0,4.0,3.0,4.0,4.0,2.0,6.0,3.0,2.0,3.0,4.0,5.0,4.0,4.0,6.0,3.0,4.0,3.0,3.0,3.0,5.0,3.0,4.0,4.0,4.0,2.0,2.0,3.0,4.0,2.0,4,,,,,,,,,,,,,,,,,,,,,,,,,,,,,,,,,8,,,,,,,,,,,,,,,,,,,,,,,,,,,,,,,,,7,,,,,,,,,,,,,,,,,,,,,,,,,,,,,,,,,12,,,,,,,,,,,,,,,,,,,,,,,,,,,,,,,,,14,,,,,,,,,,,,,,,,,,,,,,,,,,,,,,,,,1,5.0,6.0,5.0,5.0,5.0,5.0,3.0,4.0,5.0,5.0,5.0,4.0,5.0,4.0,5.0,4.0,5.0,4.0,5.0,4.0,4.0,5.0,5.0,5.0,5.0,4.0,3.0,5.0,5.0,4.0,5.0,1.0,Everything worked fine!,488.82,63.67,,,,58.16,,35.31,,,,,,,,,,,,,,102.95,,,,,,,,,,,,131.91,,,,,,,,,,,,,,,,,,83.79,,,13.03,,APPROVED,Male,24.0,FALSE
1243,2022-03-22 03:29:43,19,en,1617149921,2022-03-22 03:25:34,2022-03-22 03:29:43,Y,Y,A1,,,1,4.0,5.0,2.0,1.0,2.0,2.0,5.0,4.0,5.0,2.0,2.0,3.0,3.0,5.0,4.0,1.0,4.0,2.0,2.0,2.0,3.0,2.0,2.0,2.0,2.0,2.0,3.0,2.0,2.0,2.0,3.0,1.0,2,6.0,2.0,5.0,5.0,5.0,6.0,4.0,4.0,3.0,5.0,5.0,4.0,6.0,4.0,5.0,5.0,6.0,4.0,5.0,4.0,5.0,5.0,4.0,4.0,4.0,5.0,2.0,4.0,4.0,5.0,4.0,2.0,3,,,,,,,,,,,,,,,,,,,,,,,,,,,,,,,,,13,,,,,,,,,,,,,,,,,,,,,,,,,,,,,,,,,8,,,,,,,,,,,,,,,,,,,,,,,,,,,,,,,,,9,,,,,,,,,,,,,,,,,,,,,,,,,,,,,,,,,14,,,,,,,,,,,,,,,,,,,,,,,,,,,,,,,,,12,,,,,,,,,,,,,,,,,,,,,,,,,,,,,,,,,6,,,,,,,,,,,,,,,,,,,,,,,,,,,,,,,,,5,,,,,,,,,,,,,,,,,,,,,,,,,,,,,,,,,11,,,,,,,,,,,,,,,,,,,,,,,,,,,,,,,,,4,,,,,,,,,,,,,,,,,,,,,,,,,,,,,,,,,10,,,,,,,,,,,,,,,,,,,,,,,,,,,,,,,,,0,1.0,2.0,1.0,4.0,4.0,2.0,2.0,5.0,3.0,2.0,2.0,2.0,2.0,2.0,5.0,2.0,4.0,2.0,2.0,1.0,2.0,2.0,5.0,2.0,2.0,4.0,3.0,1.0,4.0,2.0,3.0,7.0,7,,,,,,,,,,,,,,,,,,,,,,,,,,,,,,,,,,252.29,11.65,,,,5.32,,36.34,,62.7,,,62.53,,,,,,,,,,,,,,,,,,,,,,,,,,,,,,,,,,,,68.78,,,,,,4.97,,APPROVED,Female,33.0,FALSE
1244,2022-03-22 03:38:13,19,en,501249754,2022-03-22 03:25:39,2022-03-22 03:38:12,Y,Y,A1,,,14,,,,,,,,,,,,,,,,,,,,,,,,,,,,,,,,,13,,,,,,,,,,,,,,,,,,,,,,,,,,,,,,,,,6,,,,,,,,,,,,,,,,,,,,,,,,,,,,,,,,,1,7.0,7.0,6.0,7.0,7.0,7.0,1.0,7.0,7.0,7.0,7.0,7.0,7.0,7.0,7.0,7.0,7.0,7.0,7.0,7.0,6.0,7.0,7.0,7.0,6.0,7.0,5.0,7.0,7.0,7.0,7.0,4.0,4,,,,,,,,,,,,,,,,,,,,,,,,,,,,,,,,,8,,,,,,,,,,,,,,,,,,,,,,,,,,,,,,,,,5,,,,,,,,,,,,,,,,,,,,,,,,,,,,,,,,,1,2.0,3.0,2.0,6.0,2.0,5.0,4.0,2.0,6.0,4.0,2.0,3.0,4.0,3.0,3.0,3.0,3.0,4.0,2.0,3.0,3.0,3.0,4.0,3.0,2.0,6.0,3.0,4.0,4.0,2.0,5.0,1.0,12,,,,,,,,,,,,,,,,,,,,,,,,,,,,,,,,,3,,,,,,,,,,,,,,,,,,,,,,,,,,,,,,,,,10,,,,,,,,,,,,,,,,,,,,,,,,,,,,,,,,,2,6.0,6.0,5.0,7.0,7.0,7.0,1.0,6.0,5.0,4.0,4.0,7.0,6.0,4.0,6.0,6.0,6.0,6.0,6.0,6.0,4.0,6.0,6.0,5.0,6.0,6.0,4.0,4.0,4.0,4.0,6.0,5.0,11,,,,,,,,,,,,,,,,,,,,,,,,,,,,,,,,,7,,,,,,,,,,,,,,,,,,,,,,,,,,,,,,,,,9,,,,,,,,,,,,,,,,,,,,,,,,,,,,,,,,,,758.83,62.52,,,,8.08,,53.75,,,,,,,,,,,248.23,,,,,,,,,,,,195.33,,,,,,,,,,,,182.93,,,,,,,,,,,,7.99,,APPROVED,Female,24.0,FALSE
1245,2022-03-22 03:42:27,19,en,281589656,2022-03-22 03:25:56,2022-03-22 03:42:27,Y,Y,A1,,,8,,,,,,,,,,,,,,,,,,,,,,,,,,,,,,,,,12,,,,,,,,,,,,,,,,,,,,,,,,,,,,,,,,,14,,,,,,,,,,,,,,,,,,,,,,,,,,,,,,,,,6,,,,,,,,,,,,,,,,,,,,,,,,,,,,,,,,,1,5.0,4.0,5.0,3.0,4.0,5.0,5.0,3.0,6.0,4.0,3.0,5.0,3.0,4.0,5.0,5.0,5.0,4.0,4.0,4.0,4.0,5.0,1.0,5.0,4.0,5.0,2.0,6.0,5.0,4.0,5.0,5.0,13,,,,,,,,,,,,,,,,,,,,,,,,,,,,,,,,,0,4.0,2.0,3.0,5.0,1.0,2.0,5.0,1.0,4.0,3.0,2.0,3.0,2.0,2.0,3.0,2.0,5.0,2.0,2.0,2.0,2.0,4.0,5.0,2.0,3.0,3.0,3.0,2.0,2.0,2.0,1.0,7.0,3,,,,,,,,,,,,,,,,,,,,,,,,,,,,,,,,,7,,,,,,,,,,,,,,,,,,,,,,,,,,,,,,,,,5,,,,,,,,,,,,,,,,,,,,,,,,,,,,,,,,,11,,,,,,,,,,,,,,,,,,,,,,,,,,,,,,,,,4,,,,,,,,,,,,,,,,,,,,,,,,,,,,,,,,,2,5.0,3.0,5.0,5.0,3.0,3.0,4.0,3.0,4.0,4.0,3.0,4.0,5.0,6.0,5.0,5.0,6.0,5.0,5.0,3.0,6.0,4.0,3.0,5.0,3.0,7.0,2.0,5.0,5.0,4.0,3.0,6.0,10,,,,,,,,,,,,,,,,,,,,,,,,,,,,,,,,,9,,,,,,,,,,,,,,,,,,,,,,,,,,,,,,,,,I have no comment,992.9,57.69,,,,7.02,,48.73,,,,,,,,,,,,,,440.03,,,,,,228.07,,,,,,,,,,,,,,,,,,175.01,,,,,,,,,36.35,,APPROVED,Female,25.0,FALSE
1246,2022-03-22 03:44:06,19,en,789901751,2022-03-22 03:26:32,2022-03-22 03:44:06,Y,Y,-oth-,HS Diploma,,8,,,,,,,,,,,,,,,,,,,,,,,,,,,,,,,,,14,,,,,,,,,,,,,,,,,,,,,,,,,,,,,,,,,2,7.0,7.0,7.0,7.0,7.0,7.0,1.0,7.0,7.0,7.0,7.0,7.0,7.0,7.0,7.0,7.0,7.0,7.0,7.0,7.0,7.0,7.0,7.0,7.0,7.0,7.0,7.0,7.0,7.0,7.0,7.0,1.0,5,,,,,,,,,,,,,,,,,,,,,,,,,,,,,,,,,3,,,,,,,,,,,,,,,,,,,,,,,,,,,,,,,,,6,,,,,,,,,,,,,,,,,,,,,,,,,,,,,,,,,4,,,,,,,,,,,,,,,,,,,,,,,,,,,,,,,,,1,7.0,2.0,3.0,6.0,6.0,7.0,2.0,2.0,2.0,5.0,6.0,7.0,7.0,7.0,6.0,7.0,7.0,5.0,7.0,2.0,1.0,7.0,7.0,3.0,2.0,6.0,7.0,2.0,6.0,7.0,7.0,1.0,9,,,,,,,,,,,,,,,,,,,,,,,,,,,,,,,,,7,,,,,,,,,,,,,,,,,,,,,,,,,,,,,,,,,11,,,,,,,,,,,,,,,,,,,,,,,,,,,,,,,,,13,,,,,,,,,,,,,,,,,,,,,,,,,,,,,,,,,10,,,,,,,,,,,,,,,,,,,,,,,,,,,,,,,,,12,,,,,,,,,,,,,,,,,,,,,,,,,,,,,,,,,0,6.0,6.0,6.0,3.0,6.0,3.0,5.0,3.0,6.0,6.0,6.0,6.0,6.0,6.0,6.0,3.0,6.0,6.0,6.0,6.0,5.0,6.0,3.0,6.0,6.0,6.0,6.0,3.0,6.0,6.0,6.0,1.0,,1057.27,163.4,,,,25.01,,582.73,,,,,,,,41.38,,,,,,,,,,,,,,,112.98,,,,,,,,,,,,,,,,,,,,,126.19,,,5.58,,APPROVED,Female,30.0,FALSE
1247,2022-03-22 03:31:58,19,en,1375950186,2022-03-22 03:27:11,2022-03-22 03:31:58,Y,Y,A2,,,12,,,,,,,,,,,,,,,,,,,,,,,,,,,,,,,,,5,,,,,,,,,,,,,,,,,,,,,,,,,,,,,,,,,6,,,,,,,,,,,,,,,,,,,,,,,,,,,,,,,,,10,,,,,,,,,,,,,,,,,,,,,,,,,,,,,,,,,8,,,,,,,,,,,,,,,,,,,,,,,,,,,,,,,,,14,,,,,,,,,,,,,,,,,,,,,,,,,,,,,,,,,7,,,,,,,,,,,,,,,,,,,,,,,,,,,,,,,,,1,1.0,4.0,1.0,1.0,3.0,1.0,7.0,5.0,2.0,1.0,1.0,3.0,1.0,1.0,1.0,1.0,3.0,1.0,1.0,1.0,1.0,1.0,1.0,1.0,1.0,2.0,1.0,1.0,2.0,3.0,3.0,1.0,4,,,,,,,,,,,,,,,,,,,,,,,,,,,,,,,,,13,,,,,,,,,,,,,,,,,,,,,,,,,,,,,,,,,0,2.0,5.0,1.0,1.0,1.0,1.0,6.0,6.0,2.0,2.0,1.0,1.0,1.0,2.0,3.0,1.0,5.0,1.0,1.0,1.0,2.0,2.0,1.0,1.0,2.0,3.0,1.0,1.0,1.0,3.0,1.0,4.0,11,,,,,,,,,,,,,,,,,,,,,,,,,,,,,,,,,3,,,,,,,,,,,,,,,,,,,,,,,,,,,,,,,,,2,1.0,1.0,1.0,5.0,1.0,5.0,1.0,5.0,2.0,1.0,1.0,4.0,2.0,2.0,2.0,5.0,3.0,2.0,1.0,1.0,1.0,1.0,1.0,1.0,1.0,5.0,1.0,2.0,2.0,2.0,3.0,7.0,9,,,,,,,,,,,,,,,,,,,,,,,,,,,,,,,,,,289.87,21.57,,,,4.75,,40.4,,,,,,,,,,,,,,,,,,,,,,,62.1,,,,,,,,,99.16,,,,,,,,,59.03,,,,,,2.86,,APPROVED,Female,29.0,FALSE
1248,2022-03-22 03:41:57,19,en,325616810,2022-03-22 03:30:25,2022-03-22 03:41:57,Y,Y,A1,,,8,,,,,,,,,,,,,,,,,,,,,,,,,,,,,,,,,3,,,,,,,,,,,,,,,,,,,,,,,,,,,,,,,,,6,,,,,,,,,,,,,,,,,,,,,,,,,,,,,,,,,12,,,,,,,,,,,,,,,,,,,,,,,,,,,,,,,,,2,5.0,5.0,3.0,5.0,3.0,5.0,5.0,3.0,5.0,2.0,7.0,5.0,3.0,5.0,5.0,5.0,5.0,5.0,5.0,3.0,6.0,5.0,5.0,3.0,4.0,7.0,5.0,5.0,3.0,4.0,6.0,5.0,11,,,,,,,,,,,,,,,,,,,,,,,,,,,,,,,,,9,,,,,,,,,,,,,,,,,,,,,,,,,,,,,,,,,0,2.0,2.0,2.0,1.0,2.0,2.0,7.0,4.0,2.0,1.0,2.0,5.0,2.0,4.0,2.0,2.0,5.0,2.0,2.0,2.0,2.0,1.0,5.0,1.0,2.0,4.0,2.0,1.0,2.0,2.0,1.0,1.0,4,,,,,,,,,,,,,,,,,,,,,,,,,,,,,,,,,1,5.0,6.0,6.0,5.0,6.0,4.0,4.0,6.0,6.0,3.0,6.0,5.0,5.0,6.0,6.0,5.0,6.0,6.0,6.0,6.0,5.0,5.0,5.0,5.0,6.0,6.0,6.0,6.0,6.0,5.0,4.0,3.0,5,,,,,,,,,,,,,,,,,,,,,,,,,,,,,,,,,14,,,,,,,,,,,,,,,,,,,,,,,,,,,,,,,,,13,,,,,,,,,,,,,,,,,,,,,,,,,,,,,,,,,7,,,,,,,,,,,,,,,,,,,,,,,,,,,,,,,,,10,,,,,,,,,,,,,,,,,,,,,,,,,,,,,,,,,,695.57,11.82,,,,5.39,,16.33,,,,,,,,,,,,,,362.31,,,,,,,,,163.28,,,,,,133.61,,,,,,,,,,,,,,,,,,2.83,,APPROVED,Female,30.0,FALSE
1249,2022-03-22 03:34:59,19,en,2025794978,2022-03-22 03:31:00,2022-03-22 03:34:59,Y,Y,-oth-,some college,,1,6.0,5.0,5.0,6.0,6.0,6.0,4.0,6.0,6.0,4.0,6.0,5.0,6.0,5.0,5.0,5.0,6.0,4.0,6.0,4.0,4.0,6.0,4.0,5.0,6.0,5.0,5.0,6.0,5.0,5.0,6.0,1.0,11,,,,,,,,,,,,,,,,,,,,,,,,,,,,,,,,,3,,,,,,,,,,,,,,,,,,,,,,,,,,,,,,,,,7,,,,,,,,,,,,,,,,,,,,,,,,,,,,,,,,,6,,,,,,,,,,,,,,,,,,,,,,,,,,,,,,,,,5,,,,,,,,,,,,,,,,,,,,,,,,,,,,,,,,,14,,,,,,,,,,,,,,,,,,,,,,,,,,,,,,,,,10,,,,,,,,,,,,,,,,,,,,,,,,,,,,,,,,,2,3.0,3.0,3.0,4.0,3.0,4.0,5.0,5.0,3.0,3.0,3.0,3.0,3.0,3.0,3.0,3.0,3.0,3.0,3.0,3.0,3.0,3.0,5.0,3.0,3.0,3.0,3.0,3.0,3.0,3.0,3.0,2.0,12,,,,,,,,,,,,,,,,,,,,,,,,,,,,,,,,,8,,,,,,,,,,,,,,,,,,,,,,,,,,,,,,,,,13,,,,,,,,,,,,,,,,,,,,,,,,,,,,,,,,,0,4.0,4.0,5.0,4.0,4.0,3.0,5.0,5.0,5.0,4.0,4.0,4.0,4.0,5.0,5.0,5.0,5.0,4.0,4.0,4.0,4.0,5.0,5.0,5.0,5.0,4.0,5.0,5.0,4.0,4.0,4.0,6.0,4,,,,,,,,,,,,,,,,,,,,,,,,,,,,,,,,,9,,,,,,,,,,,,,,,,,,,,,,,,,,,,,,,,,,242.03,13.21,,,,15.54,,24.6,,61.36,,,,,,,,,,,,,,,,,,,,,,,,51.3,,,,,,,,,,,,73.6,,,,,,,,,2.42,,APPROVED,Female,21.0,FALSE
1251,2022-03-22 03:40:57,19,en,1878614799,2022-03-22 03:31:55,2022-03-22 03:40:57,Y,Y,A1,,,7,,,,,,,,,,,,,,,,,,,,,,,,,,,,,,,,,6,,,,,,,,,,,,,,,,,,,,,,,,,,,,,,,,,9,,,,,,,,,,,,,,,,,,,,,,,,,,,,,,,,,10,,,,,,,,,,,,,,,,,,,,,,,,,,,,,,,,,0,2.0,2.0,5.0,1.0,1.0,1.0,7.0,1.0,5.0,2.0,1.0,4.0,5.0,1.0,5.0,1.0,6.0,1.0,1.0,1.0,1.0,3.0,1.0,1.0,1.0,5.0,5.0,1.0,1.0,1.0,2.0,5.0,3,,,,,,,,,,,,,,,,,,,,,,,,,,,,,,,,,14,,,,,,,,,,,,,,,,,,,,,,,,,,,,,,,,,12,,,,,,,,,,,,,,,,,,,,,,,,,,,,,,,,,11,,,,,,,,,,,,,,,,,,,,,,,,,,,,,,,,,5,,,,,,,,,,,,,,,,,,,,,,,,,,,,,,,,,4,,,,,,,,,,,,,,,,,,,,,,,,,,,,,,,,,13,,,,,,,,,,,,,,,,,,,,,,,,,,,,,,,,,1,5.0,7.0,6.0,6.0,6.0,5.0,1.0,6.0,6.0,5.0,6.0,6.0,7.0,6.0,6.0,6.0,6.0,6.0,6.0,6.0,4.0,6.0,6.0,6.0,6.0,5.0,5.0,6.0,6.0,7.0,6.0,6.0,8,,,,,,,,,,,,,,,,,,,,,,,,,,,,,,,,,2,4.0,7.0,4.0,1.0,3.0,5.0,4.0,6.0,5.0,3.0,4.0,4.0,4.0,4.0,3.0,4.0,4.0,5.0,6.0,4.0,4.0,3.0,3.0,4.0,4.0,2.0,4.0,4.0,3.0,3.0,3.0,1.0,,545.69,17.19,,,,3.95,,23.96,,,,,,,,,,,,,,112.93,,,,,,,,,,,,,,,,,,,,,,,,300.4,,,,,,82.66,,,4.6,,APPROVED,Male,45.0,FALSE
1252,2022-03-22 03:55:25,19,en,1523341314,2022-03-22 03:44:46,2022-03-22 03:55:25,Y,Y,A1,,,7,,,,,,,,,,,,,,,,,,,,,,,,,,,,,,,,,1,6.0,3.0,3.0,6.0,5.0,6.0,2.0,3.0,2.0,5.0,3.0,3.0,5.0,2.0,3.0,6.0,5.0,5.0,5.0,3.0,3.0,5.0,6.0,5.0,6.0,5.0,3.0,3.0,3.0,5.0,5.0,2.0,8,,,,,,,,,,,,,,,,,,,,,,,,,,,,,,,,,13,,,,,,,,,,,,,,,,,,,,,,,,,,,,,,,,,2,5.0,2.0,3.0,6.0,2.0,3.0,3.0,6.0,3.0,3.0,2.0,6.0,3.0,5.0,5.0,5.0,6.0,2.0,5.0,2.0,3.0,5.0,6.0,3.0,2.0,6.0,2.0,5.0,6.0,5.0,6.0,5.0,6,,,,,,,,,,,,,,,,,,,,,,,,,,,,,,,,,14,,,,,,,,,,,,,,,,,,,,,,,,,,,,,,,,,0,5.0,5.0,5.0,6.0,3.0,3.0,6.0,6.0,5.0,3.0,5.0,6.0,3.0,5.0,5.0,6.0,6.0,2.0,5.0,3.0,5.0,6.0,6.0,5.0,3.0,6.0,5.0,3.0,6.0,3.0,3.0,1.0,9,,,,,,,,,,,,,,,,,,,,,,,,,,,,,,,,,12,,,,,,,,,,,,,,,,,,,,,,,,,,,,,,,,,11,,,,,,,,,,,,,,,,,,,,,,,,,,,,,,,,,3,,,,,,,,,,,,,,,,,,,,,,,,,,,,,,,,,10,,,,,,,,,,,,,,,,,,,,,,,,,,,,,,,,,4,,,,,,,,,,,,,,,,,,,,,,,,,,,,,,,,,5,,,,,,,,,,,,,,,,,,,,,,,,,,,,,,,,,"Many of the terms did not feel like they would apply to a chart. For example, tasteful and beautiful are terms that I consider exclusive to humans. ",643.09,19.14,,,,6.54,,30.9,,,,,231.77,,,,,,,,,129.68,,,,,,,,,134.62,,,,,,,,,,,,,,,,,,,,,,,,90.44,,APPROVED,Male,,FALSE
1255,2022-03-22 04:25:31,19,en,143509380,2022-03-22 04:19:53,2022-03-22 04:25:31,Y,Y,A1,,,8,,,,,,,,,,,,,,,,,,,,,,,,,,,,,,,,,11,,,,,,,,,,,,,,,,,,,,,,,,,,,,,,,,,10,,,,,,,,,,,,,,,,,,,,,,,,,,,,,,,,,9,,,,,,,,,,,,,,,,,,,,,,,,,,,,,,,,,13,,,,,,,,,,,,,,,,,,,,,,,,,,,,,,,,,5,,,,,,,,,,,,,,,,,,,,,,,,,,,,,,,,,2,4.0,4.0,4.0,6.0,4.0,6.0,4.0,6.0,5.0,4.0,6.0,4.0,3.0,4.0,4.0,4.0,5.0,6.0,4.0,4.0,4.0,5.0,6.0,5.0,5.0,6.0,4.0,4.0,6.0,4.0,6.0,7.0,0,3.0,2.0,3.0,3.0,3.0,3.0,3.0,2.0,2.0,3.0,3.0,3.0,3.0,3.0,3.0,3.0,3.0,3.0,4.0,3.0,2.0,3.0,2.0,2.0,3.0,4.0,3.0,3.0,4.0,2.0,4.0,1.0,6,,,,,,,,,,,,,,,,,,,,,,,,,,,,,,,,,14,,,,,,,,,,,,,,,,,,,,,,,,,,,,,,,,,4,,,,,,,,,,,,,,,,,,,,,,,,,,,,,,,,,7,,,,,,,,,,,,,,,,,,,,,,,,,,,,,,,,,3,,,,,,,,,,,,,,,,,,,,,,,,,,,,,,,,,1,4.0,5.0,4.0,5.0,4.0,5.0,4.0,6.0,4.0,4.0,5.0,4.0,5.0,4.0,5.0,5.0,5.0,5.0,5.0,4.0,5.0,4.0,6.0,4.0,4.0,5.0,4.0,5.0,4.0,4.0,6.0,7.0,12,,,,,,,,,,,,,,,,,,,,,,,,,,,,,,,,,,342.63,85.87,,,,8.68,,45.69,,,,,,,,,,,,,,,,,,,,60.72,,,80.79,,,,,,,,,,,,,,,,,,55.15,,,,,,5.73,,RETURNED,CONSENT REVOKED,27.0,FALSE